throughput_KLONGTEI,throughput_KASEMRAT,throughput_NARANONG,throughput_SUNLAKAKHON,throughput_RAMA4, throughput_ATTHAKAVI_RAMA4,throughput,mean_speed,jamlength_percent,Backlog
0,0,0,0,0,0,0,7.8764396314290765,0.0,17
0,0,0,0,0,1,1,8.912429623297465,0.007551010726155326,35
0,1,0,0,0,0,1,9.838638487469835,0.024986370826265005,60
0,2,1,0,0,0,3,10.169151355244681,0.035320870854561835,84
1,2,1,1,0,0,5,9.621403962818546,0.08082405796799949,107
1,2,1,4,3,1,12,10.29322567842895,0.08245506820085738,139
0,1,0,2,0,1,4,9.258225036736466,0.22674975983143522,164
4,7,0,4,3,0,18,8.950806642362386,0.3175366352720206,181
3,12,0,5,0,4,24,9.7914514559691,0.21514875617412804,197
3,7,3,3,4,0,20,9.24328302576451,0.28891558029842795,231
6,7,3,9,1,2,28,8.852455337756172,0.4694187910718436,249
0,3,1,3,5,3,15,8.514660640084815,0.6300788800761068,281
8,4,1,14,5,6,38,9.074463859003574,0.5180272742940142,295
9,7,1,4,1,5,27,8.27778759559186,0.87203434447384,335
10,8,3,1,8,3,33,7.898775093699714,1.2395307021371453,369
12,7,6,5,12,5,47,7.5960723037983096,1.2923686787891147,380
4,9,4,14,7,5,43,7.436997683823087,1.4962687604078058,409
3,7,1,7,3,3,24,6.687558212885031,2.019624210672626,416
2,9,0,9,2,3,25,6.409104472721209,2.3711129684347885,442
5,21,8,7,2,11,54,6.495432242415171,2.257645210556991,448
13,19,4,11,9,6,62,6.96952958931828,2.088544159252184,476
10,10,8,6,20,4,58,6.672080520275574,2.221923572687502,484
16,8,10,10,5,8,57,6.277825691391278,2.5343139965371075,498
15,4,10,3,19,4,55,6.235539960037579,2.634918267628471,506
8,5,10,14,7,3,47,5.921509835274515,3.02604052545045,514
9,3,10,6,11,7,46,5.131239063044942,3.525143265282669,519
10,8,10,9,12,7,56,4.978984448927653,3.62372430115805,524
15,8,8,5,10,12,58,5.126158073595499,3.493342473256752,534
7,9,11,11,9,14,61,5.183781891251507,3.382243411990029,549
14,13,17,4,11,6,65,5.046966125311567,3.725317294255692,568
16,23,6,5,18,4,72,5.542700560992606,3.7380376767315195,559
2,17,4,5,16,6,50,5.286377049051005,4.085958029415197,582
5,11,2,8,1,3,30,5.10416212716153,4.5107526674614675,606
6,6,8,4,5,6,35,4.6537582348921545,4.799807586570581,619
14,9,8,11,3,8,53,4.689107324864098,4.85103214642229,648
8,5,8,16,10,12,59,4.645793850496714,4.700601695003593,655
9,10,8,9,21,14,71,4.8988312436167485,4.383888232633722,659
21,8,9,7,13,10,68,4.29844133672767,4.9641799142881755,677
17,11,4,5,12,7,56,4.040884855597967,5.731434242377964,670
6,10,6,10,4,7,43,3.943009483021144,6.1703829825843615,686
10,11,10,15,4,7,57,3.9881419907605067,5.875262482685335,699
11,20,12,8,5,6,62,4.012525963385027,5.871805127342651,694
9,19,9,11,13,10,71,4.412086222433186,5.565461342504438,701
12,23,10,16,6,10,77,4.681476570062253,5.41763234000497,740
18,19,7,8,11,8,71,4.607360027512062,5.548262183846368,758
5,12,3,6,12,7,45,4.145780418916835,6.478632602035709,767
7,7,13,6,7,6,46,4.078577759708483,6.432779006514578,781
5,9,16,4,5,7,46,3.9625918198194388,7.014963205671946,798
4,13,6,15,2,9,49,3.5626966384956122,7.455625486591321,810
12,7,1,19,2,10,51,3.1697810400613955,8.042694413487016,821
6,10,0,12,13,13,54,3.5258615793995016,7.729889498427361,837
13,13,7,14,22,13,82,3.7262529788299,7.7261665869543625,859
25,22,10,12,13,4,86,3.8632651446933175,7.466293457952053,862
12,22,7,5,10,8,64,3.841325746075453,7.905824994456774,880
10,20,5,12,3,6,56,3.8503447759035097,7.916925565305836,869
4,16,5,10,10,7,52,3.72705744757521,8.199576023437288,881
13,9,5,15,4,8,54,3.718512556761176,8.3307870057459,895
12,12,6,10,10,10,60,3.3088542558366547,8.633821534786012,901
7,7,7,13,7,9,50,3.0782571586416916,8.810523633109021,902
27,7,8,16,15,8,81,3.025570969661429,9.211205983425353,916
7,8,6,13,14,10,58,2.8785543588739,9.580853790420083,916
6,7,5,5,23,4,50,2.7067132348639307,9.84972226992523,918
5,9,2,4,5,8,33,2.74390846744261,10.257514246623487,949
8,23,1,5,3,4,44,2.8266546035880173,10.121225902854803,966
15,24,1,15,6,10,71,3.089481335064584,10.14165837166061,989
9,14,5,13,12,14,67,2.965956243702879,10.399288752049493,995
17,11,6,9,24,13,80,3.061341422271551,10.202808991435917,991
24,10,5,14,11,6,70,2.908100072103579,10.250750971050286,988
7,5,10,9,19,7,57,2.743275566068786,10.245046241984786,991
9,7,10,5,10,4,45,2.7360485643184287,10.849755375880648,1031
5,3,9,1,8,6,32,2.5632707194163826,11.19642693613073,1051
10,6,3,3,4,4,30,2.653985323683656,11.368368184359912,1089
8,8,11,15,5,13,60,2.7725329089253714,10.465589325408619,1090
13,7,9,10,8,13,60,2.509636529483543,11.563787255612075,1106
22,15,3,8,13,11,72,2.351621720185266,11.333041140574197,1083
8,22,0,13,10,6,59,2.564279664699854,11.674509302622791,1111
5,20,1,10,9,6,51,2.6229543264476445,12.35806729982081,1132
5,15,0,4,6,5,35,2.3902478916580807,12.96455944012103,1148
9,9,6,7,5,7,43,2.410166499865046,13.246884246822223,1160
5,7,15,3,3,12,45,2.240136556810478,13.713132936207224,1179
6,9,8,14,12,13,62,1.9269883760775024,14.12785408354933,1174
11,9,1,6,22,7,56,1.9042379708016026,14.484118994047382,1194
21,9,0,8,14,13,65,1.9121203127819244,14.681890536119376,1213
8,1,2,14,11,5,41,1.9732178329136114,14.765514676614858,1236
4,3,8,10,6,8,39,1.9432227965319666,15.145662538539154,1247
4,16,10,3,1,5,39,1.9412959557710585,14.944329898247293,1269
7,24,5,9,2,4,51,2.1913209075477322,14.823140623431303,1279
3,16,5,9,4,10,47,2.1338825645263215,14.71159929759341,1278
10,16,5,15,9,10,65,2.2273428753969933,14.783721981962694,1279
14,11,5,6,12,5,53,1.9720427285685291,14.825968674102771,1272
4,10,7,10,9,6,46,2.04409435546869,15.17844117487753,1298
4,6,4,10,11,6,41,1.920808358351241,15.81513241169183,1318
7,8,5,11,3,5,39,1.8063984559097879,16.002283457537413,1325
5,7,0,3,7,5,27,1.6801401375385443,16.96657383440775,1343
5,1,1,2,5,9,23,1.5897213923215643,17.290148846244865,1364
2,2,0,3,9,13,29,1.6044253189743314,17.779140940758445,1403
8,14,1,15,15,9,62,1.6610099675657386,17.527649723180225,1404
9,20,0,21,8,6,64,1.594284443433662,17.4972676659219,1383
4,20,1,6,4,7,42,1.6180101526461363,17.66361393129121,1410
0,13,4,11,4,8,40,1.7170429460256886,17.70741067796275,1428
3,10,5,5,0,7,30,1.7943882275200553,17.532132326973386,1440
4,8,6,4,7,6,35,1.6217419609596364,18.241111188996783,1466
3,9,5,1,5,9,32,1.54894564637511,18.76794915046403,1487
12,9,0,3,0,8,32,1.4325524439060806,19.23099704952864,1525
3,7,0,15,9,6,40,1.3977566109302493,19.204844105205183,1533
6,4,0,16,9,8,43,1.3586112424107488,19.646411989961376,1544
3,2,0,2,7,5,19,1.2487401801981677,20.290958562918775,1574
5,14,0,2,3,2,26,1.3062013176954161,20.078057827292135,1593
6,21,0,8,2,5,42,1.3835237198435228,20.06006835539384,1602
5,21,0,1,4,10,41,1.466890613813478,20.514772853622087,1626
4,7,0,0,9,11,31,1.4211236041662683,20.83632149671694,1649
7,9,0,1,10,7,34,1.2532714359525925,21.540104540642602,1673
7,8,0,10,8,8,41,1.2530601132757713,21.869043136421112,1685
3,8,0,13,15,8,47,1.2961193524415762,22.13495675701636,1696
3,7,0,0,8,7,25,1.1921848813634148,22.654909009640512,1719
4,10,0,2,6,6,28,1.1070373991755789,23.15667552277343,1733
8,2,3,5,4,7,29,1.041301730829124,23.527053144016392,1751
9,1,0,0,0,12,22,1.0062072372856832,23.94983593851571,1790
14,12,3,0,0,8,37,1.0023580732254491,24.061595848578314,1808
2,21,5,2,3,4,37,1.054933142225272,24.400701406209453,1821
0,17,5,10,10,7,49,1.1420413623877448,23.972600864428518,1830
3,16,5,13,2,4,43,1.1228680030519507,24.430358597304142,1829
0,11,7,0,0,6,24,1.1406756429021085,24.902343811473134,1862
0,5,1,1,0,5,12,0.9568158734266026,25.535226044337264,1877
0,9,0,3,1,7,20,0.8606105880403863,26.46275709403834,1912
0,6,1,0,11,11,29,0.8767182009817263,26.730826287079072,1930
6,9,1,0,18,3,37,0.8076598827093242,27.149856073922958,1943
11,2,0,2,10,5,30,0.6386596861055508,27.86146592378924,1953
3,0,0,4,0,2,9,0.6633321191678759,27.90625030822173,1977
0,14,0,0,0,5,19,0.661130215567517,28.204809398690287,1989
0,24,0,0,0,1,25,0.7136135350148418,28.37398342998991,2005
1,14,4,1,0,2,22,0.739925726843302,28.590811282466106,2020
1,2,7,0,0,5,15,0.7044642438253162,28.94831994274506,2049
0,7,5,2,0,2,16,0.6854869018133893,29.320383691266926,2065
0,3,5,0,0,4,12,0.6167565164128829,29.609435622193125,2085
0,4,1,0,0,4,9,0.590406602851823,29.881280997607718,2097
0,7,0,0,0,4,11,0.5201842465213146,30.485966562530518,2129
0,6,0,1,0,4,11,0.5159252971118953,30.80703228412915,2152
0,6,0,0,0,1,7,0.4819077767572679,31.29323744200221,2176
0,1,0,0,0,0,1,0.44400143874820314,31.86680410793246,2199
0,8,0,0,6,3,17,0.4109962653045368,31.998343309629803,2208
2,18,0,0,17,6,43,0.5220304330111646,32.06164792909753,2222
7,18,0,0,5,1,31,0.5274122410198329,32.02521370980824,2227
2,2,0,0,0,4,8,0.509974763877429,32.473681806925235,2249
0,5,0,0,0,3,8,0.4776035276830597,32.542977185178735,2269
0,4,0,1,0,3,8,0.4596828266047779,33.17803598539566,2284
0,4,0,1,6,4,15,0.4905601149213749,33.492599600204684,2306
8,7,0,0,0,3,18,0.4262723369744405,33.88077719638561,2322
4,3,0,0,0,3,10,0.35069683387253014,34.35901252520132,2331
0,3,0,0,0,6,9,0.3303973430165501,34.72114778894149,2351
0,1,2,0,0,1,4,0.30243697952970344,34.9152840665859,2378
0,8,5,0,0,7,20,0.33040909780100586,35.00237996037902,2389
0,16,5,0,0,2,23,0.43162515185721795,34.917351258527674,2404
0,14,5,0,0,5,24,0.5001618623151513,34.90210016186315,2418
0,16,5,0,0,5,26,0.5359229522867573,35.064212205114174,2433
0,7,6,0,7,2,22,0.48290173380472934,35.110753163815666,2440
2,5,0,0,13,2,22,0.4707745577802268,35.55459763916568,2455
7,5,0,0,10,1,23,0.4449792459960538,35.55440537926379,2461
0,2,1,0,4,6,13,0.4173072977953541,36.01191735818297,2475
0,7,0,0,3,5,15,0.33753864480566803,36.36040721158298,2479
0,3,0,0,3,3,9,0.33456647803334805,36.664359551410584,2500
3,1,0,0,2,2,8,0.301816781313911,37.00773252666379,2519
8,8,0,0,1,3,20,0.2819295499223736,37.037216134981605,2515
6,17,2,0,0,4,29,0.3671949900839092,36.92190236232403,2522
3,17,6,0,0,1,27,0.47380381116322073,36.580607334811596,2525
0,5,5,0,0,4,14,0.4499611811894462,36.71111097889072,2532
0,3,5,0,0,7,15,0.42724244611874507,37.08161065842229,2540
0,8,3,0,0,5,16,0.3821420686132878,37.27536159270404,2549
0,7,0,0,0,3,10,0.37770283948119937,37.520447578849094,2569
0,5,0,0,0,3,8,0.27744518866661166,38.01469593009891,2583
0,4,0,0,6,5,15,0.2770270135222383,38.361899046443845,2593
1,5,0,0,17,6,29,0.3214619694176608,38.83004919800426,2608
4,0,0,0,7,5,16,0.30679128280984524,38.84590625237422,2622
0,8,0,0,0,1,9,0.29811095821947364,39.09279478636719,2631
0,20,0,0,1,3,24,0.35502998137514796,39.06930543081382,2640
0,16,2,0,0,5,23,0.39382544099025457,39.11518973213435,2649
5,11,0,0,0,2,18,0.3549851491326854,39.45348199441672,2660
5,1,0,0,0,3,9,0.34139039178919334,39.67318815724928,2674
3,2,0,0,0,2,7,0.3374576753450238,39.97442722899446,2683
0,3,0,0,0,2,5,0.26701851548301503,40.17448599728042,2688
0,0,0,0,0,4,4,0.24741775739185654,40.465880985634506,2700
0,2,0,0,0,4,6,0.21553043349260895,40.76531328289475,2712
0,2,0,0,0,4,6,0.2363634636852679,40.87402007980489,2724
0,0,4,0,0,4,8,0.24724205845038413,40.91185359019312,2731
0,2,5,0,0,5,12,0.2384412881943132,40.897691024933195,2735
0,19,5,0,7,2,33,0.28654101389192826,40.358578756843514,2725
2,18,5,0,15,5,45,0.41798527088773074,40.0959284951876,2729
3,2,5,0,8,3,21,0.3898072273963413,40.14919263724206,2727
0,3,0,0,0,3,6,0.35441379451968436,40.41359062141912,2737
0,3,0,0,0,0,3,0.3151900053862591,40.792594100243804,2753
0,0,1,0,1,4,6,0.289355296685692,40.96612607509998,2760
8,1,0,0,5,4,18,0.2672892917483738,41.36082430491625,2767
6,3,0,0,1,4,14,0.20105210234674173,41.5941415349721,2770
4,0,0,0,0,4,8,0.21520789461621118,41.846667111774494,2787
0,0,0,0,0,5,5,0.22820039625922198,42.02712700842241,2802
0,2,1,0,0,4,7,0.22193447737691072,42.2405351019053,2811
0,18,4,0,0,2,24,0.25871140239202345,41.855317050819664,2810
0,16,5,0,0,2,23,0.30756088064516207,41.64203650009492,2807
0,3,5,0,0,5,13,0.29958063417632236,41.81607196411121,2816
0,2,5,0,0,4,11,0.286967271852724,41.65115580924382,2826
0,1,0,0,7,4,12,0.26471439320652673,41.91362605951484,2832
2,4,0,0,13,2,21,0.28719292669495855,42.056517517819664,2836
0,1,0,0,11,3,15,0.25717785208630906,42.288846400805014,2842
1,2,0,0,1,2,6,0.21615268829983245,42.459290200039796,2842
0,0,0,0,1,2,3,0.18622123291712242,42.53425940373969,2846
4,0,0,0,0,4,8,0.21097013763236955,42.649975005653744,2860
5,2,0,0,0,3,10,0.20423941874128038,42.72672929980255,2865
5,17,0,0,0,3,25,0.26092901445139777,42.59338767123755,2863
3,18,0,0,0,4,25,0.35205445454522327,42.44165241858075,2876
0,1,0,0,0,6,7,0.32468844318552836,42.761829284217384,2890
0,5,0,0,0,4,9,0.29245937262804644,42.92138946123755,2897
0,2,0,0,0,1,3,0.27670079679415754,43.1341186775577,2910
0,0,0,0,0,0,0,0.23677257169982985,43.385083551694585,2915
0,0,0,0,0,0,0,0.22978641172616276,43.68293671841796,2932
0,0,0,0,0,0,0,0.17947775030986574,43.99211842588567,2936
0,0,3,0,7,0,10,0.18111480985708545,43.971172209018704,2941
0,0,5,0,16,0,21,0.21427852800574718,43.90444155719468,2945
0,2,5,0,5,0,12,0.20502494877318742,43.88235531088319,2944
0,10,5,0,0,0,15,0.22360988474000268,43.67322920576761,2941
0,13,5,0,1,0,19,0.29205475395948693,43.27755052862394,2950
7,2,2,0,0,0,11,0.2747796949980078,43.53467641063161,2962
7,0,0,0,1,0,8,0.22706578698666338,43.91035391125203,2963
4,0,3,0,5,0,12,0.2070822003501905,44.068356321669455,2970
1,0,0,0,1,0,2,0.20454992637373448,44.26347929225943,2983
0,0,0,0,0,0,0,0.15911097992697898,44.5539231401185,2989
1,0,0,0,0,0,1,0.1596004881018408,44.886411267805954,3009
0,0,0,0,0,0,0,0.15122906866070585,45.05142026022478,3017
0,0,0,0,0,0,0,0.16654963829377742,45.104622309053156,3027
0,0,4,0,0,0,4,0.17294592813238469,45.20425343234932,3035
0,10,5,0,0,0,15,0.226356583294292,44.94492444538363,3041
0,14,5,0,6,0,25,0.27078962275488405,44.90931828711181,3041
0,2,4,0,15,1,22,0.2936625828761066,45.300961525760336,3045
0,1,1,0,5,2,9,0.23736391457232744,45.06104685970534,3044
0,0,0,0,1,1,2,0.1804925538448596,45.38983913179506,3055
0,0,0,0,2,1,3,0.18810318666224374,45.72295629259717,3062
10,0,0,0,4,0,14,0.17417315517867402,46.50276827150448,3079
5,0,0,0,6,1,12,0.12998261782003084,46.754116598300804,3081
7,1,0,0,1,0,9,0.12721388678258003,46.50374000353353,3088
3,0,0,0,0,0,3,0.09840376756617947,46.91535440563684,3096
0,0,0,0,0,0,0,0.09171428163105662,47.02856840382285,3106
0,11,1,0,0,0,12,0.155504451338258,46.86841927818677,3117
0,14,0,0,0,0,14,0.2139708504221694,47.14918063209581,3133
2,3,0,0,0,0,5,0.19970877797080125,47.16483105068722,3140
0,0,0,0,0,0,0,0.15432318700558972,47.42192800419538,3146
0,0,0,0,0,0,0,0.13322385722064806,47.687462944756,3158
1,0,0,0,6,0,7,0.12479946058153085,47.9665846094079,3167
0,0,0,0,8,0,8,0.11529341421441136,47.87661984124409,3171
0,0,2,0,14,0,16,0.14575289733063101,47.710470231742974,3170
0,0,5,0,1,0,6,0.10439701196455227,47.77120862976742,3167
4,0,5,0,0,0,9,0.09522557206323173,47.83491930217722,3170
5,0,5,0,0,0,10,0.08065980512753933,47.7990992082255,3163
5,10,5,0,0,0,20,0.11920678371974525,47.42834063849042,3156
1,13,3,0,0,0,17,0.16491538476002446,47.39379016239985,3163
0,2,0,0,4,0,6,0.18888093513943335,47.516733124751624,3170
0,0,1,0,7,0,8,0.1915462560723147,47.57328772224505,3176
0,0,5,0,0,0,5,0.15652292271168516,47.98325022306522,3181
0,0,2,0,0,0,2,0.14060941081822295,48.07294795834147,3189
0,0,0,0,0,0,0,0.1312416847730094,48.447319078718586,3200
0,0,0,0,0,0,0,0.0975071987780512,48.60302621405517,3206
0,0,0,0,0,1,1,0.06524548057962266,48.85923723420582,3213
1,0,0,0,8,0,9,0.09059463073752244,48.813198532187414,3212
1,0,0,0,11,0,12,0.09625616707148232,48.88991296053791,3223
0,9,0,0,6,1,16,0.16119170756417248,48.3996695091435,3214
0,10,0,0,1,0,11,0.1652498756856329,48.537073809226435,3222
7,0,0,0,0,0,7,0.14768712954332472,48.69901660264098,3230
4,0,0,0,0,0,4,0.12394182265677783,48.34848395606535,3230
0,0,0,0,1,0,1,0.1310720242787229,48.90319138736232,3242
0,0,0,0,3,0,3,0.12805989366780227,49.014949518378934,3246
0,0,0,0,0,0,0,0.11908449121931625,48.9635641912423,3255
0,0,0,0,0,0,0,0.12223743758764155,49.03440658456238,3266
0,0,0,0,0,0,0,0.16883536823402628,49.4864941672381,3278
0,0,0,0,0,0,0,0.17080174321348598,49.46776847348986,3281
0,0,0,0,0,0,0,0.16168016800385346,49.54444494892749,3286
0,7,0,0,0,0,7,0.17785386514518264,49.454450967160746,3285
0,14,1,0,0,0,15,0.2346800164175667,49.05618274930719,3294
1,5,0,0,6,0,12,0.22877222000256356,48.63744330777886,3298
0,0,0,0,9,1,10,0.19739848287561557,49.483358634698845,3315
0,0,1,0,8,0,9,0.2758666418678272,49.311611503445505,3328
0,0,0,0,4,2,6,0.28986174939437326,49.753219905130784,3347
8,2,1,0,3,1,15,0.28098760065602807,49.79033208825284,3352
6,0,4,0,5,1,16,0.2645525231013588,50.09597831800499,3362
2,1,5,0,4,1,13,0.21348175790847637,50.503196314478146,3363
2,0,5,0,0,0,7,0.1679043838971792,50.69638783724235,3367
0,0,5,0,0,0,5,0.15144033336363513,51.79224160256955,3373
0,3,4,0,0,0,7,0.13551343583948802,51.21678611066079,3378
0,0,1,0,0,0,1,0.11853054137927126,52.2025032507632,3385
4,0,0,0,4,0,8,0.11164942269344733,52.459023197510305,3388
0,0,5,0,0,0,5,0.0971218617328989,52.580111126937716,3397
0,0,0,0,0,0,0,0.10550117049634627,52.9930571185647,3412
0,0,0,0,0,0,0,0.09453351500743468,54.05141307550895,3422
0,0,0,0,5,0,5,0.05980470451069011,54.07377554241108,3429
0,0,0,0,5,0,5,0.0777624212305386,54.166143935814624,3434
0,0,0,0,7,0,7,0.044503091195154255,54.47895634905401,3435
3,0,0,0,0,0,3,0.05105570324628309,54.77756374019543,3449
1,0,0,0,0,0,1,0.05721476297651513,54.63622909726852,3449
0,0,0,0,0,0,0,0.044283430137924344,54.836582441878164,3457
0,0,0,0,1,0,1,0.041082473965356296,55.13593089351656,3466
0,0,0,0,4,0,4,0.05274286480077406,55.04049171795084,3475
1,0,0,0,0,0,1,0.0327470098279296,55.43488182619398,3492
0,0,0,0,0,0,0,0.046046791412715664,55.69902497826816,3505
0,0,0,0,0,0,0,0.02564664336250245,55.92963880203975,3514
0,0,0,0,0,0,0,0.02887107666091983,56.12166549837001,3524
0,0,0,0,0,0,0,0.020890843493150246,56.21535622757286,3527
0,0,0,0,0,0,0,0.026485220008525517,56.261190848105684,3534
0,0,1,0,0,0,1,0.029754596792955144,56.44430291994764,3544
0,0,1,0,3,0,4,0.0471825175897556,56.50251210442562,3550
0,0,0,0,6,0,6,0.05340545421479801,56.53398262542365,3554
0,0,0,0,6,0,6,0.0698739717949179,56.42902149857301,3553
3,0,0,0,1,0,4,0.05708518609195434,56.526639530676654,3558
1,0,0,0,0,0,1,0.042889112926286985,56.553925015927824,3559
1,0,0,0,0,1,2,0.044047838432659775,56.58772164668574,3563
0,0,0,0,0,0,0,0.035238974810747115,56.83301137975543,3568
0,0,4,0,0,0,4,0.030775861448325306,56.89206824417282,3572
0,0,5,0,0,0,5,0.03564925072631469,56.727610363616954,3571
0,0,5,0,0,0,5,0.037038899594781315,56.73946860006659,3568
0,0,5,0,0,0,5,0.040392370779987155,56.6343423205112,3569
0,0,5,0,0,0,5,0.077460785585842,56.50044987579156,3570
0,0,6,0,0,0,6,0.07959613536447091,56.42188655896667,3574
0,0,4,0,6,0,10,0.09046002382945625,56.611184934450044,3580
0,0,3,0,3,0,6,0.08556807656372227,56.825155881679095,3587
0,0,0,0,4,0,4,0.06538757845151648,56.91638936075965,3589
3,0,0,0,6,0,9,0.07243941484684625,56.84674002888335,3593
1,0,1,0,8,0,10,0.0633953158667458,57.0192162179999,3593
2,0,0,0,1,0,3,0.07330000604435961,56.982369196295885,3595
0,0,0,0,0,0,0,0.05879138843780936,57.04047621786211,3594
0,0,0,0,0,0,0,0.04040658655769477,57.28863483086765,3599
1,0,0,0,1,0,2,0.04075341654849817,57.44031196607471,3605
0,0,0,0,5,2,7,0.05503062688413182,57.26452332204958,3604
0,2,2,0,5,0,9,0.07414682042993,56.33541995817122,3605
0,0,7,0,0,0,7,0.06625046839509784,56.85068879639246,3609
0,0,2,0,0,0,2,0.10806111602226286,56.04124535051675,3624
0,0,0,0,0,0,0,0.05776762738797922,56.10836586475422,3625
0,0,0,0,0,0,0,0.04207634353861504,57.82858397043153,3635
0,0,0,0,0,0,0,0.027749003703827334,58.85857164515166,3644
0,0,1,0,0,0,1,0.014913438858767652,58.989460930730786,3646
0,0,0,0,5,0,5,0.036947198942921596,58.88795784488678,3649
0,0,0,0,5,0,5,0.03963280600061286,58.893454455973014,3650
0,0,2,0,6,0,8,0.05543197026291808,58.71895022629968,3646
2,0,0,0,0,0,2,0.0349079783678539,58.878793188187736,3650
0,0,0,0,0,0,0,0.035478254753358716,58.98153430276066,3654
0,0,0,0,0,0,0,0.025472134623818258,59.163709703428225,3659
0,0,1,0,0,0,1,0.022747660191369496,59.18433716570412,3664
0,0,0,0,0,0,0,0.026451637914797606,59.299308356946696,3667
0,0,0,0,0,0,0,0.032741643797843195,59.25930978103309,3669
0,0,2,0,0,0,2,0.028792885886517135,59.31161531303935,3675
0,0,5,0,0,0,5,0.03730234020187465,59.225136353817774,3674
0,0,5,0,0,0,5,0.024437793164367134,59.179374330277824,3669
0,0,5,0,0,0,5,0.032904116762292886,59.14518985149543,3669
0,0,5,0,0,0,5,0.024847279375739266,59.08377740919964,3666
0,0,3,0,0,0,3,0.027479967181168564,59.09110068307252,3668
0,0,0,0,6,0,6,0.033520331267556304,59.0908986374265,3673
0,0,1,0,6,0,7,0.03205148895242893,59.209944894754564,3675
2,0,0,0,8,0,10,0.0401266299918962,59.24288906058704,3671
1,0,0,0,0,0,1,0.0102264185508633,59.396860977779326,3672
0,0,0,0,1,0,1,0.022926697246487774,59.437199671888685,3680
1,0,0,0,1,0,2,0.015107897444386727,59.59699307082215,3685
0,0,0,0,2,1,3,0.02667532557641992,59.5984376865339,3691
0,0,1,0,7,0,8,0.0364934041768232,59.44024748988248,3690
0,0,0,0,3,0,3,0.045336456349048856,59.202866708726845,3688
3,0,0,0,1,0,4,0.04482912036472379,59.56298480598248,3695
0,0,0,0,0,0,0,0.028624197112918873,59.78689650884992,3701
0,0,0,0,0,1,1,0.018999311133617462,59.8953306415086,3701
0,0,0,0,0,0,0,0.021252030371254838,59.88919044019926,3706
0,0,0,0,0,0,0,0.03066618632890879,59.77587478325598,3712
2,0,0,0,0,0,2,0.026131492481809647,59.53585472805262,3718
0,0,0,0,3,1,4,0.02528655298875462,59.711661344672436,3719
0,0,0,0,4,1,5,0.023443788763773243,60.19354112441624,3720
0,0,0,0,1,1,2,0.019908621857263557,60.20162309420455,3722
0,0,0,0,0,0,0,0.015015777535410753,60.251650758008196,3723
0,0,1,0,0,1,2,0.025795178306112714,60.30124141471239,3733
1,0,1,0,0,1,3,0.01837914455076362,60.42237546624251,3736
0,0,0,0,1,0,1,0.03370949047109633,60.41843985297178,3744
0,0,2,0,4,0,6,0.03029841352862113,60.47163195864512,3742
0,0,0,0,1,0,1,0.016389038691207773,60.53894823303056,3743
1,0,0,0,0,0,1,0.024003743439857266,60.56321736086273,3746
0,0,0,0,0,0,0,0.012799417925387059,60.63400987184324,3750
0,0,1,0,0,0,1,0.025049559624043007,60.700539697770324,3758
1,0,4,0,0,0,5,0.026735698125026942,60.468708428149924,3754
0,0,6,0,0,1,7,0.04418629528937117,60.37085933536263,3755
0,0,5,0,0,0,5,0.05549192892773853,60.228761861003434,3756
0,0,5,0,5,1,11,0.058740389984218794,60.27363458132233,3752
1,0,5,0,1,0,7,0.08304658146425874,60.00269324083863,3756
0,0,1,0,1,0,2,0.06251141090811523,59.85266884494557,3756
0,0,0,0,1,0,1,0.04032235836524568,60.0961134449244,3759
0,0,0,0,0,2,2,0.0330085670644256,60.193370474980114,3764
0,0,0,0,1,1,2,0.029522094530105732,60.54319938016306,3767
0,0,1,0,2,0,3,0.023029429820038014,60.551929034692805,3768
0,0,1,0,8,0,9,0.03573373465816988,60.34985257591265,3765
0,0,0,0,4,0,4,0.05479296158690205,59.97856570924208,3769
0,0,0,0,6,1,7,0.10883982808403624,59.587136965611194,3773
0,0,0,0,0,0,0,0.0837804633158636,59.85325018243567,3781
0,0,0,0,0,0,0,0.02866529588163442,60.53326308791437,3783
1,0,0,0,0,1,2,0.03480091169545832,60.36187775116294,3783
0,0,0,0,0,0,0,0.03261951625460955,60.52791280866279,3790
0,0,0,0,0,0,0,0.012902199051925071,60.24052729403054,3790
0,0,0,0,1,0,1,0.014376090009434392,60.98923860986746,3793
0,0,0,0,0,1,1,0.016680752348464317,61.05181558581836,3797
0,0,1,0,0,2,3,0.009309250743506046,61.06741030790419,3796
0,0,0,0,0,0,0,0.01837146523976504,60.93006188982008,3803
0,0,0,0,0,0,0,0.027389346294884542,61.12463730508904,3808
0,0,1,0,1,1,3,0.021770834447160936,61.18722706400162,3808
0,0,1,0,2,0,3,0.016201387741743668,61.21834917249333,3810
0,0,1,0,11,0,12,0.060731337223646965,60.916988752919345,3808
0,0,2,0,12,2,16,0.06983088652854769,60.94323632752762,3811
1,0,7,0,2,1,11,0.06120039280362423,61.04636251414869,3815
0,0,7,0,0,0,7,0.047859826497217865,61.1071602371486,3816
0,0,0,0,0,0,0,0.03348135647828844,61.14352501892548,3823
1,0,0,0,0,1,2,0.017582263936079364,61.383102529851264,3823
0,0,0,0,0,0,0,0.020421151539808096,61.43001801807299,3826
0,0,4,0,0,0,4,0.012312309007271358,61.38020491074854,3824
0,0,6,0,6,0,12,0.017057178539611213,61.12239073733247,3813
0,0,5,0,0,0,5,0.029416744052858067,61.18182157741098,3817
1,0,5,0,1,0,7,0.03262074539800672,61.094593790916655,3815
0,0,5,0,0,0,5,0.029743787184523227,61.050296690620236,3811
0,0,2,0,0,1,3,0.03262478779693977,60.80627102404667,3807
0,0,0,0,0,1,1,0.027468847589271782,60.97671129789282,3810
0,0,0,0,2,0,2,0.01617958795166144,61.10668709049819,3813
0,0,0,0,9,0,9,0.07178010673628353,60.136885466277654,3814
0,0,1,0,5,1,7,0.07254981643458401,59.33811422778817,3817
1,0,2,0,6,0,9,0.05494422355937036,59.47467526079995,3818
0,0,2,0,0,1,3,0.04424394045588537,59.47559181075893,3821
0,0,0,0,0,0,0,0.04804182755230664,59.59348451432786,3828
0,0,0,0,0,2,2,0.038998767018712854,59.745479380064744,3829
0,0,0,0,0,0,0,0.053550458660693176,58.29360079647927,3825
0,0,0,0,0,0,0,0.04299635938296105,58.546922864093595,3826
0,0,0,0,5,0,5,0.049613049156139476,59.15270925252572,3829
0,0,0,0,0,0,0,0.041357759026360456,58.55016383479419,3834
0,0,1,0,2,1,4,0.03340142354722062,59.85941453652254,3835
0,0,0,0,1,0,1,0.025042680254841784,59.322728621287,3836
0,0,0,0,0,0,0,0.019032455317648373,58.82854214081337,3837
0,0,0,0,0,0,0,0.024263016209677885,59.441065015802444,3842
0,0,0,0,1,0,1,0.029422090287371132,59.52537544597828,3848
0,0,0,0,10,0,10,0.04611248906321284,59.38598364089124,3845
0,0,2,0,2,0,4,0.049595029361036894,59.738753133197434,3848
0,0,5,0,0,0,5,0.04985408049668313,59.94636118556142,3856
1,0,1,0,0,0,2,0.0373422465120381,60.0800645343109,3857
0,0,0,0,0,0,0,0.03094732998724704,60.136101232699346,3859
0,0,0,0,0,0,0,0.027726528004548955,60.21120562143144,3864
0,0,1,0,0,0,1,0.029507776946360302,60.22700679482279,3866
0,0,0,0,0,0,0,0.02116095633930325,60.29175326587371,3868
0,0,0,0,6,0,6,0.020721208977575765,60.29306601883163,3865
0,0,2,0,0,0,2,0.029273806400589842,60.32067627257969,3871
0,0,4,0,0,0,4,0.03422127801119405,60.10847867138428,3866
0,0,5,0,1,0,6,0.02734683731675555,60.09386187801456,3863
1,0,5,0,0,0,6,0.04103818518441018,60.0522943669209,3865
0,0,5,0,0,0,5,0.04130762277862503,59.97471316436632,3860
0,0,3,0,2,0,5,0.047884892284286086,59.89540539775114,3862
0,0,2,0,5,0,7,0.06293919354765642,59.781979233491114,3859
0,0,1,0,5,0,6,0.10551463622219727,59.53685793083016,3865
0,0,1,0,5,0,6,0.09177692621179573,59.650403052432324,3866
0,0,1,0,1,0,2,0.12288531944859242,58.42524195264297,3870
0,0,0,0,0,0,0,0.11689652023262354,57.70369493178059,3872
0,0,0,0,0,0,0,0.11030601910329271,58.03884884861697,3877
1,0,0,0,0,0,1,0.10095295672429926,58.139934696932876,3883
0,0,0,0,0,0,0,0.10821084000775653,58.39629449945919,3885
0,0,0,0,3,0,3,0.1087077233328608,58.32243980480524,3879
0,0,0,0,1,0,1,0.09120533388699784,58.5066729434555,3885
0,0,0,0,0,0,0,0.09955926475758667,58.60279677061597,3892
0,0,0,0,0,0,0,0.10110832000587908,58.8179661179091,3895
0,0,0,0,0,0,0,0.10679950460260977,58.90174150904529,3898
0,0,0,0,0,0,0,0.08520152379486245,58.958421307424075,3899
0,0,0,0,1,0,1,0.05957571110548978,59.2727285331551,3902
0,0,0,0,0,0,0,0.04777644495458422,59.507622168262614,3903
0,0,0,0,0,0,0,0.038096901617682054,59.629910665068856,3905
0,0,0,0,0,0,0,0.03443470722489318,59.863229036764096,3909
0,0,1,0,0,0,1,0.021439323338309856,59.92740140246896,3911
0,0,1,0,0,0,1,0.01573237244545908,60.019086971259696,3916
0,0,0,0,0,0,0,0.014179731075379504,60.97670273772291,3916
0,0,0,0,0,0,0,0.012007918555332993,60.99247693794391,3916
0,0,0,0,0,0,0,0.01967241724588215,61.00810539134633,3920
0,0,0,0,2,0,2,0.021228632855511433,61.011241971578954,3923
0,0,0,0,1,0,1,0.01946863465807987,61.04270093455101,3921
0,0,0,0,0,0,0,0.02115997605566535,61.10553911561917,3925
0,0,1,0,0,0,1,0.02126005956634925,61.13815505503722,3928
0,0,4,0,1,0,5,0.02588222342832729,60.98337067049278,3925
0,0,5,0,1,0,6,0.031727783839696315,60.87729526396172,3922
0,0,5,0,2,0,7,0.030177811195810738,60.8704664545293,3920
0,0,5,0,0,0,5,0.03604991301081947,60.69710234281633,3919
0,0,5,0,4,0,9,0.09240005275088232,60.03689542297814,3912
0,0,0,0,6,0,6,0.08639082200155165,60.0127725247936,3914
1,0,0,0,5,0,6,0.09280127674100604,59.96199054631289,3922
0,0,0,0,0,0,0,0.09897449442513344,60.37701879037088,3925
0,0,1,0,0,0,1,0.05497520547330218,61.99666028093593,3927
0,0,0,0,0,0,0,0.056583686169339,62.444746713261665,3933
0,0,0,0,0,0,0,0.04905201044843327,62.76659181385157,3935
0,0,0,0,0,0,0,0.018458164889954613,62.94570991794036,3938
0,0,0,0,0,0,0,0.03464655901505588,62.768511227756925,3941
0,0,0,0,0,0,0,0.022581139737202865,62.770230331816975,3942
0,0,0,0,0,0,0,0.023158384746543647,62.51597498379418,3947
0,0,0,0,0,0,0,0.035770533724895935,62.544503191351865,3952
1,0,0,0,0,0,1,0.03070301760846909,62.5872652371802,3956
0,0,0,0,1,0,1,0.016139865998883497,62.706698718879,3958
0,0,0,0,0,0,0,0.0257714400842824,62.7513482946238,3963
0,0,0,0,0,0,0,0.02139026501221525,62.798293148223166,3964
1,0,0,0,2,0,3,0.018434727997976925,62.77905017239657,3966
0,0,0,0,0,0,0,0.023560222661733302,62.9020860812341,3970
0,0,0,0,0,0,0,0.015724191523452054,62.9694013842885,3973
0,0,0,0,0,0,0,0.012147383653800893,63.04642855537631,3976
0,0,1,0,0,0,1,0.006645284479830482,63.07754192167775,3976
1,0,0,0,0,0,1,0.009068948632562041,63.133134322795975,3982
0,0,0,0,0,0,0,0.009109695824173253,63.16637122772142,3982
0,0,0,0,0,0,0,0.009130097229039352,63.16773544905629,3982
0,0,0,0,0,0,0,0.017445320680655067,63.16776161356544,3985
0,0,0,0,0,0,0,0.02029789857513464,63.170516917537675,3989
0,0,0,0,0,0,0,0.021539822672019468,63.24874074452566,3993
0,0,0,0,0,0,0,0.021174855397935174,63.26443118222299,3995
0,0,4,0,0,0,4,0.027815270309988854,63.215513731720264,3995
0,0,5,0,0,0,5,0.021011612875368513,62.845761691382165,3989
0,0,5,0,0,0,5,0.03051706231202724,62.74587149902733,3988
0,0,5,0,1,0,6,0.05832179920720742,62.57257500662899,3989
0,0,6,0,0,0,6,0.05470887079512897,62.35641228791574,3987
0,0,3,0,0,0,3,0.056834429655881966,62.33362467066418,3991
0,0,0,0,0,0,0,0.03603612434903388,62.94340627008896,3992
0,0,0,0,0,0,0,0.022428142792511402,63.203026132893854,3993
0,0,0,0,0,0,0,0.02266945030511334,63.280627322404484,3997
0,0,0,0,0,0,0,0.013971891792861818,63.40349746012555,4000
0,0,0,0,0,0,0,0.013693704569475242,63.407659871526995,4001
0,0,0,0,0,0,0,0.014680824551028497,63.423491571125005,4005
0,0,0,0,0,0,0,0.02757659328457571,63.4704818783326,4011
0,0,0,0,0,0,0,0.02668507066524733,63.517438775228484,4013
0,0,1,0,0,0,1,0.029629183481719352,63.54344255061497,4018
0,0,0,0,0,0,0,0.026195387739055873,63.59043553048376,4020
0,0,0,0,0,0,0,0.023651775670648082,63.63209049321387,4022
0,0,0,0,0,0,0,0.020704015058725215,63.710890407689796,4026
0,0,0,0,7,0,7,0.030170349245349514,63.46793020816399,4023
1,0,0,0,1,0,2,0.027952690887478947,63.61611064808971,4027
0,0,0,0,0,0,0,0.017290890216925127,63.69002838145373,4029
0,0,0,0,0,0,0,0.01496566922695721,63.82861509707721,4030
1,0,0,0,0,0,1,0.016772348014723673,63.85461140152655,4035
0,0,0,0,0,0,0,0.02067891916718281,63.79387363909013,4037
1,0,0,0,0,0,1,0.013577831975976427,63.872215648269666,4038
0,0,1,0,0,0,1,0.005249065565239254,63.9245367019337,4040
0,0,1,0,0,0,1,0.000599827439745308,63.97171131484729,4041
0,0,0,0,0,0,0,0.01051232538312096,63.971736276725856,4044
0,0,0,0,0,0,0,0.011618263608240614,64.05000979877227,4049
0,0,0,0,0,0,0,0.015631865518046996,64.05003105828776,4051
0,0,0,0,0,0,0,0.006010582413576552,64.11589904472967,4053
0,0,0,0,0,0,0,0.009501027508071073,64.1398612515576,4056
0,0,2,0,0,0,2,0.013776624414000753,64.11220632003923,4057
0,0,5,0,8,0,13,0.03076541003523309,63.792950822689725,4046
0,0,5,0,0,0,5,0.028196201010483722,63.78481792741357,4046
0,0,5,0,0,0,5,0.01864365193619004,63.72598073665965,4040
0,0,5,0,0,0,5,0.0181437535876061,63.640403267332424,4035
0,0,3,0,0,0,3,0.018742863626124144,63.561841373288814,4034
0,0,0,0,0,0,0,0.019638304387231183,63.6914100693207,4036
0,0,2,0,0,0,2,0.0029183410187590937,63.871400462017476,4036
0,0,0,0,0,0,0,1.2810483026472935e-06,63.902534529019434,4037
0,0,0,0,0,0,0,0.0021555781581999215,63.902554890319294,4038
0,0,0,0,0,0,0,0.002002212017457382,63.92856040632878,4041
0,0,0,0,0,0,0,0.012092773922887724,63.95987717314761,4046
0,0,0,0,0,0,0,0.014663115902837379,63.97555560955029,4047
0,0,1,0,0,0,1,0.022401062393674297,63.97557058005914,4050
0,0,0,0,0,0,0,0.016323012949279393,64.01478626397403,4052
0,0,1,0,0,0,1,0.011964318822664717,64.03047463332638,4051
0,0,0,0,3,0,3,0.003910863352138006,64.05936013878443,4050
1,0,0,0,0,0,1,0.01648600017794309,64.08683599098447,4058
0,0,1,0,0,0,1,0.015424377386603868,64.05537526753847,4058
0,0,0,0,0,0,0,0.005205456103250437,64.17081269606277,4059
0,0,0,0,0,0,0,0.0064743187122131745,64.18647040986737,4061
0,0,0,0,0,0,0,0.007627843004162309,64.21779126104941,4063
0,0,0,0,0,0,0,0.005723890923191331,64.23349373475054,4064
0,0,0,0,0,0,0,0.002750277208653261,64.29079684068483,4065
0,0,0,0,0,0,0,0.0016260530013317805,64.3064514110617,4066
0,0,0,0,0,0,0,0.005748766909694201,64.3064725634405,4067
0,0,0,0,0,0,0,0.006057704983150099,64.33777269098776,4069
0,0,0,0,0,0,0,0.017938239304205513,64.337788096777,4073
0,0,0,0,0,0,0,0.01351908953401812,64.37211603391484,4076
0,0,0,0,0,0,0,0.008756265487525308,64.41670910013396,4076
0,0,1,0,0,0,1,0.0022730869093730813,64.4482225993652,4076
0,0,0,0,4,0,4,0.004185333202495004,64.36850618667962,4071
0,0,1,0,0,0,1,0.00533285999319084,64.38739873386805,4074
0,0,4,0,0,0,4,0.013583240941766866,64.17354318174856,4069
0,0,5,0,0,0,5,0.032126407824723376,64.06168346073157,4072
0,0,5,0,0,0,5,0.03836437002778206,63.92183741796531,4072
0,0,5,0,0,0,5,0.028268704252086427,64.09846944228951,4072
1,0,5,0,0,0,6,0.02474915084153697,63.86568121066971,4067
1,0,0,0,0,0,1,0.020548096500038034,64.05507345542358,4068
4,0,0,0,0,0,4,0.029234061964187517,64.06397796677243,4068
2,0,0,0,4,0,6,0.0376300280964059,63.869995141018066,4068
4,0,1,0,1,0,6,0.04218976654377324,64.00822752201383,4077
3,0,0,0,2,0,5,0.042788054936674536,64.06350269551886,4080
2,0,0,0,3,0,5,0.03638841832262106,64.10043637520107,4079
3,0,0,0,4,0,7,0.05416653847473726,64.12181660497671,4085
0,0,0,0,0,0,0,0.03011561988216847,64.43536601341432,4087
2,0,0,0,6,0,8,0.034588903212261594,64.43514610649756,4089
1,0,0,0,4,0,5,0.04091110400928829,64.49834162417152,4095
0,0,0,0,0,0,0,0.01444819642823024,64.71186120380344,4093
0,0,0,0,0,0,0,0.015305330540375906,64.74323874824483,4096
0,0,0,0,0,0,0,0.014931746466186238,64.7588915639531,4097
0,0,0,0,0,0,0,0.009713455387942091,64.79055118119328,4097
0,0,0,0,0,0,0,0.008460275281007127,64.8005674356448,4097
0,0,0,0,0,0,0,2.1942687376132675e-05,64.84782265490824,4098
0,0,0,0,0,0,0,0.005321350450150156,64.84752122750574,4099
0,0,0,0,0,0,0,0.012256471914774136,64.84753619871208,4102
0,0,0,0,0,0,0,0.008008617403760705,64.89453438227595,4103
0,0,1,0,0,0,1,0.00788897100424267,64.9281092878357,4106
0,0,1,0,0,0,1,0.007089539174266158,64.94713966796719,4107
0,0,0,0,0,0,0,0.003958677656978094,64.97851203302655,4107
0,0,0,0,0,0,0,0.0044642278321654775,64.99414814564534,4108
0,0,0,0,3,0,3,0.01869059450915351,64.9240143688331,4111
0,0,0,0,0,0,0,0.024247007448469592,64.94927607068786,4116
0,0,0,0,0,0,0,0.019244251459769858,65.04276050577785,4121
0,0,0,0,0,0,0,0.01246596616827957,65.1367306541373,4123
0,0,3,0,0,0,3,0.017067677221449452,65.06373234479923,4123
0,0,5,0,0,0,5,0.01950853563528521,64.96001071628453,4119
0,0,5,0,0,0,5,0.013723188602883225,64.99132853350851,4116
0,0,5,0,0,0,5,0.004090167389172714,65.00698949762219,4111
0,0,2,0,0,0,2,0.01547920922206075,64.73940857292077,4113
1,0,0,0,0,0,1,0.03528223640679963,64.6785188860945,4114
5,0,0,0,0,0,5,0.032249704512214816,64.56592533654263,4109
3,0,0,0,4,0,7,0.05859860442794125,64.47181635857882,4113
6,0,0,0,3,0,9,0.0735878747208531,64.36152589688488,4119
4,0,0,0,0,0,4,0.07875469561000238,64.575361654156,4124
6,0,0,0,0,0,6,0.060487782341115744,64.54940997570488,4122
7,0,0,0,7,0,14,0.06768213309864614,64.6754319573517,4130
2,0,0,0,9,0,11,0.049664463945844575,65.32510716169757,4140
1,0,0,0,6,0,7,0.023384129301781967,65.54937949006707,4146
2,0,0,0,2,0,4,0.008541384295440322,65.87598414310565,4150
0,0,0,0,2,0,2,0.014415268293089402,65.92724353826551,4155
0,0,0,0,0,0,0,0.0068085178184108235,65.89262990168774,4157
0,0,0,0,0,0,0,0.01151359513704427,66.02270955376981,4159
0,0,0,0,0,0,0,0.00648622867268917,66.03838733234498,4159
1,0,0,0,0,0,1,0.0089330017511558,66.06989980222781,4161
0,0,0,0,0,0,0,0.009536212815386613,66.08554811492318,4162
0,0,0,0,0,0,0,0.00814055459709573,66.13316306972665,4165
0,0,0,0,0,0,0,0.00947380106895547,66.13257436245281,4166
0,0,0,0,0,0,0,0.0028419464147736015,66.16386559788641,4164
0,0,0,0,0,0,0,4.784701022075066e-07,66.16388177914727,4163
0,0,0,0,0,0,0,0.005995558344506131,66.16389547627186,4166
0,0,0,0,5,0,5,0.01690868042262813,66.09647850088147,4166
0,0,0,0,0,0,0,0.005204398771544736,66.22001358197197,4168
0,0,0,0,0,0,0,0.00332528837001472,66.10093661294874,4166
0,0,0,0,0,0,0,0.005430511053397907,66.24337498335198,4169
0,0,0,0,0,0,0,0.005336564845805489,66.25902498883146,4170
0,0,0,0,0,0,0,0.007677529003278329,66.14788666742592,4171
0,0,2,0,0,0,2,0.009855818424518598,66.11757862798889,4171
0,0,4,0,0,0,4,0.0041186099425016024,66.13788589029457,4168
0,0,0,0,0,0,0,0.007891237997922042,66.15351891280251,4170
0,0,0,0,0,0,0,0.0036474786791961316,66.16386498334694,4171
0,0,0,0,0,0,0,0.0028772687561713925,66.18896053571196,4171
0,0,0,0,0,0,0,0.003465991517926304,66.15847722765645,4172
1,0,0,0,0,0,1,0.0011405946540106653,66.20459394643707,4171
0,0,0,0,0,0,0,0.006783808503815323,66.19720886566392,4174
1,0,0,0,0,0,1,0.013802151432743976,66.22535117982933,4179
0,0,0,0,0,0,0,0.007792489087485834,66.2200811144809,4179
0,0,0,0,0,0,0,0.006324477470194529,66.30066134540681,4181
0,0,0,0,0,0,0,0.005728845717304233,66.30048478098055,4181
0,0,0,0,0,0,0,0.002374453010292116,66.33177547686786,4182
0,0,0,0,0,0,0,0.0017266165693846918,66.34742703668569,4183
0,0,0,0,0,0,0,0.004915804471312856,66.36307383254332,4185
0,0,0,0,0,0,0,0.0055729233166213294,66.36308488348902,4185
0,0,0,0,0,0,0,0.003017212099363595,66.38683371469459,4186
0,0,0,0,0,0,0,0.0028715064466910425,66.3864707845393,4186
0,0,0,0,0,0,0,0.0030719933629827765,66.40250618348549,4189
0,0,0,0,0,0,0,0.009159398873470727,66.38947878089847,4191
0,0,0,0,0,0,0,0.009399297461144034,66.46472871491612,4194
0,0,0,0,0,0,0,0.00463358855212848,66.49601152121267,4195
0,0,0,0,0,0,0,0.005729395720319176,66.51164880150431,4196
0,0,0,0,0,0,0,0.009785030045485588,66.55065108507792,4200
0,0,0,0,1,0,1,0.001171420303127075,66.61323604259857,4201
0,0,2,0,0,0,2,0.0026516232287545974,66.59229507279638,4201
0,0,1,1,0,0,2,0.012768740857033972,66.63921971341156,4207
0,0,0,0,0,0,0,0.009500999904009926,66.67049746881385,4209
0,0,0,0,0,0,0,0.005435623117627995,66.70951384293099,4210
0,0,0,0,0,0,0,0.005625701845383932,66.72515265005723,4210
0,0,0,0,0,0,0,7.616482466913564e-05,66.75661917623381,4210
0,0,0,0,0,0,0,5.173981391610948e-07,66.75643630178423,4210
0,0,0,0,0,0,0,0.0008763689269466557,66.75643803852562,4211
0,0,0,0,0,0,0,2.7830482393979132e-05,66.7724125892129,4211
0,0,0,0,0,0,0,0.0010349624803275628,66.78775679703958,4213
0,0,0,0,0,0,0,0.0016599982951719951,66.7877587602046,4214
0,0,0,0,0,0,0,0.006213035027286367,66.8190381430898,4217
0,0,0,0,0,0,0,0.0029309421141989573,66.83467595187088,4216
0,0,0,0,0,0,0,0.0027779181313981327,66.83467582048381,4216
0,0,0,0,1,0,1,0.0030012620232048193,66.8807500452145,4218
0,0,0,0,0,0,0,0.0031109543788608264,66.89641373619786,4220
0,0,0,0,0,0,0,0.002918701065854061,66.89638852689009,4220
1,0,0,0,0,0,1,0.0027790401538153662,66.92768864435709,4222
0,0,0,0,0,0,0,0.0015374082310393071,66.9276883312391,4222
0,0,0,0,0,0,0,0.0018520955721082037,66.95896710312299,4224
0,0,0,0,0,0,0,2.6208074210451245e-07,66.97460644736242,4224
0,0,0,0,0,0,0,0.0020325030516111665,66.97460621451619,4225
0,0,0,0,0,0,0,2.0284532685819677e-07,66.99024460204602,4225
0,0,0,0,0,0,0,0.001954052252826092,66.99024352061035,4226
0,0,0,0,0,0,0,0.006250901896334286,67.0058824195941,4230
1,0,0,0,0,0,1,0.005716916867324074,67.03185510627061,4230
0,0,0,0,0,0,0,0.009501607811678492,67.02151986104263,4231
0,0,0,0,0,0,0,0.011190615213326514,67.05297704153351,4233
0,0,0,0,0,0,0,0.005455132192273685,67.06556894830251,4232
0,0,0,0,0,0,0,0.008092023545320473,67.06556922476521,4233
0,0,0,0,0,0,0,0.002777810214736388,67.0906023041815,4233
0,0,0,0,0,0,0,9.978144085189749e-08,67.0905205142554,4233
0,0,0,0,0,0,0,0.0012791366127885056,67.09052018484395,4233
0,0,0,0,0,0,0,1.4444573736760978e-07,67.10615868213475,4233
0,0,0,0,0,0,0,0.0007858349296294414,67.10615839167934,4235
0,0,0,0,0,0,0,0.0060003175251192985,67.12184823706869,4237
0,0,0,0,0,0,0,0.002884673088772352,67.12184943683945,4235
0,0,0,0,0,0,0,0.00368848298636036,67.12184899596983,4236
0,0,0,0,0,0,0,1.0316860734642323e-07,67.15312594629758,4236
0,0,0,0,0,0,0,0.005590804028732794,67.1531251665865,4238
0,0,0,0,0,0,0,0.010687208490886963,67.15312487981953,4241
0,0,0,0,0,0,0,0.007082190864476085,67.18440155516336,4241
0,0,0,0,0,0,0,0.0028261736530224096,67.18440302641348,4240
0,0,0,0,0,0,0,0.0025739573193028402,67.18440190785346,4240
0,0,0,0,0,0,0,0.0012325592943910185,67.21567878032545,4241
0,0,0,0,0,0,0,0.005722732475100936,67.21567903441442,4242
0,0,0,0,0,0,0,6.403329964925065e-07,67.23131962977948,4241
0,0,0,0,0,0,0,0.002646895157104223,67.23131656864236,4243
0,0,0,0,0,0,0,0.004250740641243187,67.24695440430796,4244
0,0,0,0,0,0,0,0.00869124683837751,67.24695661649996,4246
0,0,0,0,0,0,0,0.008672115208114855,67.26259927815816,4246
0,0,0,0,0,0,0,0.009211616000843956,67.26259301836792,4247
0,0,0,0,0,0,0,0.017362183455226873,67.27824694474728,4251
0,0,0,0,0,0,0,0.010746821662023289,67.34082120974641,4253
0,0,0,0,0,0,0,0.0006931613048987045,67.38510351749586,4251
0,0,0,0,0,0,0,1.9224645788942375e-07,67.38774823211462,4251
0,0,0,0,0,0,0,0.002783108000208156,67.38776190289325,4252
0,0,0,0,0,0,0,0.0048322122034933955,67.40341419911788,4254
0,0,0,0,0,0,0,3.871848434907756e-05,67.45069129986028,4255
0,0,0,0,0,0,0,0.0028701592847420955,67.45035103143937,4256
0,0,0,0,0,0,0,0.00281990902109873,67.46600143850652,4257
0,0,0,0,0,0,0,0.0022068998790331436,67.466013022829,4257
0,0,0,0,0,0,0,4.391901865094e-07,67.48168113854533,4257
0,0,0,0,0,0,0,0.003120682768054627,67.48168840490548,4259
0,0,0,0,0,0,0,0.008468115541779103,67.49733495289111,4261
0,0,0,0,0,0,0,0.005707018563642116,67.49734333411006,4263
1,0,0,0,0,0,1,0.007011993391727609,67.56016312690709,4265
0,0,0,0,0,0,0,0.00288168125273615,67.5755595419049,4264
0,0,0,0,0,0,0,0.002613400889684033,67.59121169866394,4265
0,0,0,0,0,0,0,0.0038778252122759886,67.6068661467317,4267
0,0,0,0,0,0,0,0.005582360175305487,67.60687387327812,4267
0,0,0,0,0,0,0,1.81813955374212e-07,67.62252061349703,4266
0,0,0,0,0,0,0,0.001078048172799748,67.62252914737644,4267
0,0,0,0,0,0,0,0.0003588406694533733,67.64660052391083,4269
0,0,0,0,0,0,0,0.0027869880441104976,67.6466131327025,4269
0,0,0,0,0,0,0,0.0027525215055780126,67.66226578585328,4270
0,0,0,0,0,0,0,0.0027001581951576928,67.66226804684584,4270
0,0,0,0,0,0,0,0.0028481150705439206,67.66227919194122,4270
0,0,0,0,0,0,0,1.124970312212511e-06,67.677927833732,4270
0,0,0,0,0,0,0,1.642898982749597e-07,67.67793415705779,4270
0,0,0,0,0,0,0,0.0009751911293598772,67.67794636561962,4271
0,0,0,0,0,0,0,0.0035512111645403335,67.67795616167857,4272
0,0,0,0,0,0,0,0.005306709527179515,67.677966394771,4272
0,0,0,0,0,0,0,0.0029014394430563173,67.67797406304325,4271
0,0,0,0,0,0,0,0.0010002497394559445,67.69362396803676,4272
0,0,0,0,0,0,0,0.002758654497050705,67.69363367664761,4272
0,0,0,0,0,0,0,0.009032169248809556,67.6936467451694,4275
0,0,0,0,0,0,0,0.002612749769671007,67.73412496882948,4275
0,0,0,0,0,0,0,7.235230672803242e-08,67.74976536819082,4275
0,0,0,0,0,0,0,0.0009985797326312765,67.74976490544563,4276
0,0,0,0,0,0,0,0.002821963445019653,67.74976394917327,4276
0,0,0,0,0,0,0,4.000165755803289e-07,67.74976528958675,4275
0,0,0,0,0,0,0,0.0029090068918873366,67.74976300827872,4276
0,0,0,0,0,0,0,0.005599933875175998,67.7497633421748,4278
0,0,0,0,0,0,0,0.008114876896760792,67.7600986637116,4279
1,0,0,0,0,0,1,0.0023843259147614745,67.791583945472,4279
0,0,0,0,0,0,0,2.72262602990503e-08,67.79137569674586,4278
0,0,0,0,0,0,0,3.335062789095074e-07,67.80709466088832,4279
0,0,0,0,0,0,0,0.005685091420018986,67.8070945409391,4281
2,0,0,0,0,0,2,0.007646954657674631,67.79675920260938,4282
0,0,0,0,0,0,0,0.0014298073312784857,67.82805363636504,4281
0,0,0,0,0,0,0,0.002817875009583474,67.85932928115038,4283
0,0,0,0,0,0,0,0.0026459967766526106,67.85932902456163,4283
0,0,0,0,0,0,0,0.0001484034705044027,67.85933129060464,4284
1,0,0,0,0,0,1,0.0026868318640237625,67.87496715334053,4284
0,0,0,0,0,0,0,0.002889427182703547,67.87496623356387,4284
0,0,0,0,0,0,0,0.0028779510585348316,67.87496823755747,4284
0,0,0,0,0,0,0,0.0016086443445461629,67.89060852488872,4287
0,0,0,0,0,0,0,0.002769142994533717,67.92210795899143,4287
0,0,0,0,0,0,0,0.005629730343457093,67.92210742218757,4288
0,0,0,0,0,0,0,0.004721527586563132,67.92210802123836,4290
0,0,0,0,0,0,0,0.002703464129829478,67.95339857581804,4289
0,0,0,0,0,0,0,0.0013588042228255043,67.95339844933147,4289
0,0,0,0,0,0,0,0.007535583309987973,67.95339961240681,4291
0,0,0,0,0,0,0,0.005462305619146538,67.96903863449705,4291
0,0,0,0,0,0,0,0.0,68.00133670249896,4291
0,0,0,0,0,0,0,2.3273759790655263e-07,68.0013357070535,4291
0,0,0,0,0,0,0,0.005498917746160627,68.00133701338433,4293
0,0,0,0,0,0,0,0.00575308146366788,68.01583320105111,4294
0,0,0,0,0,0,0,0.0028926738243233805,68.01583342749954,4294
0,0,0,0,0,0,0,0.0026009886190151944,68.03147169136649,4294
0,0,0,0,0,0,0,0.001937510610392977,68.03147060158861,4295
0,0,0,0,0,0,0,1.38376913583153e-07,68.17384410464331,4295
0,0,0,0,0,0,0,1.4434116731573212e-07,68.17384609476069,4295
0,0,0,0,0,0,0,1.4858840873988418e-07,68.17384366923326,4295
0,0,0,0,0,0,0,3.1976032638167216e-06,68.1815225191939,4296
0,0,0,0,0,0,0,0.00072104417923114,68.1815225191939,4297
0,0,0,0,0,0,0,0.0,68.19759085348183,4297
0,0,0,0,0,0,0,0.0,68.19759085348183,4297
0,0,0,1,0,0,1,0.0001700412463960146,68.22887333842367,4299
0,0,0,0,0,0,0,0.00025631607849737524,68.22886738131659,4300
0,0,0,0,0,0,0,0.0006474316216939426,68.24450651480979,4301
0,0,0,0,0,0,0,0.002847723551793953,68.26014472990065,4302
0,0,0,0,0,0,0,0.0024197133498159037,68.27578331146846,4303
0,0,0,0,0,0,0,0.0,68.29142894784174,4303
0,0,0,0,0,0,0,0.0,68.29142894784174,4303
0,0,0,0,0,0,0,0.0,68.29142894784174,4303
0,0,0,0,0,0,0,0.00449878526337739,68.29142894784174,4305
0,0,0,0,0,0,0,0.005251800557782357,68.29142894784174,4305
0,0,0,0,0,0,0,0.0021178581660291134,68.29142894784174,4305
0,0,0,0,0,0,0,0.0033053285106304565,68.32273143498658,4307
0,0,0,0,0,0,0,0.005421018684503458,68.32273143498658,4307
0,0,0,0,0,0,0,0.005465050992480883,68.32273143498658,4307
1,0,0,0,0,0,1,0.00017804029225071887,68.33840971194869,4307
0,0,0,0,0,0,0,0.005344079958404653,68.33836982327004,4309
0,0,0,0,0,0,0,0.003072784533998679,68.3540089076327,4309
0,0,0,0,0,0,0,0.009520779927728996,68.3540089076327,4312
0,0,0,0,0,0,0,0.006309781186026785,68.36981440051417,4312
0,0,0,0,0,0,0,0.012584122057301146,68.37743536339573,4314
0,0,0,0,0,0,0,0.005609510566969696,68.39307374196198,4313
0,0,0,0,0,0,0,0.0032454816717806547,68.42435027537897,4315
0,0,0,0,0,0,0,0.001656137912898972,68.45589676552756,4315
0,0,0,0,0,0,0,0.0026759847441573384,68.47157820855988,4316
1,0,0,0,0,0,1,0.0010923815465007515,68.47933368574142,4317
1,0,0,0,0,0,1,0.007999276598780903,68.47916736654054,4319
0,0,0,0,0,0,0,0.0027993654468085358,68.47916736654054,4317
0,0,0,0,0,0,0,0.0,68.47916736654054,4316
0,0,0,0,0,0,0,0.003515253152995603,68.47916736654054,4318
0,0,0,0,0,0,0,0.0027344980512755603,68.49494855870466,4318
0,0,0,0,0,0,0,0.005562917141780312,68.49494855870466,4319
0,0,0,0,0,0,0,0.0028580595063497157,68.51058686760034,4319
0,0,0,0,0,0,0,0.0,68.52632838572744,4319
0,0,0,0,0,0,0,0.0,68.52632838572744,4319
0,0,0,0,0,0,0,0.0,68.52632838572744,4319
0,0,0,0,0,0,0,0.002737978104775754,68.52632838572744,4320
0,0,0,0,0,0,0,0.002832521574606222,68.52632838572744,4320
1,0,0,0,0,0,1,0.0018866069130478666,68.52632838572744,4320
0,0,0,0,0,0,0,0.009375020151618146,68.52632838572744,4324
0,0,0,0,0,0,0,0.0045912055279310445,68.57339927858334,4324
0,0,0,0,0,0,0,0.004859508377375988,68.58904059673803,4325
0,0,0,0,0,0,0,0.0028928052591207917,68.60472421611904,4325
1,0,0,0,0,0,1,0.0038371781896095695,68.60466388960053,4326
1,0,0,0,0,0,1,0.0027192201743779735,68.60466388960053,4326
0,0,0,0,0,0,0,0.005342033871671704,68.60466388960053,4326
0,0,0,0,0,0,0,0.005043443364110438,68.62030212178011,4327
0,0,0,0,0,0,0,0.002875477527269307,68.63594034799985,4327
0,0,0,0,0,0,0,0.0,68.65159346251922,4327
0,0,0,0,0,0,0,0.0,68.65159346251922,4327
0,0,0,0,0,0,0,0.0018327289696136412,68.65159346251922,4328
0,0,0,0,0,0,0,0.00019494092456571538,68.65159346251922,4328
0,0,0,0,0,0,0,0.0010995215692549433,68.66723178916325,4329
0,0,0,0,0,0,0,0.008418396825116636,68.66723178916325,4331
1,0,0,0,0,0,1,0.010842709385459037,68.66723178916325,4333
0,0,0,0,0,0,0,0.01340366125312,68.66723178916325,4334
0,0,0,0,0,0,0,0.004375674866484445,68.67756628919155,4333
1,0,0,0,0,0,1,0.0073464649450637,68.7093031216346,4335
0,0,0,0,0,0,0,0.006592929871064247,68.74059959300801,4336
1,0,0,0,0,0,1,0.006811635185299021,68.74590329959486,4336
0,0,0,0,0,0,0,0.003201051037240008,68.76154176699448,4336
0,0,0,0,0,0,0,0.0,68.79317504529752,4336
0,0,0,0,0,0,0,0.005353278463008254,68.79317504529752,4338
1,0,0,0,0,0,1,0.002702699498756073,68.82447269272981,4339
0,0,0,0,0,0,0,0.0,68.82445155354655,4338
0,0,0,0,0,0,0,0.002565199299624237,68.82445155354655,4339
0,0,0,0,0,0,0,0.0028157744664629295,68.82445155354655,4339
0,0,0,0,0,0,0,0.0025665747732186777,68.82445155354655,4339
0,0,0,0,0,0,0,0.0010346471728614854,68.82445155354655,4339
0,0,0,0,0,0,0,0.0,68.84011884973496,4339
0,0,0,0,0,0,0,0.0,68.84011884973496,4339
0,0,0,0,0,0,0,0.003973964449130659,68.84011884973496,4341
0,0,0,0,0,0,0,0.0027963255881656443,68.86609297439495,4342
1,0,0,0,0,0,1,0.005111024777270842,68.86530432640413,4343
0,0,0,0,0,0,0,0.005212962546941444,68.87147704840486,4343
1,0,0,0,0,0,1,0.01102665691214349,68.88715272423826,4346
0,0,0,0,0,0,0,0.0021468405646571406,68.9027580236742,4344
0,0,0,0,0,0,0,0.0006457555039718284,68.91839640985292,4345
0,0,0,0,0,0,0,0.004164745940362779,68.93403478846193,4347
0,0,0,0,0,0,0,0.0028690835571035227,68.94974393202497,4347
0,0,0,0,0,0,0,1.3776133600710778e-07,68.96538283762122,4347
0,0,0,0,0,0,0,0.0,68.96538217452891,4347
0,0,0,0,0,0,0,0.0028618481285654167,68.96538217452891,4348
0,0,0,0,0,0,0,0.0026292195434434304,68.98102164085978,4349
0,0,0,0,0,0,0,0.002807427772249496,68.9810204866268,4349
0,0,0,0,0,0,0,0.0025743821719019064,68.9810204866268,4350
0,0,0,0,0,0,0,0.0032847250510949816,68.9810204866268,4350
0,0,0,0,0,0,0,0.0055926360755215315,68.99669802956716,4351
0,0,0,0,0,0,0,0.004527494157196591,68.99669802956716,4351
0,0,0,0,0,0,0,0.0,69.01255602892616,4350
0,0,0,0,0,0,0,0.0,69.01255602892616,4350
0,0,0,0,0,0,0,0.0028502095355950868,69.01255602892616,4351
0,0,0,0,0,0,0,0.0015845110348328716,69.02819452066814,4352
0,0,0,0,0,0,0,0.0026600011784002242,69.04384682026756,4353
0,0,0,0,0,0,0,0.0021946544116258483,69.04384682026756,4353
0,0,0,0,0,0,0,0.002663023900974507,69.04384682026756,4353
0,0,0,0,0,0,0,0.0017496753412063486,69.04384682026756,4353
0,0,0,0,0,0,0,0.005575762361760363,69.04384682026756,4354
0,0,0,0,0,0,0,0.005723011200524123,69.05948773443353,4355
0,0,0,0,0,0,0,0.0037228403902940556,69.05948503227339,4355
0,0,0,0,0,0,0,0.0002483867649030153,69.07513297712063,4355
0,0,0,0,0,0,0,0.0038835509374223875,69.09077133273,4357
0,0,0,0,0,0,0,0.0074666157140884344,69.09077133273,4358
0,0,0,0,0,0,0,0.00018600541132847298,69.1064096707578,4357
0,0,0,0,0,0,0,0.0,69.1221090743175,4357
0,0,0,0,0,0,0,0.0,69.1221090743175,4357
0,0,0,0,0,0,0,0.0003308494763493562,69.1221090743175,4358
0,0,0,0,0,0,0,0.0,69.1377473134649,4358
0,0,0,0,0,0,0,0.0,69.1377473134649,4358
0,0,0,0,0,0,0,0.0,69.1377473134649,4358
0,0,0,0,0,0,0,0.0017544495247998392,69.1377473134649,4359
0,0,0,0,0,0,0,0.002567066641372312,69.1377473134649,4359
0,0,0,0,0,0,0,0.0,69.1377473134649,4358
0,0,0,0,0,0,0,7.634006101956758e-07,69.15339608026574,4359
1,0,0,0,0,0,1,0.002622038965335611,69.15338554246965,4360
0,0,0,0,0,0,0,0.0015204930210087162,69.1797355201648,4362
0,0,0,0,0,0,0,0.0,69.19502564816213,4362
0,0,0,0,0,0,0,0.0,69.19502564816213,4362
0,0,0,0,0,0,0,0.0,69.19502564816213,4362
0,0,0,0,0,0,0,0.0,69.19502564816213,4362
0,0,0,0,0,0,0,0.0,69.19502564816213,4362
0,0,0,0,0,0,0,0.0,69.19502564816213,4363
0,0,0,0,0,0,0,0.006277256350908834,69.19502564816213,4365
0,0,0,0,0,0,0,0.007272066491873636,69.19502564816213,4365
0,0,0,0,0,0,0,0.007559555079279653,69.19502564816213,4365
1,0,0,0,0,0,1,0.004737058304259677,69.22638099253406,4366
0,0,0,0,0,0,0,0.005327059166289207,69.22638099253406,4366
0,0,0,0,0,0,0,0.002585934336489617,69.28120251397515,4369
0,0,0,0,0,0,0,0.005287989618480336,69.28113391813822,4370
0,0,0,0,0,0,0,3.7337282370022144e-08,69.30710665552294,4370
0,0,0,0,0,0,0,0.0,69.32291947115834,4371
0,0,0,0,0,0,0,0.004124823963703641,69.2065186564544,4373
1,0,0,0,0,0,1,0.006377786936246604,69.32830976730696,4376
1,0,0,0,0,0,1,0.009231724055229429,69.34395550713728,4377
0,0,0,0,0,0,0,4.10116722132243e-08,69.37525728669164,4375
0,0,0,0,0,0,0,0.0,69.37525728669164,4375
0,0,0,0,0,0,0,0.0,69.37525728669164,4375
0,0,0,0,0,0,0,0.002099148959882178,69.37525728669164,4376
1,0,0,0,0,0,1,0.0016155474578104078,69.39089567798747,4377
0,0,0,0,0,0,0,0.004739301976134673,69.39089567798747,4379
0,0,0,0,0,0,0,0.0054089483620501505,69.4065338871216,4379
0,0,0,0,0,0,0,0.005520484926797736,69.4065338871216,4379
0,0,0,0,0,0,0,0.0003113739072841639,69.422197098308,4379
0,0,0,0,0,0,0,0.0,69.43790399502461,4379
0,0,0,0,0,0,0,0.0,69.43790399502461,4379
0,0,0,0,0,0,0,0.0,69.43790399502461,4379
0,0,0,0,0,0,0,0.0,69.43790399502461,4379
0,0,0,0,0,0,0,0.002036571492261541,69.45357466208056,4381
0,0,0,0,0,0,0,0.0,69.46921630038493,4381
0,0,0,0,0,0,0,0.0,69.46921630038493,4381
0,0,0,0,0,0,0,0.0,69.46921630038493,4381
0,0,0,0,0,0,0,0.0,69.46921630038493,4381
0,0,0,0,0,0,0,0.0,69.46921630038493,4381
0,0,0,0,0,0,0,0.004816169532724155,69.46921630038493,4384
0,0,0,0,0,0,0,0.0026650711320668637,69.50050879545603,4384
0,0,0,0,0,0,0,0.004287462859152219,69.50050879545603,4385
0,0,0,0,0,0,0,7.72397432732257e-07,69.52649147661263,4385
1,0,0,0,0,0,1,0.004663123234731949,69.52649147661263,4387
0,0,0,0,0,0,0,0.002808327761001957,69.52649147661263,4387
0,0,0,0,0,0,0,0.0,69.55776805418049,4387
0,0,0,0,0,0,0,0.0,69.55776805418049,4387
1,0,0,0,0,0,1,0.0015277494998190428,69.54743355415218,4388
0,0,0,0,0,0,0,0.0055193119080005895,69.56758686496057,4389
0,0,0,0,0,0,0,0.0,69.56758686496057,4387
0,0,0,0,0,0,0,0.0004748087874837255,69.56758686496057,4388
0,0,0,0,0,0,0,0.0,69.58334353389628,4388
0,0,0,0,0,0,0,0.0011917658550992037,69.58334353389628,4389
0,0,0,0,0,0,0,0.0,69.59898191862658,4389
0,0,0,0,0,0,0,0.001683852742716139,69.59898191862658,4390
0,0,0,0,0,0,0,0.0007639486201596388,69.61462951673914,4392
0,0,0,0,0,0,0,0.0026648902000188453,69.63026772680304,4392
0,0,0,0,0,0,0,0.0019037907777518673,69.63026772680304,4392
