throughput_KLONGTEI,throughput_KASEMRAT,throughput_NARANONG,throughput_SUNLAKAKHON,throughput_RAMA4, throughput_ATTHAKAVI_RAMA4,throughput,mean_speed,jamlength_percent,Backlog
0,0,0,0,0,0,0,7.8764396314290765,0.0,17
0,0,0,0,0,1,1,8.912429623297465,0.007551010726155326,35
0,1,0,1,0,0,2,10.079036809367432,0.01800482078810721,59
0,3,1,0,1,0,5,10.346978648693707,0.01800482078810721,85
1,1,1,0,1,0,4,9.679940966625702,0.06350808111747926,109
1,3,0,0,2,1,7,9.853808168592142,0.14574791735376993,138
3,4,1,1,0,0,9,9.418599359678089,0.21180092978137446,163
0,4,1,3,1,1,10,9.186131518124965,0.2945222353971312,179
0,3,0,3,0,4,10,8.705966454140306,0.4314770458019632,207
3,5,0,1,2,0,11,7.985403440994457,0.6417094524180167,234
5,5,0,3,4,3,20,7.691145238724593,0.8730956961826516,257
2,15,1,19,2,3,42,8.363938123380857,0.7027879365561969,275
8,10,0,5,1,5,29,8.087555852238397,0.97527026179295,317
3,8,0,2,1,2,16,7.828854562535444,1.2996872954684828,346
5,7,1,2,2,2,19,7.649268732106887,1.4854410774030633,386
4,5,12,3,3,5,32,7.308873111220143,1.7317532651524574,415
4,7,1,3,0,1,16,6.386063388684489,2.3115893441178397,447
7,13,2,1,2,7,32,5.922428964910705,2.773726168014984,466
3,7,1,2,0,1,14,5.514696083848805,3.3041311076641398,494
11,5,10,2,23,5,56,5.957428299373012,2.957298302914108,505
11,5,10,9,23,2,60,5.9061186035194755,2.968676722122755,518
8,5,9,6,7,5,40,5.817456136509124,3.257836525700856,539
8,5,9,1,5,4,32,5.216912559173962,3.8382684057413394,570
8,13,7,0,5,11,44,4.71931225907809,4.236884728496224,580
11,8,6,17,2,13,57,4.7201127637217155,4.23895286589566,587
8,12,9,21,9,12,71,4.604757489724567,4.180497426027624,567
12,8,7,15,2,10,54,4.324955368659268,4.525428323082328,558
13,7,7,1,8,8,44,4.342693312237466,4.621070515467045,576
6,6,9,3,25,7,56,4.459138800294165,4.46755272635063,596
26,9,10,1,24,8,78,4.4346331411833235,4.495474238323741,596
25,13,6,1,11,5,61,4.4456381808758145,4.588213052523008,601
9,10,15,3,6,11,54,4.21406616500805,4.717875823886944,608
4,9,12,3,6,8,42,4.0029003571471,5.2448114849268075,620
5,6,6,13,8,7,45,4.1088746008058346,5.333725458317193,633
8,10,14,12,12,4,60,4.306414957067854,4.802979335890167,639
5,2,8,15,9,8,47,4.585745574865448,4.576148937412671,661
6,18,4,12,10,4,54,4.422086891331861,4.852466063093682,675
4,9,6,11,5,6,41,4.356749434137221,5.423839101603115,699
2,9,7,6,7,6,37,4.211646024226276,5.925098017484639,723
18,9,13,3,13,6,62,4.162322641353812,6.134319480317976,726
6,6,6,1,8,6,33,3.869631491143163,6.825552244630417,773
5,7,1,5,9,6,33,3.412231707431541,7.437997878941364,792
3,12,2,4,8,6,35,3.159093346680053,8.10047870760887,811
7,14,10,3,7,7,48,3.2385745245895317,8.00300498935264,828
10,16,10,6,18,7,67,3.4495496519521027,7.624014978096315,850
8,22,10,17,23,8,88,3.936581758482352,7.0796234158962585,865
9,14,10,21,18,6,78,4.350006854394761,7.0977585895650295,894
12,23,11,15,8,9,78,4.413049976135253,7.052030933092037,908
8,20,10,4,7,9,58,4.172087235969741,7.353175173351752,916
9,11,10,1,24,17,72,4.000588628978332,7.657209639370764,935
7,18,8,10,28,12,83,3.6664812497229624,8.272365567190858,944
37,15,8,18,10,13,101,3.632248939390661,8.134296842248158,915
24,10,8,12,11,11,76,3.3687717316479193,8.476610977399268,913
8,8,8,6,12,9,51,3.2614804551858723,8.691995266565291,921
9,27,8,2,11,7,64,3.4106069062665614,8.153388116114321,921
7,23,5,16,11,9,71,3.527929789272728,7.94774117456404,908
5,23,7,21,5,7,68,3.597270810771201,7.843342731003221,905
9,17,13,22,4,9,74,3.4266587160851802,8.385959438793991,912
10,7,15,19,4,5,60,3.355608305645823,8.598794692084349,919
12,7,14,6,5,6,50,3.086773862216789,8.691979807218528,908
3,15,11,11,17,5,62,3.092562069708055,8.415898112844815,909
11,12,13,3,8,7,54,2.9404979010751613,9.128649240267805,913
9,13,11,11,10,8,62,2.9179452344471,9.149386483880441,938
3,5,12,11,12,6,49,3.200519267377761,9.224759633440321,953
1,7,8,16,11,8,51,3.291156897388303,9.354389019235738,976
9,4,9,14,22,6,64,3.383822715737526,9.194844955979672,986
14,8,3,16,26,6,73,3.396074299333894,9.431749712210209,1005
14,9,4,8,26,2,63,3.3494666109963602,9.609775635068681,1035
13,12,6,4,12,8,55,3.123427083777812,9.799017062331295,1056
12,23,5,4,10,9,63,3.231680542652021,9.720128429730812,1071
1,20,6,3,10,15,55,2.9367712382996327,10.538878297244052,1085
13,17,5,4,17,15,71,2.878474003781501,10.856616000317123,1116
9,9,5,4,31,10,68,2.7633158571159475,11.087746647306805,1114
32,6,6,3,19,13,79,2.6079791677541526,11.754552226998793,1122
32,6,5,4,11,12,70,2.197929722242869,12.20106235593774,1100
10,10,5,11,13,16,65,2.157729375427388,12.504435587943009,1098
10,8,13,15,14,11,71,2.172110535644987,12.34361462060458,1095
10,4,10,12,5,7,48,2.3398940865344193,12.363988219034235,1118
9,22,9,7,5,8,60,2.585152188340759,11.853304654861452,1127
9,20,5,2,6,7,49,2.627351860688321,11.730159195115641,1131
0,19,12,2,5,7,45,2.7345420038217823,11.46323731239449,1146
15,14,9,6,6,9,59,2.564994227014378,11.419034703873232,1153
5,12,12,0,7,8,44,2.458984604122032,11.653770198944212,1174
7,12,14,2,8,9,52,2.42605441148719,11.763950603372715,1196
5,6,16,4,11,8,50,2.083687205358199,12.822855873698868,1211
2,1,5,1,14,9,32,1.8095275399739468,13.823436616509849,1223
1,3,0,1,4,8,17,1.817222399889579,14.532474522978799,1260
3,19,1,3,0,10,36,1.8171364260030651,14.23874333605975,1266
8,21,10,13,22,8,82,2.224939182689328,13.291333348715801,1263
10,17,10,13,21,8,79,2.423535849621889,13.215316674257412,1262
1,20,5,12,14,9,61,2.594784100004283,13.018316362398384,1282
4,19,2,9,2,8,44,2.409402995292793,13.345168385350936,1290
11,13,5,5,21,5,60,2.305127281756257,13.322049861504395,1286
11,13,6,4,23,6,63,2.06227881037069,13.722744998114939,1291
10,13,5,1,11,7,47,2.030064574669668,14.47444644080252,1307
32,14,5,17,7,6,81,2.2925190417326196,13.39049481714963,1283
20,23,6,20,6,6,81,2.2823181522581386,13.007810575795755,1266
7,21,5,23,9,5,70,2.360993259216382,12.992913009101368,1237
7,19,5,20,4,5,60,2.442500686457485,12.741170573532385,1230
4,9,5,21,9,5,53,2.4149765254754167,12.568109081990434,1222
5,7,7,17,4,6,46,2.415071142403303,12.576770953720237,1233
3,11,7,11,4,6,42,2.2834231100871305,12.994837129177919,1247
7,9,5,16,4,7,48,2.2859400722922496,13.515471177934383,1265
6,13,8,14,4,7,52,2.1751436754933247,13.419699324050859,1273
5,9,11,11,7,7,50,2.177802307209849,13.424779918113343,1278
8,24,10,3,6,6,57,2.373801271152716,13.192729762907073,1293
9,14,16,5,11,5,60,2.1819643466037117,13.29252310688344,1282
1,17,12,1,9,5,45,2.278389797380283,13.649779437593196,1295
1,17,14,12,3,4,51,2.4488922337453065,13.005856235329746,1292
1,8,9,11,2,6,37,2.5317559829847056,13.182639536309681,1311
8,5,6,12,18,6,55,2.5645629512457564,13.272929671484615,1296
4,10,5,14,19,9,61,2.589694861855862,12.87541260124556,1298
11,12,10,15,18,5,71,2.772308930695843,12.818688055723191,1319
11,7,11,15,16,6,66,2.6033088047208066,13.3931666388609,1329
14,6,11,11,28,6,76,2.4649397299919653,14.011305462760776,1355
8,27,10,7,29,6,87,2.335991650433233,14.53628828824925,1360
28,16,11,6,10,5,76,2.270019284719726,14.876632260744728,1361
27,18,6,6,11,5,73,2.101752529436107,15.279994769182165,1362
6,11,5,5,12,1,40,2.0658400805334303,15.887922249355466,1371
4,4,13,7,7,2,37,2.0434135249017484,15.948832130707274,1394
4,3,11,5,10,7,40,1.9599842471608817,16.35290702292953,1411
10,8,9,16,8,5,56,1.8990680846381653,16.57680974631817,1415
14,10,11,17,8,6,66,2.0494262669426377,16.143113166038027,1429
10,10,11,10,7,4,52,2.056713390061197,16.08715950945766,1449
6,24,6,12,4,3,55,2.1366010904143975,16.35803910750738,1467
9,18,9,6,16,5,63,2.3843818003840727,16.062736198618897,1493
5,14,9,7,21,4,60,2.3246296217947364,16.24340991937357,1513
7,8,11,5,13,3,47,2.023476654304585,17.609969117727832,1528
14,4,4,4,4,2,32,1.815947221025772,17.968904216332653,1564
12,3,5,0,7,3,30,1.66692255572357,18.826160245752988,1587
8,12,5,3,9,3,40,1.4476948687618665,19.45144335734587,1597
1,12,7,4,7,3,34,1.4609896268578089,19.603928325793376,1616
25,13,10,5,8,4,65,1.6131809299898452,19.164043316073425,1621
10,20,5,4,4,2,45,1.56091061611376,19.608405306161846,1633
11,20,5,15,18,5,74,1.749988773043269,19.047256752535755,1625
7,13,5,11,20,4,60,1.7732813610228635,18.961020866962855,1627
8,13,5,9,10,20,65,1.7550017970034886,18.742175519512465,1619
9,19,15,10,8,17,78,1.645999513370023,19.050640975738517,1614
10,9,11,7,6,14,57,1.7006526376630173,19.37214271530753,1645
11,12,13,16,4,17,73,1.7162843316690497,18.88262627602662,1630
10,9,11,17,10,19,76,1.8521883891722777,17.466953992787793,1622
0,10,4,23,4,17,58,1.9707444472020847,17.12661355979548,1622
15,27,6,22,7,17,94,2.181055300237375,15.898886819569336,1584
10,34,5,21,6,16,92,2.4155678294794494,16.216414434548028,1568
14,24,6,19,10,16,89,2.265427915742068,16.298250922206158,1545
12,18,8,20,7,18,83,2.2480675778159327,16.197102650471162,1540
10,19,11,11,7,18,76,1.9644756936192946,16.76109698182865,1532
7,10,7,7,4,14,49,1.755132296154264,17.504009004646818,1537
6,15,5,7,6,15,54,1.5564724648313784,18.229747621039795,1527
5,19,5,8,17,14,68,1.5510230586100726,17.83454265788339,1521
3,16,13,16,15,11,74,1.7662784825123685,17.333602749897835,1523
0,7,10,16,18,17,68,1.7922102093265901,17.208495922521134,1516
8,10,8,10,13,14,63,1.7784593428455144,17.193084742807365,1524
4,8,5,14,10,12,53,1.887884260291558,17.282490040700598,1531
5,7,8,10,22,13,65,1.999268716889068,16.977473715078354,1537
4,10,7,8,27,15,71,2.082787224226427,16.761736140165013,1531
5,13,6,6,21,9,60,2.076332661702603,17.19946717696472,1551
6,15,9,7,2,5,44,2.009500431704496,17.845577803561508,1579
10,22,14,7,18,7,78,2.153202867808007,17.31858378897062,1573
11,21,15,8,24,12,91,2.1909803129312095,17.09055600993007,1574
5,20,15,7,10,12,69,1.9673205057135221,17.87427279448937,1579
0,11,15,2,0,11,39,1.8355658747700743,18.436784344553928,1595
32,13,8,0,0,13,66,1.7316709904479621,18.68637837257653,1584
10,8,5,11,7,7,48,1.5681537175105964,19.100617157038922,1608
26,8,10,15,22,8,89,1.8722171954494424,18.328167036432678,1605
28,6,10,10,27,8,89,1.956175195137487,18.2948969948114,1614
27,8,5,3,21,4,68,1.8140161630178475,18.552901754480615,1615
25,23,5,4,15,11,83,1.7993033771238318,18.07394917044682,1606
10,23,6,2,24,6,71,1.9150782601117526,17.61815146865314,1604
9,22,5,2,21,6,65,1.9735974072474354,17.547037904864684,1613
12,14,5,2,5,5,43,1.8680642193575794,17.956100170959278,1628
6,7,5,12,7,6,43,1.8950389851394869,18.032562510094536,1637
16,7,6,15,19,11,74,1.7509835284929622,18.167395637968323,1625
19,9,4,13,17,13,75,1.6397768189386688,18.530988568743766,1608
16,11,5,9,18,10,69,1.559117185783458,18.954841785754105,1606
18,8,6,7,19,9,67,1.462133694819591,19.28292560267526,1598
5,23,5,8,21,7,69,1.469907812998351,19.134714189396842,1593
6,22,8,8,13,3,60,1.5617417082144551,19.44425483274983,1609
5,17,4,2,1,4,33,1.5120209343813742,19.778988921814538,1626
7,3,5,15,0,7,37,1.5019809131670459,19.788248904137102,1634
12,8,5,21,19,12,77,1.5741472708115882,19.44158582125886,1622
0,10,6,19,8,9,52,1.5204798638062231,19.192843173019902,1619
15,11,9,21,9,13,78,1.68033051411136,18.543532002438848,1592
7,12,18,22,11,6,76,1.6424712061761697,18.307007897780494,1579
11,9,13,7,6,4,50,1.6898356763647913,18.073504386586784,1591
13,22,9,1,6,5,56,1.7217043010181934,17.803511419492423,1582
11,21,9,1,5,6,53,1.8595470958411273,17.557991058643754,1606
14,14,9,2,7,5,51,1.8765092919390651,17.43623856549633,1625
19,10,1,14,10,10,64,1.9850040857142144,17.43389566283436,1644
23,9,5,11,12,6,66,2.021279440238647,17.72663507072107,1657
16,6,4,13,11,11,61,1.8833088921127192,17.93778832660879,1660
6,10,5,10,9,8,48,1.5884775914596816,18.902282337631412,1666
22,9,4,12,5,10,62,1.6002105644068738,19.145771003468024,1672
8,11,4,13,12,8,56,1.5061241436961093,20.248564028088303,1691
7,20,3,6,11,1,48,1.5061017057246726,20.410193202741993,1711
5,21,11,4,5,5,51,1.4677353047918924,21.02845277861818,1725
4,21,10,8,4,8,55,1.5818351834097817,21.07504555252411,1747
3,8,12,9,5,8,45,1.5588279175356712,21.288043800534037,1761
3,12,13,6,6,8,48,1.4614291488048672,21.767412544576867,1774
4,8,9,5,7,12,45,1.3476562020713905,22.414526885903115,1788
6,2,6,6,15,10,45,1.2866423229222521,22.53954519225052,1795
0,2,5,6,6,8,27,1.223574530671216,22.9174532535369,1807
3,1,5,5,6,7,27,1.2090176229026905,23.47846586932739,1837
3,23,5,7,3,6,47,1.2245000390154233,23.53571615940742,1849
1,20,5,1,6,9,42,1.2790097467183827,23.98951666005344,1861
9,17,5,0,23,6,60,1.5225153792217128,22.934622818871247,1871
12,17,5,9,27,8,78,1.7055762934779235,21.862018646043374,1860
13,17,5,7,27,9,78,1.7905921252401338,21.248260758533668,1862
13,13,15,5,11,9,66,1.718513107061247,21.664409284767107,1873
11,1,12,4,12,9,49,1.4833302913939033,22.636300378295594,1880
14,6,11,14,8,9,62,1.419769193922004,22.672837821159632,1884
1,11,10,14,8,5,49,1.3999882304675624,23.07919734976812,1877
6,21,7,12,19,6,71,1.4643762180543725,22.356295019503737,1872
7,19,6,10,21,7,70,1.4120978446056713,22.94440035775188,1876
9,25,7,6,4,5,56,1.335402571709231,23.0160810483581,1877
5,16,5,9,3,0,38,1.1901491690960586,23.80474251045792,1879
6,2,7,5,1,4,25,1.1439498778198338,24.214019910155216,1900
6,3,5,6,4,8,32,1.0730364196579498,24.505768797932337,1915
8,8,5,6,2,6,35,1.0379913993295242,24.865301255728077,1921
9,8,6,17,4,4,48,1.1348795353323382,24.855530895228732,1932
35,13,6,22,20,5,101,1.3393630558567142,23.63019675736702,1898
1,21,15,16,19,5,77,1.36156965647972,23.196988440256277,1879
33,21,16,10,5,4,89,1.4408598121847447,22.914677511798228,1863
27,17,15,12,5,4,80,1.5455801547170167,22.641915462749754,1841
10,9,15,8,6,6,54,1.4079321128601003,23.13613729170903,1825
7,7,15,6,12,6,53,1.4200763390580342,22.93759419393579,1824
7,5,5,1,5,1,24,1.247471495702158,23.44985694837096,1827
3,6,11,3,4,2,29,1.1433387766424223,23.997834906283682,1836
8,7,10,6,3,3,37,1.1675236266883846,23.73673869097619,1854
6,9,5,3,0,4,27,1.1494438957093434,24.304306945695387,1881
3,21,8,6,2,4,44,1.2160706923198679,24.777890814034123,1902
0,11,5,8,12,6,42,1.1654205824177966,24.8578512874508,1910
1,12,6,6,14,5,44,1.209591071862431,24.97601955779718,1912
3,6,5,7,15,5,41,1.3023873983640883,24.484043410325167,1925
4,7,5,5,8,5,34,1.2305538397850784,24.476561152339873,1942
7,9,5,3,4,2,30,1.1118165523857433,25.073171176684493,1963
5,7,6,0,8,6,32,1.1079268224295424,24.912083814134018,1974
7,8,6,1,9,4,35,1.0472931809192287,25.483452727752617,1997
8,8,6,0,6,3,31,1.0875894587749875,25.541128553475627,2031
7,20,6,0,6,3,42,1.1241451266114462,25.64709078996187,2039
1,13,5,10,18,3,50,1.1219501041678046,25.5528064193304,2037
6,13,5,6,7,7,44,1.102972580533832,26.229963889259647,2049
17,8,3,5,8,2,43,1.032463567953226,26.8549404954985,2061
7,6,5,12,7,6,43,0.9058484026579156,27.00917295609007,2055
8,6,5,11,5,5,40,0.844325022385215,27.733614460291992,2073
6,7,5,9,7,5,39,0.8810396385495882,27.43640777367243,2078
13,10,7,4,8,1,43,0.9558777662973628,27.0895885538252,2100
11,10,5,18,6,3,53,0.9787972259986222,26.48318919584645,2086
9,18,9,20,5,7,68,1.090601340575032,25.737168902443408,2087
13,13,5,22,16,0,69,1.1550319529697084,25.77300686295353,2066
12,17,5,22,15,17,88,1.2601626803711057,24.80395419194389,2056
2,11,5,2,15,16,51,1.2115102794244077,24.75213481050647,2064
21,17,0,10,7,17,72,1.1562259469758303,25.390415918159686,2063
8,9,5,9,5,15,51,1.110437153764862,25.86123573243679,2065
8,6,7,13,4,18,56,1.2588674116692626,24.692476328366563,2068
11,10,5,8,5,18,57,1.3509983903704461,24.36256158269142,2067
10,9,6,9,5,18,57,1.376667456354948,24.39095035578082,2055
8,28,5,6,7,16,70,1.5171228732861435,23.98287258400139,2059
4,24,5,8,6,18,65,1.55542463126774,23.51260661408033,2035
7,28,5,9,1,14,64,1.5816281424169527,23.40300689161569,2050
6,20,5,5,2,19,57,1.5151980471660835,23.55085904276502,2031
0,14,5,2,8,13,42,1.3659042036826894,24.19700039432269,2031
8,12,6,3,10,13,52,1.2310795064655162,24.928184956756397,2018
7,9,9,3,20,13,61,1.3543358126379375,24.075988653838742,2024
8,10,5,7,22,13,65,1.3947543529553192,24.149858870869544,2040
12,8,4,0,23,15,62,1.4410445621325059,24.477054275183555,2053
10,25,11,0,11,16,73,1.4581145368171666,24.516430996335686,2071
11,25,6,0,6,10,58,1.3387144191769007,24.939531740576925,2068
12,14,6,1,23,12,68,1.5471648865033685,23.26937951201061,2079
13,8,6,9,20,11,67,1.5583281580858852,23.700999392602867,2097
16,7,10,6,12,12,63,1.584443799872536,23.511403646713276,2101
2,8,5,7,8,11,41,1.4525629700987224,24.917216626179222,2124
38,9,10,2,1,13,73,1.3668376118493255,24.807228873058694,2102
12,8,7,2,15,19,63,1.4770651013911087,25.044114608101978,2127
6,11,11,16,20,12,76,1.4781856970943228,24.849114864001045,2116
24,24,6,21,25,16,116,1.5897601088781796,24.41764435624036,2083
28,27,6,21,20,11,113,1.503196246661789,25.095217255307322,2054
17,26,5,21,14,12,95,1.32817169206376,25.2680059031305,2014
11,17,9,5,18,14,74,1.2781112748391679,25.206992600837843,2017
2,10,15,3,18,5,53,1.2470138406291629,25.32532235810134,2020
1,8,15,7,14,7,52,1.2165882509151391,25.25675613992852,2017
0,10,16,9,17,11,63,1.2028943527273028,25.817749145701313,2012
3,14,10,5,14,9,55,1.0948431765033577,26.096154210890123,2003
0,11,9,7,8,8,43,1.0399485723497155,26.884517527976513,2018
2,25,10,6,7,6,56,1.087963318170528,26.541223980149777,2016
4,17,15,3,4,7,50,1.0641159210102933,26.62710816154207,2017
2,18,10,3,0,9,42,1.0047388184972388,26.909208137960206,2026
0,17,12,10,0,8,47,1.044763052701437,26.65124315954203,2035
5,17,10,12,18,7,69,1.1687264283622294,25.954079742232032,2036
6,11,10,12,15,5,59,1.2333888373195163,25.6742925766749,2040
9,13,10,13,2,5,52,1.2337269298410785,25.743418382499428,2049
9,9,10,10,5,7,50,1.18744154811568,25.640328773473197,2041
10,9,7,11,8,11,56,1.1603097765088803,26.156732589518075,2049
10,20,7,12,5,15,69,1.1586129532372909,26.06660761200534,2058
13,13,3,9,8,5,51,1.1038089587206792,26.11247346834169,2071
5,23,1,11,10,6,56,1.1485741679392818,25.962814854750963,2069
4,15,9,5,4,8,45,1.123144637470398,25.870347076964922,2074
10,7,6,11,6,8,48,1.1883746147009249,25.941634534290728,2080
9,7,9,10,7,5,47,1.2687544034832392,26.064084152973628,2100
7,6,7,4,7,8,39,1.0874442752277704,27.038383597777464,2126
4,1,9,5,8,8,35,1.0909815895115818,27.88947301779024,2154
4,0,5,4,7,9,29,1.0058408939365668,27.95974031730466,2156
7,18,6,0,20,9,60,1.0999017195189082,26.929371480487685,2149
9,12,5,3,25,9,63,1.3670786204518057,26.035096161721505,2156
6,18,7,6,24,9,70,1.3325522326327843,26.22407462251357,2160
7,17,6,7,1,7,45,1.393201334407802,26.30430732887543,2180
7,18,7,5,4,7,48,1.2880142277836133,27.16256575732597,2218
7,13,17,6,16,6,65,1.2729002144481452,27.446394701950126,2222
8,9,8,7,16,5,53,1.2930945853863056,27.833065129327363,2250
7,13,11,5,9,5,50,1.4994369112760249,26.54319459411464,2262
11,9,8,1,2,7,38,1.5179525122556277,26.9601086121984,2289
8,22,5,17,11,5,68,1.4656241705167816,27.086804474548718,2313
32,13,9,21,6,5,86,1.3294877889770111,27.755277649820613,2295
10,20,8,21,17,6,82,1.4443374935236029,27.25768344610563,2288
24,14,10,20,20,5,93,1.4127760623068595,28.364140759198165,2279
20,10,11,21,8,4,74,1.2123300137065975,28.92604165356075,2255
5,11,8,20,10,5,59,1.1875747497483675,29.281098029484433,2260
7,10,11,13,21,6,68,1.299432722432492,29.975286401105706,2241
8,9,6,11,12,5,51,1.1723549623597738,30.41276778370345,2230
8,12,9,14,3,5,51,1.0544335429569902,30.62409892432705,2235
11,24,10,1,1,7,54,1.1409922695816246,30.619930591079637,2250
5,12,11,5,3,3,39,0.9207409143759723,32.03657377423801,2237
3,16,8,12,16,4,59,0.9807407967733838,31.415584294665628,2239
27,7,5,13,23,3,78,0.9669245268791735,31.4996805699577,2219
24,6,5,7,21,3,66,0.8194561385522846,32.02384323409427,2200
17,6,5,7,12,7,54,0.6975187790369426,32.601322454555586,2199
7,9,5,6,17,6,50,0.7866808222706171,32.17263276789082,2199
8,11,5,6,16,2,48,0.8575057188752007,32.219341576175395,2207
13,8,8,7,2,7,45,0.8055890536455615,32.018741129473185,2190
14,19,6,8,6,4,57,0.9144130171715105,31.403616010874956,2193
13,11,7,14,15,3,63,0.9962036396098508,31.442851050634392,2197
15,16,5,16,6,1,59,0.9902027970971498,30.869766161346433,2175
2,9,7,12,13,3,46,0.86244882032759,31.3428193753514,2160
12,6,7,1,8,1,35,0.8583701005317612,31.4969233931225,2155
9,5,6,8,20,3,51,0.9504953129653505,31.396994103209888,2154
5,15,4,11,6,1,42,0.8718762795512346,31.7854642663856,2155
9,8,0,4,3,5,29,0.8430864438562419,31.85858896900867,2162
10,8,1,6,5,4,34,0.75162531100225,32.32194475356593,2179
3,7,0,16,16,6,48,0.8058939312662721,32.30072505267938,2185
12,7,0,13,6,3,41,0.8398050294745145,32.40004164475191,2174
1,3,0,14,11,4,33,0.8808793581798907,32.13715502435117,2177
4,17,15,14,12,2,64,1.0445554922043385,31.358877038482547,2176
0,6,16,8,16,6,52,1.1045537448534646,30.979827411414526,2166
14,7,15,12,14,2,64,1.1481662518207085,30.630020568378132,2149
9,3,15,9,17,17,70,1.1681774987232132,30.388670178528,2138
8,9,13,7,15,15,67,1.1196985713254863,30.317497088237047,2125
3,12,6,4,16,17,58,1.054396354331681,30.535855822830946,2133
6,15,5,9,9,14,58,1.1426226143054952,29.84977604235124,2129
6,7,4,9,13,16,55,1.2668618632056425,29.80382368958999,2159
8,6,8,7,1,17,47,1.215569674857773,30.215798029988644,2167
2,26,10,7,4,15,64,1.238967479291365,29.722985212187105,2169
4,30,5,9,7,8,63,1.3255003207674398,28.68495612625618,2172
2,25,5,9,15,11,67,1.5314974717567627,26.300748849937367,2176
9,25,6,4,16,13,73,1.4608855923207469,26.811874417246447,2171
8,13,6,2,19,14,62,1.3626753982529274,27.240090391017027,2189
8,9,5,0,10,19,51,1.227633124353786,28.019260305515772,2200
7,8,5,2,8,15,45,1.058845784801762,28.663417640005278,2201
10,7,7,6,9,16,55,1.0938666793489111,28.224923831906835,2221
11,6,6,6,6,19,54,1.0466251982923773,28.740115947941266,2255
8,26,8,5,4,17,68,1.040736640925516,29.36903170049459,2277
7,34,5,4,7,14,71,1.0422457568107784,30.000116865348282,2293
7,30,5,3,16,12,73,1.058879553848814,31.301665162590417,2314
2,19,12,0,11,16,60,0.9517458993706507,31.601783444935553,2325
12,16,8,0,2,13,51,0.8379191650359591,32.677865052795376,2347
6,13,5,9,1,9,43,0.7415244205528405,32.07587983677803,2356
5,13,5,6,1,11,41,0.7795501808577796,32.39019560531221,2369
5,9,5,5,5,16,45,0.6883393624263883,32.20111928555753,2375
6,12,5,6,6,10,45,0.7490838679679915,32.28620797745107,2384
6,21,11,9,7,5,59,0.8173950231633863,31.307532584091472,2362
11,27,5,10,8,9,70,1.0143282151327335,30.434060355848448,2360
13,21,8,12,9,6,69,1.0156819440272051,31.162398847490838,2357
10,20,5,10,8,6,59,1.035550666376492,30.94510011759056,2368
3,10,6,9,6,6,40,1.149467865298514,30.938419934328323,2362
24,8,5,17,7,6,67,1.15295357462599,30.707207562980305,2358
13,8,1,16,7,5,50,0.9926797587472355,31.708097225511445,2354
10,7,4,15,23,11,70,1.1149794416363592,30.62523122563939,2345
12,10,5,12,27,7,73,1.2304426785624178,29.29720719569584,2344
10,22,5,13,9,8,67,1.316707289824802,28.71479533582754,2336
15,22,7,14,8,10,76,1.275989330691147,29.089231641303634,2320
13,23,6,14,11,11,78,1.1808726243893195,28.57734333803721,2292
15,11,6,10,7,14,63,1.1473197364240004,29.14975733041529,2295
12,9,4,6,18,15,64,1.1752250972457654,29.68639546761156,2298
0,10,7,10,15,13,55,1.2171168191452164,29.757059856649086,2293
28,20,10,13,15,14,100,1.2025437956981468,29.40380723407046,2271
16,16,12,6,18,11,79,1.1893812874588254,29.19298645130963,2254
18,18,13,7,14,9,79,1.144665943446191,28.666509774729686,2234
17,5,11,11,16,9,69,1.096903102806903,28.705988512985837,2220
14,8,7,17,19,4,69,1.2456261906164077,28.689376081286024,2230
14,9,2,16,6,6,53,1.1800162904784026,29.180395169273304,2232
5,14,10,12,1,5,47,1.240873082292894,29.220127079404865,2235
4,10,7,11,0,8,40,1.1996188414614526,29.500822637132305,2243
3,16,5,12,2,5,43,1.0908768132648619,31.29869426261737,2249
5,9,5,6,5,6,36,1.061699451596305,31.702202855762486,2274
8,7,9,12,8,6,50,1.0068650948466813,32.31736295296441,2299
8,9,5,7,21,6,56,0.9716134167764067,31.51916568554642,2322
7,12,7,9,26,6,67,0.9717580416238042,31.873117766644857,2327
10,9,5,7,2,4,37,0.9877297263531712,31.975519905738516,2346
9,9,9,6,7,2,42,0.9332659362397138,32.418690275198244,2352
11,21,7,1,6,8,54,0.9051203316814395,34.13350304475744,2350
6,13,7,0,10,5,41,0.921193491502849,34.05913901670681,2365
7,23,10,1,15,4,60,0.9326971897851837,33.824455600600835,2373
3,8,6,0,8,7,32,0.8977225651822517,33.74918567288786,2385
2,8,7,5,3,9,34,0.9363910411156426,33.51477849808189,2395
26,10,6,7,1,8,58,0.9133591677454674,33.63575858673667,2394
7,9,5,12,14,9,56,0.9360641042090496,33.497341990617954,2394
7,2,5,12,7,11,44,1.0582409817934566,33.36140549358096,2422
11,4,7,11,9,9,51,1.081833670519823,34.15110526815771,2444
10,16,5,8,11,10,60,1.1267331411063048,34.32606512472412,2472
10,14,5,1,14,8,52,1.1222872699336066,34.85104126307199,2494
8,18,5,5,8,8,52,1.049423772817221,34.799628230546375,2501
11,19,15,4,15,2,66,1.0717095756402422,33.18155263395642,2518
6,18,14,11,11,3,63,0.9190016032854631,34.22378947716828,2517
3,14,10,4,6,4,41,0.9304789467396486,33.685127009928706,2553
16,7,8,9,4,7,51,0.8781554406388657,34.00475816204197,2560
8,13,7,9,4,5,46,0.894352384338488,34.14387961244831,2571
6,8,7,8,18,5,52,0.9431470221168333,33.99640884724527,2591
6,21,5,7,16,5,60,0.9607518816094437,33.897930865832,2586
2,13,5,6,11,4,41,0.9731213732492365,33.951143466938404,2602
3,14,5,6,8,3,39,0.9493314764846882,34.004420619665154,2624
2,10,5,8,6,5,36,0.9060125126124778,34.63154082259102,2637
0,6,5,17,11,5,44,0.8514767030425069,34.373852452362804,2632
2,7,7,22,7,5,50,0.8712628714030687,33.93005712313071,2625
0,5,6,21,7,1,40,0.876629944656252,34.09615279402565,2605
9,10,5,22,6,7,59,0.9844357821110019,33.322574530180596,2578
6,9,5,19,15,3,57,1.035572725608292,33.0683133243077,2557
2,20,14,20,14,3,73,1.056740619723477,32.07541688834666,2512
4,16,7,11,6,4,48,1.051884462353031,32.39852369829729,2516
6,15,12,10,8,3,54,1.00014505082782,32.638023667812355,2512
3,6,9,9,12,3,42,0.9437697132189781,32.82615322969435,2491
2,7,8,15,19,6,57,0.9389417924039258,32.46675794677877,2486
1,6,9,12,1,3,32,0.8728073769976983,32.820729367993785,2477
0,7,10,7,1,5,30,0.7775054079240207,33.19031073441562,2471
0,7,7,6,0,4,24,0.7367041508232248,33.78003181263816,2470
0,6,9,14,18,3,50,0.8325748661242912,33.31127072156987,2472
0,24,6,17,14,3,64,0.8767361305840196,33.403822988297655,2474
0,12,6,14,2,2,36,0.7926643428003337,33.735584323598836,2463
0,9,7,11,4,8,39,0.895881146056237,33.28647195458143,2452
0,7,5,12,1,5,30,0.9713343589663765,33.79772460575589,2483
0,10,17,10,0,0,37,0.9117112412393777,33.46927553144153,2480
23,3,15,13,21,4,79,1.0322142416933184,32.53989703016536,2463
23,9,15,9,14,2,72,1.0425734791066659,32.40504357948643,2448
12,6,15,9,18,0,60,1.011631872517186,32.763950740996165,2452
0,11,15,6,9,2,43,0.8970371266334339,33.27904389435696,2463
13,8,14,7,0,6,48,0.7855857371279289,34.502367172453,2468
5,3,7,10,0,4,29,0.690047532845075,35.33782021773732,2468
5,13,5,6,4,5,38,0.7480283298669406,35.06582868714585,2489
5,8,8,11,6,0,38,0.73395732973985,35.35373531632167,2501
5,2,7,6,23,6,49,0.7528071737198243,35.129678460962225,2507
15,6,8,5,15,5,54,0.7530382606582011,35.569567469586964,2510
10,7,6,2,14,3,42,0.795713428796871,35.37815644380101,2521
6,10,6,6,8,3,39,0.7668335369293322,35.49416324653621,2521
7,8,2,7,6,5,35,0.8507050511607681,35.552357087918224,2545
2,19,5,7,0,4,37,0.8230800070859283,35.51221154403506,2552
4,11,5,9,1,4,34,0.9128236053056595,34.8440983521183,2567
6,20,5,2,1,4,38,0.9280136075801583,35.32472288628115,2587
2,5,5,6,18,5,41,0.9353370967273446,35.38610785293246,2585
14,8,5,4,19,2,52,0.8892133247304547,35.37930160423724,2576
13,6,5,9,7,4,44,0.7303253574718813,36.33997618833729,2595
11,6,5,7,10,3,42,0.6310132430889113,36.41600497216423,2603
6,9,5,15,6,3,44,0.6493203559798391,35.87886927533863,2593
8,12,5,8,1,6,40,0.6180932270746152,36.24791203363396,2600
7,23,1,7,8,4,50,0.6748485663299015,36.04186398768351,2606
0,16,6,7,7,1,37,0.6575887317602257,36.763553704433924,2620
10,10,10,7,5,3,45,0.8126532917050059,35.78827296284449,2642
10,4,10,6,14,4,48,0.8185524155396348,36.214838214530374,2663
6,5,11,9,12,2,45,0.7186044175597501,36.63100412900838,2685
8,4,11,12,6,4,45,0.7016962248713644,37.25902785783075,2703
10,8,9,16,3,16,62,0.7187630992542678,36.89184642414768,2689
10,6,5,12,4,17,54,0.785453493506878,36.20766185251324,2695
11,15,6,15,0,19,66,0.9207496037105533,34.76553964820062,2659
10,21,6,14,2,15,68,0.9711818686011269,33.45563683589671,2630
4,27,5,14,5,14,69,1.0421075730626195,33.11935448758406,2623
7,22,6,14,6,15,70,1.1669915161026339,31.966450101687066,2592
15,22,5,13,15,17,87,1.1563382062773992,31.943983186722882,2570
6,13,5,12,16,15,67,1.0464796120326336,33.007461627887416,2562
6,13,5,10,7,21,62,0.9997969177179579,33.32542316524042,2546
6,20,6,11,7,15,65,0.9495667066144688,33.14256659629692,2535
3,16,13,10,8,16,66,0.956992318096237,32.788281276044145,2514
9,12,13,4,18,16,72,1.0543934650977127,32.162251966570864,2502
9,14,13,8,22,19,85,1.1612282965367038,31.48913982558962,2472
15,18,11,10,25,14,93,1.1576795975934706,31.41333658105232,2471
15,13,8,12,11,14,73,1.0471201016571778,32.13150005802276,2469
1,7,7,14,12,11,52,1.046371138228812,31.926488031027652,2467
6,7,9,13,13,12,60,1.2930706236864251,29.648618390173493,2461
5,13,10,12,18,14,72,1.2893038410768627,29.315063446351466,2457
6,13,11,11,3,12,56,1.239794680805328,29.206952702766454,2461
5,16,11,13,2,12,59,1.1673943844426238,30.208128233476266,2482
5,8,11,12,1,17,54,1.168275022280818,31.201533313721253,2505
12,14,11,12,1,12,62,1.0662252179090284,32.37558989993458,2520
31,10,4,8,19,11,83,1.1353309314347457,31.94406339271113,2530
23,8,6,8,21,11,77,1.1142650282665758,31.711855929961917,2518
19,9,5,8,17,10,68,1.0953134481127007,31.7710603020957,2524
2,8,5,4,18,8,45,1.0563700570291998,32.633648818055946,2547
25,24,5,12,12,10,88,1.1459562237123366,32.0999760904542,2533
13,20,5,11,10,6,65,1.1238769070521386,32.03344300536651,2544
19,19,5,10,6,6,65,1.2322329476467428,31.54998720725734,2549
9,15,5,5,13,8,55,1.284677137861269,32.117383347128886,2567
10,19,5,6,17,13,70,1.204953864341867,32.95521124720542,2576
14,11,13,6,9,15,68,1.0538723250196316,32.85636746510764,2555
6,13,8,6,6,4,43,1.005653320171611,33.38056114009368,2562
3,7,10,1,7,11,39,0.9414137092409883,34.10530476592064,2574
9,12,16,4,10,13,64,0.8914909348072854,33.97211963239867,2578
0,24,11,3,9,0,47,0.8533496039034252,33.8150041704627,2577
8,19,12,8,5,4,56,0.9589481444590057,33.93672495601116,2581
5,15,6,10,0,5,41,0.9641039522934838,33.55982800521087,2595
4,7,9,7,0,6,33,0.9674626876654567,33.984010354836556,2587
6,5,5,14,18,6,54,1.0677225936063692,33.471785285314965,2599
5,10,6,9,12,5,47,1.0036214646569228,33.37903816606555,2618
4,12,5,4,5,6,36,0.9364457613540677,33.57043854396746,2627
4,8,5,8,6,5,36,0.9333061288779693,34.42090344668911,2657
11,8,5,9,3,12,48,0.798269731084683,35.343990334190195,2644
14,22,5,8,8,15,72,0.7282977475537681,35.656762078833246,2661
0,21,5,11,5,11,53,0.5998330891402831,36.271978794335986,2671
7,22,14,12,8,2,65,0.5776685643759204,36.782324612745896,2662
4,8,14,12,5,2,45,0.5846297268011346,36.27624718039521,2673
2,5,12,17,7,6,49,0.5588420665665136,36.367895586740524,2670
5,7,11,20,15,5,63,0.5926054720786846,36.44039815557723,2664
5,11,9,17,2,6,50,0.6429165846798689,36.119779359706634,2658
6,8,3,13,0,6,36,0.7463396126991753,35.70300456283731,2659
3,17,5,14,0,8,47,0.7396460468003282,35.54341199733136,2642
3,8,6,17,9,8,51,0.6979167089140493,35.199331378909264,2623
2,11,6,13,5,14,51,0.780347269479958,34.58409353068999,2627
0,9,11,9,8,6,43,0.7623454368616158,34.06815586226474,2609
21,12,8,14,11,4,70,0.8798808324086597,33.623847880853,2590
16,10,6,14,7,7,60,0.8651068803540145,33.673577677717326,2598
14,12,7,14,4,9,60,0.9304946985941578,33.05770989919393,2593
5,9,5,17,7,8,51,0.9419126448403219,33.392018511841414,2590
9,9,7,19,13,4,61,0.8467883251038774,33.53697764017262,2558
8,8,5,8,17,4,50,0.9394419686788346,32.23862026902449,2549
5,4,0,14,11,6,40,1.1524097567282567,31.375181317792833,2563
2,10,5,10,13,7,47,1.133738392799998,31.43126546969795,2565
1,12,6,11,12,9,51,1.2186023648923459,31.801118674633237,2566
0,10,11,11,23,9,64,1.3977801167460744,31.151821474686205,2574
7,8,6,13,23,6,63,1.3072535423152745,31.167566950468313,2597
3,8,6,7,10,6,40,1.1851535157989999,32.94133141637968,2620
2,7,9,8,5,6,37,1.0903834323725135,34.57086483206397,2642
1,6,3,9,13,14,46,1.0060783385704717,34.453085546812616,2667
0,8,5,8,15,17,53,0.8969186588336125,34.869061417561234,2675
0,10,5,8,2,13,38,0.6888073309525484,36.58884083747187,2682
0,13,6,6,3,3,31,0.6373803412370859,37.49278676052585,2700
0,8,5,5,0,7,25,0.6785148834198644,38.034926494187445,2725
0,22,5,10,0,7,44,0.7003538160841786,38.41473824527451,2720
0,22,5,6,19,9,61,0.7330746751380751,37.974675683407334,2720
23,10,5,5,19,10,72,0.7859293429285601,38.214723798898085,2717
26,10,5,1,12,6,60,0.7640613771946015,38.35293129345102,2695
11,6,13,0,12,5,47,0.6720433767985176,39.290704940583524,2684
0,6,13,3,2,7,31,0.6248050899237475,38.98392443299216,2701
0,6,6,4,1,8,25,0.6420288244949012,38.93934214119443,2719
0,17,9,3,2,8,39,0.6415513003478684,39.58489657380737,2717
0,19,6,4,1,9,39,0.6895391162995415,39.18309051395518,2731
1,21,9,4,23,7,65,0.6960262988652862,39.205905966446295,2728
16,19,8,5,13,9,70,0.7014764044777347,39.26603341865713,2724
0,14,8,7,7,9,45,0.7201488504174874,39.15390255017634,2737
9,9,9,7,8,7,49,0.7228556932726373,39.08335199382017,2727
0,6,12,14,0,8,40,0.6465060383172814,39.35188557356463,2728
1,10,11,9,0,7,38,0.583955324676078,39.047279505851336,2741
0,5,9,13,0,7,34,0.558969994476349,39.573266997563564,2739
0,15,8,7,0,5,35,0.5415074693334759,39.9159327605871,2743
0,19,14,6,17,5,61,0.5836003098025924,39.662799996753094,2731
12,28,15,5,6,6,72,0.6330294527960252,39.280925975130636,2705
0,12,15,5,10,5,47,0.6274440358835637,39.086591667386664,2700
3,11,15,7,7,6,49,0.6041676734901994,39.11794292690383,2679
0,10,14,6,13,6,49,0.6102392101811775,38.5285301130307,2671
0,10,15,16,16,7,64,0.6769393928124623,37.96966112495371,2648
1,10,15,19,18,6,69,0.7188932643602346,38.004036104441674,2631
0,11,9,23,15,5,63,0.7564746899270832,37.796336003447976,2609
2,27,5,21,14,6,75,0.7386605411992184,37.439008831717565,2581
1,16,7,18,9,5,56,0.7386784498511153,37.553560909648915,2563
3,11,11,20,7,7,59,0.7082610048438857,37.06930689000844,2556
2,14,7,15,5,6,49,0.6593706596998349,37.14478942046156,2543
1,11,6,4,3,3,28,0.6502002259979771,37.32701350718171,2550
0,7,6,10,7,4,34,0.7635881360858554,36.56970032731888,2556
3,7,6,9,0,5,30,0.6710290909172151,36.7556824611682,2554
2,11,6,13,2,6,40,0.6914466462050878,36.618578517135134,2550
4,13,5,8,0,6,36,0.7447295074876188,36.371970606696436,2547
8,24,5,6,0,2,45,0.8891009347088055,35.845414464877805,2553
5,11,5,4,6,2,33,0.9051029060976726,35.433333869703546,2555
5,15,7,10,0,3,40,0.9108799791490032,35.75690001383649,2560
5,3,5,9,6,3,31,0.889253169397546,35.90900230012623,2580
5,5,1,9,4,4,28,0.830297048380715,36.579040621911055,2603
7,6,4,10,7,5,39,0.8457422056732021,36.634467723487276,2629
11,9,5,15,9,7,56,0.832159416101792,36.75830767431579,2638
0,7,5,15,6,6,39,0.7147957922622685,37.47995486903721,2651
20,8,5,7,0,4,44,0.717361214236568,37.79996895104082,2646
11,25,3,1,10,5,55,0.8247631593032143,37.717132779201066,2660
13,14,5,0,14,6,52,0.8499074337109365,36.96452741677531,2675
14,15,10,0,13,3,55,0.9027403478743781,36.949298034806596,2692
10,11,17,0,8,2,48,0.8766285403072143,37.11532572573411,2716
13,4,14,10,3,2,46,0.8501557385708499,36.57649070402724,2732
10,3,10,5,5,2,35,0.9781017945510347,36.50105916426526,2744
11,10,6,6,5,4,42,0.9301650100399137,36.74189139845342,2769
7,16,8,5,22,4,62,1.0105853892295915,35.590744696432594,2782
6,9,6,6,19,5,51,1.035085695360201,36.12025247496721,2785
24,18,6,6,13,3,70,1.1504724161161184,34.632981156576164,2756
9,9,10,5,9,4,46,1.0765325873534253,34.82357115455188,2782
13,9,12,6,6,3,49,1.1457451949909065,33.55323976358342,2788
14,7,11,7,6,6,51,1.036374552670584,34.361317446249274,2805
9,9,10,16,5,4,53,0.9860489724951661,35.126613668090485,2809
12,6,12,20,7,4,61,1.0282763127811727,34.84727873737456,2807
13,8,5,22,5,6,59,1.0349607765317606,35.83235084761323,2808
12,12,5,21,13,2,65,1.0909066182607055,35.346610284613874,2802
9,8,6,21,14,6,64,1.0461945012282479,35.56306340257289,2770
4,17,11,20,7,2,61,1.0034784059941724,35.27475660718467,2755
17,6,8,10,7,2,50,1.0711940661521404,34.72627837608898,2751
3,13,6,7,10,4,43,1.0680631044168403,34.83894123914802,2753
7,6,6,6,19,3,47,0.9905108174951753,34.95529075563123,2746
7,2,6,3,23,6,47,1.059597632934925,35.085360321169695,2732
14,9,6,15,23,6,73,1.1088010831373927,34.04950843806731,2734
14,8,8,15,14,3,62,1.1268532733523355,36.2722251090913,2747
13,7,11,10,11,6,58,1.0673393117075225,36.66533580742137,2739
12,9,7,5,10,7,50,1.059921172487958,35.63733043899553,2752
5,18,8,6,6,3,46,0.993376344779426,36.23586054076907,2767
6,13,8,7,2,20,56,1.0445347428043679,36.53648075171399,2758
4,18,11,13,20,25,91,1.142277747068045,35.72582933349102,2748
29,20,8,9,16,17,99,1.171182954847637,35.66164557991005,2742
26,20,10,10,17,19,102,1.1537562590726735,36.55187245728766,2710
19,21,15,9,17,18,99,1.118692182467431,34.60103642264684,2696
12,7,15,4,12,18,68,1.047965441434989,34.750882269492514,2681
8,10,15,3,14,17,67,1.1729277512478635,34.766602091184936,2677
7,10,16,1,22,14,70,1.0959898675426019,34.930136824527445,2670
8,23,11,0,6,13,61,0.9669339357222821,35.844056615585146,2686
9,17,10,1,4,19,60,0.9158781418863223,36.139258508540514,2692
7,24,6,1,7,14,59,0.7840728560138948,36.5718458472406,2691
2,21,5,2,18,9,57,0.7655901621255464,37.35649366545585,2676
19,18,5,2,11,14,69,0.7143859571726127,39.73721902224589,2641
4,10,4,1,14,16,49,0.6959738963863332,38.733459887291154,2633
8,10,6,15,17,14,70,0.7629513068346923,39.45791753493148,2625
5,9,5,22,13,14,68,0.8915184926162522,35.92554927882575,2607
5,10,5,22,6,14,62,0.8890526779154158,37.31214263341306,2614
6,20,7,22,5,17,77,0.8955999933383674,35.155244500882254,2593
5,20,7,20,1,14,67,0.8056178191639334,36.26626516693178,2575
5,24,7,19,1,12,68,0.8339646219056552,34.947881158114676,2562
5,19,5,11,0,3,43,0.9527580435433033,35.72461281298459,2562
3,14,5,9,3,4,38,0.829795419397229,36.040827694585296,2583
25,5,5,7,21,6,69,0.8543639939859499,36.08803998009383,2566
31,15,2,8,25,7,88,1.0040658501132838,34.69673345925601,2556
32,19,5,9,17,5,87,1.0919796942703086,34.52505404521557,2553
21,13,5,7,9,7,62,0.9879638753000533,36.34929151958137,2542
11,8,5,8,10,6,48,0.9093541112089474,36.678611160283175,2533
7,10,9,10,4,6,46,0.8234571113058169,36.96566668617941,2527
6,6,8,10,0,8,38,0.7432254546124526,37.33672409141907,2510
3,7,5,17,0,5,37,0.6673385759155895,37.41980333373857,2499
3,13,6,21,4,5,52,0.6879163525893915,37.35599592094235,2500
4,12,5,20,7,5,53,0.7554093635506101,36.76442826988685,2494
8,24,5,21,11,6,75,0.8095260726620738,36.7130501706418,2478
1,20,4,7,19,5,56,0.7267194572423875,37.45602393326423,2472
2,18,10,3,15,7,55,0.782038799335816,37.24766010744787,2462
4,10,10,14,9,6,53,0.8429018952456948,37.03048019974651,2466
0,6,7,12,7,8,40,0.9584472060375508,36.73733519983935,2461
5,8,7,17,22,5,64,1.0619807671784964,35.95071233849946,2464
3,19,7,12,27,4,72,1.2234769559646637,35.13909690862075,2450
11,10,7,13,26,9,76,1.2515366615333936,34.94176041858586,2443
5,11,6,11,11,9,53,1.1369532901006252,35.50230267436778,2461
8,9,7,8,8,13,53,1.1884045373940686,35.06059122175978,2466
9,10,8,8,12,12,59,1.0734363718311604,35.34064178763187,2478
7,11,10,9,4,14,55,1.0200988702400704,35.811691393597464,2475
11,9,10,5,4,12,51,0.9670462562930177,36.49556231628231,2473
7,11,11,5,9,13,56,0.8933349974852214,36.85866110531944,2481
5,7,10,4,4,13,43,0.846277419443075,37.8394520101561,2510
8,27,6,2,16,10,69,0.8085976216748124,38.01793812708642,2511
13,25,6,10,17,5,76,0.8640400470722519,37.00008876610457,2504
8,19,5,2,13,10,57,0.7901510853666925,37.36159038749175,2477
5,9,5,8,10,7,44,0.8300538887216237,37.48555496781131,2486
8,8,10,1,6,5,38,0.8938694783834683,35.51481809246584,2506
8,6,8,3,7,4,36,0.7938444367667231,37.03865092772758,2506
2,8,7,6,7,6,36,0.9260605816696709,36.582349606359145,2532
18,7,6,8,3,9,51,0.9641930092687613,36.176999125420934,2542
14,2,10,10,13,8,57,0.9870815533604425,35.9063458056912,2549
17,14,7,9,8,9,64,0.9479901878926974,36.096650306286215,2572
10,7,11,7,21,9,65,0.9527439136248465,35.87261872241691,2578
21,18,8,7,10,8,72,0.9715938268036819,36.86097901601751,2577
8,17,9,7,6,8,55,0.9949642426106291,36.933317873129155,2599
3,16,9,7,6,8,49,0.8620666356252081,37.445655844471474,2610
2,11,7,13,7,8,48,0.7999846254698112,37.19682831226996,2597
3,3,6,9,7,7,35,0.7632370806268842,38.31674072862365,2634
0,7,8,8,5,6,34,0.7984871983585258,38.85038908526743,2666
4,2,5,7,9,11,38,0.7476330709937067,37.76997780186735,2695
3,18,5,7,3,9,45,0.8462467882016157,36.947238451633915,2709
5,11,8,6,16,8,54,0.9097116957611822,36.996777465698855,2717
5,22,5,9,12,8,61,1.0116763425925763,37.24628703218505,2739
5,24,5,9,1,8,52,0.9989702548108453,37.81994381239279,2738
5,14,5,10,5,5,44,0.8981310233125942,36.63869714035917,2732
6,8,5,17,7,5,48,0.773072003100957,37.12891747748613,2738
5,10,5,21,12,6,59,0.810112486863171,36.65393143712205,2724
7,8,6,22,10,6,59,0.9219132347087461,35.802472385224,2714
1,10,16,22,6,6,61,0.9467256008198054,35.19546973592865,2677
17,20,14,22,12,7,92,0.8926186621310498,35.58531407129437,2646
9,15,16,11,5,4,60,0.856381729378362,36.2251743666508,2645
10,16,8,3,13,8,58,0.9303794039492683,35.4770628275648,2631
10,12,5,12,8,5,52,0.9817667649604002,34.63231604183671,2623
9,5,5,13,5,5,42,0.9515776444681171,34.46137777260755,2612
9,7,5,14,9,3,47,0.9526892016013809,34.46035113221097,2601
9,6,5,9,6,3,38,0.8833960813035464,34.28998315417093,2580
6,9,5,9,9,4,42,0.8797956283452316,34.126644633663396,2563
4,11,5,10,9,4,43,0.8159694064229243,34.6302145703355,2556
1,21,6,14,9,3,54,0.7654641373033393,34.88630580223725,2555
10,11,9,14,7,2,53,0.8455495865917063,34.8588062734701,2553
3,11,12,14,5,0,45,0.969072213785012,34.479632223386616,2558
1,1,12,13,18,7,52,1.113730113237933,33.52877700159308,2543
1,7,9,13,9,4,43,1.0399963469740194,33.399818026127676,2544
0,6,9,13,1,6,35,1.0088433691116239,33.69046908497794,2548
0,14,3,12,0,3,32,0.87479903570489,34.41523897793848,2562
0,9,5,12,4,2,32,0.7345775902574412,35.330829853825804,2576
0,7,5,9,1,6,28,0.7193107921611319,35.90624650404096,2595
0,23,5,3,7,7,45,0.6946476508775611,35.52315629175548,2602
0,6,5,7,5,6,29,0.6700150741940213,36.01772702402169,2615
5,18,4,7,9,3,46,0.6891717919001938,36.74866494977121,2621
0,7,8,5,0,6,26,0.6654091298705247,36.95232933418075,2644
0,6,5,3,0,3,17,0.6236942386988139,37.06609504918676,2657
0,5,5,5,0,7,22,0.6205708565012382,38.0779822618283,2675
3,10,14,5,0,5,37,0.7212931728862638,37.209709483708586,2699
6,10,17,7,10,6,56,0.8263353246575589,35.94119992272772,2694
7,8,10,9,8,6,48,0.8193147577741549,36.07026561328616,2703
6,21,13,9,5,8,62,0.8873264127051054,35.50176197222635,2706
10,14,4,8,5,6,47,0.8569075913952244,37.126829467157926,2706
1,13,10,4,6,2,36,0.8589232316822182,37.47633164643749,2715
20,12,6,5,20,3,66,0.8195415994287208,36.60459597017134,2729
0,3,0,2,18,4,27,0.6687257135137147,39.126526817222995,2748
1,6,6,2,0,4,19,0.6192191772006159,39.471021071404124,2767
2,9,5,5,1,2,24,0.5997143150939452,39.65591324901843,2760
0,6,5,5,7,8,31,0.5990472706708101,38.55151928800941,2778
0,14,5,15,6,5,45,0.6217326436221088,41.37865637044994,2776
0,18,6,9,4,5,42,0.5869274555033817,38.51583073367661,2781
0,7,6,6,8,6,33,0.5988263198552585,38.5569604594636,2801
0,15,5,5,7,2,34,0.6203848302442294,39.08637805351251,2819
0,7,10,5,3,3,28,0.5505795763546149,39.10423274289213,2835
12,6,5,6,0,1,30,0.48228959255595416,39.87426178357855,2848
1,4,7,6,0,4,22,0.4161575548021281,40.61447539291819,2852
1,8,1,6,1,5,22,0.39332818533018993,40.732387778627896,2851
1,9,0,6,10,5,31,0.5535896782482588,39.669721169891574,2854
1,12,0,19,10,2,44,0.6030776069968266,39.23852366112239,2859
1,15,1,21,9,5,52,0.7297128731043231,38.57288885663992,2865
1,7,2,20,7,4,41,0.7100839196403868,38.804860200897544,2863
1,14,0,15,5,2,37,0.788426456649343,37.817870344149824,2859
0,6,1,14,4,1,26,0.7128730263466703,38.53948821372579,2857
0,5,0,14,0,2,21,0.6433334745602236,38.53781620616697,2863
11,4,0,12,0,3,30,0.5652773015296122,39.14231420106429,2849
0,9,0,14,0,5,28,0.5074476560160048,39.61976160696158,2854
0,4,0,12,6,7,29,0.46635972457294445,40.330091205040596,2857
0,10,1,10,11,3,35,0.4708143044405214,40.35170236931981,2854
0,6,15,12,8,3,44,0.474210320429258,40.336847052565034,2853
2,7,16,8,9,7,49,0.49038081802622496,40.32923273354525,2850
6,7,14,1,8,0,36,0.5468980434568445,40.14756744098182,2856
3,4,15,13,18,3,56,0.5983587249613856,39.95808018419849,2841
5,3,12,15,15,5,55,0.6721171662513553,39.197729405042956,2840
0,9,5,12,16,3,45,0.6904044822051701,38.99551276736446,2828
20,4,5,11,15,18,73,0.7462112870126115,38.13516673779185,2790
3,9,6,9,14,16,57,0.7690250526423668,37.9659278404006,2786
5,13,6,12,0,20,56,0.7515034744892463,37.8394238082931,2784
5,7,5,8,0,17,42,0.7586354822711864,37.58465631938848,2782
6,6,5,6,1,20,44,0.7560547288864363,37.508471225630366,2804
6,7,5,4,1,18,41,0.7250097254616532,37.86907287245423,2805
5,23,10,10,2,18,68,0.7890760262244111,37.533895644882854,2793
5,24,9,10,16,14,78,0.9830738703378432,36.67880751605845,2795
5,24,6,7,12,11,65,0.9433306328359987,36.85482870367518,2793
4,20,5,3,13,9,54,0.9544233783473959,37.267897746993256,2804
2,16,1,6,9,18,52,0.9508082518297857,37.453309237362355,2820
33,12,5,1,16,18,85,0.8487898171961101,37.24517228677791,2795
30,7,5,7,13,15,77,0.8647222989613741,38.50821298628367,2776
12,8,5,0,19,15,59,0.8549624365536349,38.4369213348446,2778
16,9,0,5,7,21,58,0.8909811112837824,37.54590796178252,2787
13,12,5,1,16,18,65,1.0344620891012817,37.41703778719156,2791
13,13,5,0,13,11,55,1.0203564386456074,37.14837460883009,2779
10,19,11,0,20,11,71,1.0807059444051716,36.60522025139367,2784
26,17,10,10,18,12,93,1.112064337240885,36.12672285618875,2749
20,27,11,14,19,12,103,1.0882398189203952,35.638655901942656,2730
6,19,3,14,16,13,71,1.119744119314652,35.01814458188724,2704
27,11,3,16,18,7,82,1.1105418286140463,35.18656429734977,2680
16,10,8,15,13,6,68,1.0759266300078278,35.47169313563403,2668
5,10,9,15,4,7,50,1.041153077600327,34.95396926269837,2638
8,21,13,11,4,9,66,1.0694941692972426,34.36168540271825,2643
3,20,7,12,4,6,52,0.9586657285709554,35.17468151103388,2638
3,18,10,6,1,7,45,0.9702664594917519,34.394475118691695,2643
7,17,10,6,19,5,64,0.9449216991282836,34.76571622080296,2656
7,6,10,0,20,6,49,0.904846377060044,35.668730980540275,2681
12,9,9,4,11,6,51,0.8945865907154185,36.206824189621216,2699
7,16,7,8,11,5,54,0.8841959473665529,36.41464155204126,2687
4,19,5,13,16,9,66,0.8891392348518402,36.70101066829107,2684
13,11,6,12,11,13,66,0.9400581636589013,35.92431450465938,2677
6,12,9,15,7,11,60,0.9059377505933697,35.90230893883873,2673
7,8,11,13,7,14,60,0.8584991416713902,36.45012621694502,2655
1,7,11,14,8,11,52,0.8265826271942737,36.96544063114105,2651
5,10,12,13,33,10,83,0.8935970295302763,36.210244792567195,2651
4,11,13,13,27,9,77,0.8507957232841589,38.00700740749174,2661
4,6,11,9,7,9,46,0.8139894232253846,37.95603845558811,2682
4,31,10,7,9,11,72,0.7999166164606406,40.136948043140194,2670
3,25,13,4,7,8,60,0.7424718689292792,39.37610361617451,2667
3,23,9,0,8,13,56,0.7334358120286423,38.87006875936391,2671
24,11,10,0,22,14,81,0.6968841463733543,38.95740472247021,2663
25,9,10,2,14,6,66,0.6560738254765015,38.7081450723743,2647
13,8,12,1,7,4,45,0.5656609089799771,39.9185814923183,2644
1,11,12,0,11,5,40,0.5338292304974754,41.66610868793478,2641
0,8,11,0,6,8,33,0.5145340022044741,41.032058969559934,2640
0,10,9,0,0,6,25,0.5402880442877668,41.01518805003722,2654
0,19,13,6,0,6,44,0.6575800632900736,41.611979490212555,2670
0,17,16,6,1,4,44,0.697795496812065,41.528309911445895,2668
6,18,15,9,15,8,71,0.7345560805853254,41.23429890438259,2654
1,17,15,4,7,3,47,0.6882765316090443,41.38169667199711,2657
12,8,15,6,7,1,49,0.5527842534255877,41.72534269287416,2639
0,2,12,6,8,5,33,0.48575240638234646,42.182100888322765,2639
4,8,11,7,1,6,37,0.4088160800520697,42.45679103828306,2639
5,7,7,7,0,4,30,0.5329597684883183,42.071305608841165,2653
8,5,7,8,0,7,35,0.5300287278953447,42.15933634980378,2665
9,17,9,16,3,7,61,0.6387773955977372,41.319169856220874,2655
9,15,9,17,16,8,74,0.7603241411898426,40.81870829876048,2648
24,14,5,17,17,9,86,0.9009137850383488,39.530539621291936,2624
21,17,5,15,7,7,72,0.9547016021477792,38.861160730193895,2605
5,11,5,14,6,5,46,0.8828551541992702,39.30442190152954,2602
13,10,6,15,15,6,65,0.9318613527160912,38.84347484516983,2573
6,6,7,14,17,9,59,0.9202182846178234,38.73853125021249,2548
6,16,9,10,16,10,67,0.9121934259482348,38.24324611861123,2515
4,18,11,11,12,8,64,0.9354717203105458,38.131093133479084,2500
9,18,10,10,8,11,66,0.9327992670093478,37.592697836131975,2492
4,19,9,9,6,7,54,0.8896170827053124,37.4671675640726,2481
1,11,11,12,7,8,50,0.7891402548735326,37.968786550619676,2461
1,9,10,5,6,2,33,0.7310696220953934,38.05682722297383,2458
3,7,11,14,6,7,48,0.7448894453459718,37.90682527175537,2460
7,14,5,13,4,1,44,0.7821808220716739,37.87287374209317,2452
3,9,13,12,22,3,62,0.8849309236467624,36.70318410304134,2440
4,7,5,11,19,4,50,1.1338677539766033,34.74508989623617,2447
12,4,5,8,17,2,48,1.1809171611945686,34.084953025226596,2469
10,7,5,10,12,2,46,1.2099725724575172,34.13706181177166,2467
5,2,5,11,6,2,31,1.2158866617193662,32.19172720186076,2501
8,8,5,11,6,1,39,1.0743106296269953,33.446748852512115,2513
9,8,7,9,8,3,44,0.9973965796695086,33.120409856624384,2532
8,9,7,8,7,4,43,1.0378426803549314,33.4883533627124,2542
7,16,5,5,9,1,43,1.066617060945337,33.65473358275817,2558
9,2,5,6,23,3,48,1.1046155713094092,33.60216909743067,2566
11,11,5,2,18,5,52,1.0879784690807015,33.80079433100787,2577
2,4,10,6,19,5,46,1.0006903845549189,33.723872934782705,2583
27,8,14,3,13,4,69,0.9615415438526861,34.4259783210724,2582
10,5,12,0,13,3,43,0.7867034216446084,35.372720679672135,2582
9,10,11,4,11,4,49,0.7527580967914483,35.15716123656914,2580
6,10,12,1,13,5,47,0.8215036071550392,35.092894197136,2594
12,8,6,0,7,3,36,0.8402138454432195,34.50837296659869,2590
6,20,9,2,7,4,48,0.8265044759483283,35.23292326832966,2584
6,6,8,3,6,4,33,0.7427733893157656,35.75769072768923,2596
10,19,9,5,16,4,63,0.805640704116803,35.691809055599016,2593
6,12,8,7,8,4,45,0.8704236939380223,36.21362142227985,2603
1,5,5,7,1,2,21,0.7863554722439265,37.174133415253316,2603
12,4,5,6,1,2,30,0.7638500349294252,37.45832727680708,2612
9,9,5,8,9,4,44,0.747991357045212,38.19308098213315,2609
14,4,5,16,8,2,49,0.7480281512047335,37.80442260073554,2611
11,8,6,15,10,2,52,0.763367925817174,37.65644405602631,2604
7,4,5,16,7,4,43,0.8042159779998554,36.786543264337396,2587
7,4,6,15,21,2,55,0.9873722014417169,35.78622243086361,2582
8,4,6,13,17,4,52,0.9768787862653797,35.81549284360953,2567
12,12,14,14,3,2,57,0.9242903692522618,36.007332036484534,2565
8,3,11,15,7,7,51,0.8711218099144712,37.282079999999,2573
1,9,13,9,12,7,51,0.8472929912418411,37.35358206876885,2579
15,8,12,7,8,3,53,0.7208169309088,37.95974931957659,2563
4,7,13,6,6,5,41,0.7488899382667569,37.81237178535439,2577
8,5,10,5,8,4,40,0.6893904996352529,38.059040882953276,2579
8,13,9,7,17,3,57,0.8230326303593168,37.73947165249275,2578
15,4,7,4,5,4,39,0.8007032090459836,37.64296098649699,2590
11,8,8,17,6,1,51,0.8571550517369084,37.51252859065319,2587
13,3,5,11,7,4,43,0.9785005601912047,36.503291664967755,2594
17,5,8,12,10,17,69,1.0505459412838654,35.61708564403591,2598
9,10,7,13,10,17,66,1.0534009885393594,35.946404829308754,2580
1,11,7,12,11,17,59,1.0715803501293368,35.894842200176086,2583
18,10,11,10,7,18,74,1.1616525502770854,35.23717103566192,2561
7,10,16,7,8,16,64,1.246137266991918,34.78250937448373,2578
10,21,15,11,12,19,88,1.2687601892812754,34.39450639304575,2560
14,21,15,9,16,17,92,1.3613433690936905,33.54536100346001,2539
12,29,15,7,9,13,85,1.360744190219188,33.18228566585543,2523
12,29,14,2,17,18,92,1.4114614058171189,33.13121690060458,2496
9,29,11,2,21,18,90,1.408831904414942,33.45126950144646,2493
8,16,5,7,12,19,67,1.266070444217601,34.26462578999786,2500
8,11,6,9,10,17,61,1.1166659087920363,34.62071622168446,2507
1,11,5,9,12,14,52,1.0966447021436003,34.90779352531797,2525
15,7,5,4,9,13,53,1.149932128405445,35.29461633711602,2531
6,18,5,5,11,14,59,1.0786076500745005,35.848872566446516,2554
9,16,5,4,11,16,61,0.9525537796393126,35.917926652782924,2536
5,27,7,5,6,17,67,0.8699408660307559,36.48439837397489,2543
8,26,8,7,8,16,73,0.7662611806731687,37.18706470316224,2527
4,22,5,7,10,10,58,0.7524388648130657,37.44659431043129,2534
4,8,11,6,12,11,52,0.7772462597944175,35.723545924550834,2550
7,12,9,5,21,16,70,0.7739819916608305,34.76227315743236,2554
7,9,7,7,25,14,69,0.8269731385626632,35.68728751984138,2559
3,8,8,7,4,5,35,0.8343234744467377,35.31026713994543,2594
3,13,5,10,2,6,39,0.7939636419760778,36.192070501024745,2600
12,6,5,16,7,12,58,0.8854552577664591,34.66226111290802,2588
7,19,6,19,10,3,64,1.0129157580003199,33.89426963660817,2579
10,19,7,22,14,8,80,1.0425518945281718,33.20848443730826,2554
11,9,6,20,6,6,58,1.0067872553661463,33.172823411431025,2545
6,12,6,14,4,7,49,0.9539071676993355,33.4396429400401,2535
11,9,7,14,18,7,66,0.9800984378988157,33.48505010401535,2533
6,7,9,15,20,8,65,0.8814689162200702,33.851980565897655,2522
7,17,8,10,2,9,53,0.9115233002601925,35.45264455918115,2533
6,12,7,8,3,9,45,0.86568193733749,34.12706110341077,2530
2,10,6,10,11,10,49,0.8644733757200735,34.69997520642425,2531
14,13,6,6,6,10,55,0.8452454011227405,34.53486020763942,2512
2,9,10,9,5,5,40,0.8422951498001368,34.57561559746501,2508
3,9,9,10,5,5,41,0.8247272950818855,34.435083532491504,2504
3,13,7,15,4,4,46,0.891855507541324,34.062965726935936,2496
5,5,6,13,16,3,48,1.0201255587988136,33.15417952949034,2493
5,11,5,14,17,4,56,1.0607599865054074,32.80454580507468,2486
6,7,3,13,14,7,50,1.0780377338599068,32.372510415234295,2478
7,7,5,10,15,3,47,1.085697194827587,31.690153906728014,2451
7,5,9,13,14,3,51,1.0857182873795026,31.095503870573992,2452
5,5,9,8,19,2,48,1.1049046329578291,32.841689120671155,2451
10,8,9,8,16,2,53,1.0687939576076242,33.913744081548515,2465
13,11,13,7,9,2,55,1.0577300743627882,32.12133619902315,2462
11,18,14,5,5,0,53,1.0526993963751072,31.95593434494088,2475
10,8,12,6,16,3,55,1.080428502847486,32.34111307454473,2494
11,9,10,3,17,4,54,1.070899536750484,33.24764410416096,2516
26,5,11,6,21,3,72,1.0308170690697651,33.039855435277104,2502
21,4,14,6,18,5,68,0.9543235596099477,33.13995858177116,2486
21,5,11,0,10,6,53,0.8598996163171945,33.56518390162058,2470
11,9,14,0,13,3,50,0.7477897434977944,33.915488947575106,2461
0,7,10,0,18,4,39,0.6798167811311541,34.59936091147298,2470
10,7,10,14,12,3,56,0.7106820050384111,34.04325191530877,2465
11,17,4,6,8,3,49,0.7175600519235674,34.17803468828682,2463
11,8,0,6,7,4,36,0.7332763372029771,34.304137542842895,2476
7,14,9,2,5,4,41,0.7971049756818028,33.87536415119451,2482
7,9,10,3,7,5,41,0.8076305108714664,33.79872144404094,2496
12,5,10,1,6,3,37,0.6599156375259677,34.633372641641515,2501
2,4,10,2,7,4,29,0.6864441348732239,34.28304224224947,2504
4,9,11,6,7,2,39,0.7125519413083452,33.91989764030757,2499
6,11,9,11,11,4,52,0.764569005537727,33.73092470315393,2493
10,7,7,16,13,5,58,0.8470646023682558,33.03597972915519,2491
12,19,10,20,10,2,73,0.9110956648287464,32.64099430913236,2479
4,10,8,20,7,3,52,0.8249801382597214,33.47179237532244,2487
5,14,10,22,6,5,62,0.7841050324005557,33.65904689218393,2462
4,7,5,21,14,3,54,0.7040357603367151,34.033610409778916,2453
2,5,6,14,19,4,50,0.6722449149347537,34.73872427776933,2454
1,5,3,11,13,3,36,0.6035928983759848,34.75211712594454,2457
0,9,9,10,8,3,39,0.6362423345023887,34.60387074597434,2450
0,5,11,12,7,4,39,0.6449514322971511,34.512494803218836,2448
5,6,10,5,17,4,47,0.7509006393726312,33.92957856871971,2460
8,6,10,3,20,4,51,0.6629919111190113,34.221461524168724,2455
3,6,10,1,10,17,47,0.6688978796541609,34.186644948890816,2451
0,10,10,3,2,14,39,0.6124401111733421,34.21639345267969,2456
5,9,11,12,13,18,68,0.7801282473762986,33.64431592117156,2451
6,19,12,14,8,17,76,0.8791990801140711,32.49966568774845,2443
5,17,7,7,6,18,60,0.8972075395584252,32.188709147857914,2426
5,16,6,13,2,17,59,1.0332949739453252,31.04738132936924,2412
10,8,6,12,2,22,60,1.129577729792537,30.25348609661763,2397
11,11,5,13,5,13,58,1.1244603174479983,29.971974230255313,2398
16,7,9,11,7,11,61,1.238683227323658,29.733063302574706,2404
29,22,9,7,5,10,82,1.2441579294531233,29.146938895869063,2392
5,30,9,5,7,18,74,1.2431794587770175,28.89615419207049,2376
17,27,7,6,5,18,80,1.3234772265978842,28.686711968949613,2380
15,19,10,5,8,17,74,1.2716117443425317,28.6217444848196,2368
16,17,11,6,9,12,71,1.3235397645020313,28.84441079356276,2366
4,12,5,6,13,12,52,1.1690346833359377,29.35335481585788,2347
8,7,0,1,12,15,43,1.1514792181544171,28.913321210432326,2348
7,10,0,1,13,16,47,1.085591462901322,29.325592653943346,2350
3,6,0,3,7,22,41,1.012826451572916,30.23619537020659,2370
5,32,0,0,4,22,63,1.0174777500874972,30.346218402572344,2386
9,26,0,10,22,10,77,1.0971248762194887,30.364431190766986,2378
6,22,8,7,26,9,78,1.1817867397613688,30.195753225349453,2381
14,15,5,0,22,8,64,1.1646930057697864,30.46989088209217,2391
7,13,5,0,11,7,43,1.0788775277147535,31.118010433671927,2436
5,16,6,0,8,11,46,1.0299087594772547,31.578549173441694,2458
12,9,5,11,11,13,61,0.975231535938434,31.86336474562043,2455
13,9,5,13,9,14,63,0.9674237952135393,32.17046657095826,2451
13,9,5,15,9,12,63,0.907859454358897,32.25357871313459,2444
12,22,5,15,7,13,74,0.9418935901800627,31.769051495281214,2432
6,19,5,14,3,14,61,0.8953113626184297,32.07530879854313,2419
