throughput_KLONGTEI,throughput_KASEMRAT,throughput_NARANONG,throughput_SUNLAKAKHON,throughput_RAMA4, throughput_ATTHAKAVI_RAMA4,throughput,mean_speed,jamlength_percent,Backlog
0,0,0,0,0,0,0,9.904311108768514,0.0,12
0,0,0,0,0,0,0,9.510618986914455,0.01033450002829683,29
0,0,0,0,0,0,0,10.022759566896088,0.025972844830059516,47
0,0,0,0,0,0,0,9.870536560620804,0.025972844830059516,74
1,0,0,1,0,0,2,10.333945156036938,0.08519748163136198,102
1,2,2,0,1,1,7,9.692544718728476,0.1610700015374209,136
0,5,0,0,1,1,7,9.59040697712632,0.21950449024332105,151
1,3,2,9,0,1,16,9.781123340995398,0.22396879390330995,183
1,4,1,0,1,2,9,9.565911879737097,0.3048554958352322,215
4,7,1,1,2,2,17,9.609625254065127,0.3680565639198997,243
5,5,1,2,3,7,23,9.189191544933953,0.5175431478361121,276
5,9,0,4,3,6,27,8.801754790284336,0.6614450677980692,295
2,18,2,3,4,5,34,8.091185174206931,0.7841682703197494,329
18,10,1,0,2,5,36,8.058923419855786,0.9231542675832608,344
8,13,0,2,9,6,38,7.6906583991621265,1.2702216059362201,367
6,6,0,17,3,4,36,7.2251683175567365,1.4735316566947083,383
8,10,8,6,9,4,45,6.976430203527641,1.6296321900755324,393
7,4,3,3,5,7,29,6.673353748007174,2.0148863283418246,415
7,8,1,3,5,10,34,6.078473204420472,2.381180578908318,433
11,21,4,5,6,8,55,5.76408250830267,2.589869639086577,430
8,12,1,3,9,1,34,5.54338619025229,2.7581101004970576,454
8,4,2,2,6,8,30,5.570720377113237,2.9204780254208984,480
6,4,14,4,5,7,40,5.44022238877869,3.121514918375812,506
6,7,10,15,5,3,46,5.584406744696146,3.019662256126651,525
5,7,9,14,6,7,48,5.571085954729465,3.1293581982498506,546
6,10,8,3,9,6,42,5.487648267207506,3.534977668684829,559
7,10,14,0,3,6,40,5.095412606153281,3.9837051819406715,573
5,11,6,1,3,2,28,4.738623253907261,4.597720783356953,596
3,5,11,17,22,3,61,5.080967414599006,3.9774488970182764,597
15,4,7,14,28,10,78,5.477290418063199,3.971236060303869,631
13,6,7,1,19,10,56,5.20216126151666,4.4311055310594645,653
8,11,8,0,6,4,37,5.121926354177181,4.5997842139970935,682
10,19,7,2,5,12,55,5.05783337082454,4.39040779878193,690
10,19,7,11,2,13,62,4.85645020871453,4.608416792329403,700
7,13,6,7,7,18,58,4.561984371335455,5.056417334680182,711
12,15,8,4,7,14,60,4.131814569482114,5.593496857404532,713
6,13,6,1,7,12,45,3.961973219131837,5.916404317362173,732
11,22,11,0,7,12,63,3.973899531682056,6.194052896195582,742
10,11,8,1,6,13,49,3.721609610709878,6.556342610972366,753
10,7,7,1,3,10,38,3.463414718179546,7.144075433469686,774
9,5,7,2,6,8,37,3.1777390599691624,7.418297408349061,782
9,7,6,2,15,8,47,3.1379654748685155,7.545749114898546,802
11,8,9,1,24,6,59,3.1381692664878016,7.796748587099573,813
39,6,8,1,20,8,82,3.080758873127664,7.870843679280627,820
7,5,6,17,12,5,52,3.0990453383916243,8.073391848115,840
29,7,11,20,9,9,85,3.3266240905801507,7.510554647752371,809
12,5,14,22,7,8,68,3.401809785245536,7.310468115957701,798
10,10,10,9,6,4,49,3.202458154779624,7.70147419816522,809
6,8,10,13,6,10,53,3.1683933530832378,7.735820352169792,817
4,8,9,15,10,6,52,3.127214202850632,7.68072152902521,817
10,16,6,12,5,10,59,3.30738260248168,7.610290304556106,828
6,20,5,16,10,4,61,3.334034755007836,7.571262379057808,836
7,11,6,11,8,4,47,3.3546546248336737,7.600521697877946,866
7,6,13,6,4,6,42,3.205795228763538,8.159673785206067,904
5,7,11,17,4,9,53,3.1403446092681753,8.31579280707717,906
7,10,7,20,6,6,56,3.3589965135924995,8.450409953111008,936
3,15,6,8,7,5,44,3.2939796345921803,8.716118652704479,956
13,13,6,3,6,5,46,3.3366010462825537,8.857312290913686,965
5,15,12,2,8,6,48,3.356075628138465,8.940778760678478,990
2,13,15,2,6,6,44,3.0994374730440852,9.156649431939378,1007
2,10,9,4,5,4,34,2.918986817923838,9.738076303925912,1026
2,8,3,4,6,5,28,2.7053969730289062,10.491844434136747,1043
7,10,14,9,8,6,54,2.935904337145477,10.533450124870539,1067
7,10,9,11,18,6,61,2.827729898190404,10.284959540947401,1068
2,8,7,8,13,7,45,2.7287344641611377,10.862239869844025,1075
0,9,6,6,13,8,42,2.3471726353384232,11.698495980970197,1078
0,3,7,5,0,8,23,2.227611897394276,12.563475581541306,1116
0,21,4,4,1,7,37,2.162009117019911,12.613370586165244,1122
3,30,10,4,1,11,59,2.2913655905088217,12.451777964693951,1138
1,31,11,4,0,6,53,2.248216963293939,12.682242656336154,1131
2,24,10,0,5,1,42,2.2518191048515686,12.834462792765086,1146
0,15,10,17,11,8,61,2.4136707166820774,12.072631557150343,1143
0,5,11,20,15,8,59,2.436074688449691,12.075638845423908,1150
0,9,10,23,8,3,53,2.2307060502567895,12.494941164120196,1136
1,10,13,12,7,6,49,1.9459631187317903,13.29835763842896,1147
11,11,11,2,23,6,64,2.094719446371763,12.875787770076311,1149
11,9,10,15,26,6,77,2.8272181833902015,11.56159799010414,1162
20,12,9,15,27,6,89,3.0547885590757855,11.373370714447283,1181
15,13,7,15,16,4,70,3.094364553356731,11.373252677087597,1184
17,7,7,10,11,6,58,3.043343215528924,11.518911818377614,1193
16,18,7,14,12,7,74,3.0842042593669152,11.28385269290311,1189
15,21,9,13,10,8,76,3.1445394876956487,11.075222169203704,1197
17,22,5,9,10,14,77,3.047602990468501,11.15211766546635,1219
18,18,8,7,12,12,75,2.9567810897220754,11.960530403135692,1237
17,9,6,7,13,17,69,2.5880983427088062,12.80288632766707,1253
6,13,7,7,7,12,52,2.1850732384042,14.037217420885806,1272
18,9,8,4,22,11,72,2.3284510410311703,13.726058098226417,1273
15,8,11,5,33,14,86,2.3581323720186833,13.79245389955875,1292
15,10,16,4,26,11,82,2.539845316004164,13.332545442645415,1299
12,6,16,14,19,12,79,2.678356862080678,12.708822083820166,1302
30,8,11,19,15,10,93,2.782055248395022,12.313146190071617,1304
35,10,10,16,13,10,94,2.8757834921678205,12.529984291730019,1284
32,10,12,15,19,10,98,2.680783691820321,13.098741328117876,1281
14,8,10,7,17,13,69,2.436723293958324,13.86964228892861,1281
17,11,10,5,18,9,70,2.0563775871185137,14.442733240603628,1290
10,7,6,9,13,4,49,1.841157246979985,15.3213227783821,1291
15,25,5,7,10,1,63,1.7683185829299302,15.081567299067693,1283
9,29,5,6,10,2,61,1.7842257746124535,15.285790964906615,1279
7,31,5,1,7,5,56,1.717503352893438,15.484628838018622,1288
8,24,5,15,6,8,66,1.679687499385313,15.639565266213493,1280
9,11,8,22,6,6,62,1.8473448374743158,15.299497233439329,1286
2,11,6,22,7,7,55,1.8614484529346067,15.124916474992776,1283
2,10,7,19,8,7,53,1.9711005739786296,14.777947845301387,1291
5,7,5,22,6,5,50,2.079802694026401,14.73976879446418,1294
4,21,6,19,6,5,61,2.0866022039185204,14.787789674753174,1291
5,20,12,20,5,4,66,2.065000410299647,14.606652431938222,1289
2,17,15,11,8,7,60,2.181072422074739,13.84783229606584,1286
2,20,16,6,9,6,59,2.387011524180483,13.895975776021796,1310
4,18,13,4,6,3,48,2.337893455435415,13.988802184231432,1320
4,7,8,15,5,10,49,2.2021013412573263,14.43865854910096,1325
2,8,13,14,4,8,49,2.188195448135299,14.483719160451415,1345
2,14,11,13,10,5,55,2.23649138987279,14.783743683597804,1359
3,7,11,13,7,5,46,2.303377535080492,14.75650839920245,1370
0,6,9,11,13,10,49,2.3131195471620525,14.980004265402892,1389
2,13,6,12,18,6,57,2.2564760071318597,15.427276716288024,1393
7,5,6,9,15,12,54,2.0846312838334584,15.957137893409952,1403
5,11,5,4,15,7,47,1.8081946559100874,16.452717348357453,1398
10,14,5,5,18,9,61,1.9737883912047347,15.942438917704502,1421
9,13,5,4,20,6,57,2.0204178173946343,16.14186732315634,1430
8,10,5,8,21,11,63,1.946659936264672,16.59795804483979,1452
2,9,6,4,17,5,43,1.7245228870237281,17.545509346852903,1472
6,3,5,13,7,2,36,1.682702880155436,17.695614411842786,1487
12,2,5,16,3,6,44,1.7710886585776593,17.509346184595476,1516
13,3,6,9,21,8,60,1.890872820542865,17.555142752023677,1523
14,3,5,9,30,7,68,1.99880935421463,17.81341590828534,1555
11,4,5,8,22,10,60,1.94088521136765,18.41785408993382,1583
10,18,14,7,13,6,68,1.9867269811695214,17.97931610872138,1595
0,19,12,2,18,1,52,1.8841816346283522,18.036705345403085,1607
31,22,12,1,17,5,88,1.9071481112147268,17.742256027984222,1589
34,20,11,2,10,5,82,1.8543252756119597,18.421433271931676,1569
32,3,10,1,9,7,62,1.6594349645646662,18.282247093960276,1563
9,6,11,1,20,10,57,1.6841866334901041,17.98534928730721,1574
15,0,13,3,18,8,57,1.6597269332236977,18.32729175727469,1571
12,0,11,16,8,8,55,1.6178103541245377,18.24819072740335,1563
10,4,11,12,7,10,54,1.5149467891696737,18.72033688884444,1571
7,11,3,7,6,9,43,1.3967396556049791,18.698560090744667,1578
12,13,5,7,2,7,46,1.4679938975435727,18.792327334907686,1585
14,22,5,3,7,4,55,1.5634847093185897,18.50209043055395,1590
13,24,5,16,9,2,69,1.671555231636907,17.739256865766315,1572
9,26,5,19,9,8,76,1.8526107339500095,18.047827245587523,1573
11,30,5,21,5,7,79,1.7444443751096164,18.363708410840545,1559
0,11,5,22,5,4,47,1.5740742035756758,18.46384121684629,1549
16,10,5,20,23,5,79,1.7553944580901306,18.590960047048277,1540
24,11,5,18,11,5,74,1.5482099363846764,18.702906762609228,1514
11,7,12,11,5,5,51,1.440704739205899,19.09879536385625,1510
9,11,6,13,2,4,45,1.3079315897555486,19.447829862273124,1518
8,8,6,5,9,3,39,1.2182958727518738,19.321374721852962,1520
5,9,9,2,4,3,32,1.3393607821752058,19.447890774075226,1538
11,1,9,3,3,4,31,1.2896383527757702,19.50564418026518,1563
6,1,7,1,5,3,23,1.298641357263324,19.797830880233114,1597
4,2,6,4,5,0,21,1.2271821929442481,20.07498996851878,1604
5,2,7,16,3,3,36,1.2893641460576313,19.55421189440661,1625
3,3,5,17,5,1,34,1.4945537387215737,19.372834147441036,1645
10,0,5,15,9,4,43,1.600230088085865,19.388282399540724,1658
11,21,9,11,21,5,78,1.7652431942747655,18.874515567797165,1664
1,30,7,11,25,4,78,2.054686080619794,19.025682194436847,1671
14,26,4,13,17,6,80,2.0632759987044453,19.07963906845863,1678
10,18,10,8,12,4,62,1.9207721450630526,19.76196346952463,1699
5,20,15,8,11,1,60,1.9355638529959294,19.412776674566647,1711
7,11,15,16,6,4,59,1.932638773336339,19.182472985913588,1707
10,6,16,21,8,6,67,1.9668400624843865,19.319017629009323,1724
6,11,8,18,9,6,58,1.9084773302032876,20.2430672060389,1738
8,8,6,8,8,2,40,1.7409966161154566,20.61124433485891,1745
10,7,6,2,2,3,30,1.6251343707309958,21.396257231780474,1765
11,12,5,1,4,8,41,1.5161139488031878,21.24415223238149,1767
11,10,5,17,9,7,59,1.4907806412679876,21.346320052321314,1754
15,6,5,12,13,7,58,1.5134009569162101,20.87256711363059,1757
14,9,5,12,8,7,55,1.362571445608458,21.042846471485102,1751
12,7,6,2,9,6,42,1.325872557564822,21.462031072684123,1768
0,3,5,16,6,7,37,1.2167100086376907,22.275055393925737,1772
34,1,8,9,8,6,66,1.347666281854409,21.7517455544934,1764
13,3,11,1,7,7,42,1.3747085427415606,21.577760284515694,1775
9,23,4,0,8,7,51,1.4971858621523695,20.87960857500768,1786
14,28,3,15,5,7,72,1.5984866219648581,20.993833550991447,1798
7,18,5,15,4,6,55,1.7066092249167584,20.763057648117833,1797
5,16,6,10,5,7,49,1.7649621123826653,20.795867780238275,1804
7,17,5,5,8,7,49,1.6637729042623908,21.297470318983578,1810
8,13,6,2,5,6,40,1.5389340426279265,22.02969486512928,1831
4,3,5,2,6,7,27,1.410185631721119,22.69468578887186,1846
7,7,7,3,6,6,36,1.2271874894034736,23.60070673302409,1849
11,6,6,5,5,6,39,1.3041843800321926,23.49697903008082,1871
5,3,5,13,7,7,40,1.3771606093491646,23.48537775575255,1879
5,1,7,17,6,7,43,1.3192269907670575,23.49902918927465,1905
0,14,8,9,16,6,53,1.3372974706570022,24.170684179323068,1914
2,16,6,5,7,7,43,1.3974669150881631,23.533853794539258,1917
0,10,7,2,14,7,40,1.4260428757748167,23.168931273000943,1927
0,10,6,15,16,7,54,1.3788054643852587,23.309047651690847,1902
3,11,5,5,12,6,42,1.295647249757779,23.290044870921367,1904
3,4,6,4,15,7,39,1.101518308798016,24.475623156349013,1911
0,4,5,1,4,8,22,0.9986312166461729,24.98708583055832,1928
6,1,6,17,19,5,54,1.1856402587922656,24.458388781028003,1929
2,21,6,13,26,7,75,1.4240628444462553,23.00884255832744,1913
11,27,7,1,28,6,80,1.5512638566239039,22.825324400160937,1907
9,29,9,2,12,15,76,1.4183036374130849,23.227840353897076,1924
8,26,9,7,5,15,70,1.4484630732581698,23.548170576250097,1931
8,26,9,12,13,18,86,1.489860275893064,23.49405202211357,1924
14,18,5,10,11,18,76,1.4420761766876513,22.838113200024047,1913
9,18,5,12,18,14,76,1.6020092502679775,22.427909610557734,1907
2,16,5,6,23,18,70,1.6624730913026964,22.093642325142824,1916
38,13,5,11,7,11,85,1.5892652707497128,22.43943576553135,1918
14,13,5,13,12,12,69,1.359812233477422,23.29325300370977,1945
10,15,5,7,10,6,53,1.1783712711780814,24.41138233931957,1972
7,7,5,15,5,18,57,1.2702457404700214,24.560116387009902,1996
14,15,5,15,3,15,67,1.3234661469403106,25.188675034560195,2002
14,19,5,16,10,14,78,1.489922948996097,24.73503333698559,2004
32,22,5,14,21,12,106,1.5865483430186753,23.823358840422532,2000
24,21,5,13,28,13,104,1.5918579467207075,23.861191975504198,1980
29,24,9,9,22,15,108,1.4522472617930298,24.43307231044871,1961
15,11,13,7,11,13,70,1.4515242807888722,23.991431684580217,1965
7,7,10,4,21,13,62,1.5577190407806751,23.33457430138251,1966
7,10,14,2,24,13,70,1.5017693078548346,23.58282305165076,1963
6,11,13,5,6,6,47,1.4577744936006163,24.280842475263054,1976
2,11,12,3,6,7,41,1.411035288928145,24.875382536739828,2007
9,10,11,4,23,11,68,1.3744127850051338,24.698825271836437,1989
16,7,11,2,23,11,70,1.3558322743605413,24.80409811493657,1972
16,8,12,18,13,13,80,1.2990270020607595,24.9829941250163,1965
6,5,8,18,11,9,57,1.2376816974785445,24.837239096524137,1969
1,9,7,12,7,9,45,1.2014017096511644,25.356446701636305,1985
0,7,9,10,0,3,29,1.1518550691864329,25.957114831332476,2013
0,22,7,6,0,1,36,1.1077396225814073,25.77532493688505,2010
0,30,15,1,0,1,47,1.181523324569454,25.26397710502428,2026
7,30,15,3,18,10,83,1.1672017597594675,25.614953182844555,2013
13,25,15,2,23,6,84,1.1293095139078706,25.611642599081016,2006
16,10,15,2,16,6,65,1.0801370308487537,26.051608037466508,2001
9,8,16,8,5,6,52,0.9461820927905794,26.432746933817917,1991
4,9,15,10,0,6,44,0.9130380887129781,26.546875847459116,1984
0,8,15,12,0,5,40,0.8757602962830269,26.760653460553815,1986
12,8,10,10,0,5,45,0.82747160600759,27.059841293013054,1989
7,7,5,6,11,6,42,0.7486896171264341,27.42974878480954,1999
5,7,5,6,4,6,33,0.8190144916086064,27.492348235128652,2017
4,7,5,5,3,6,30,0.783267820797862,27.45536070977701,2028
10,7,5,4,0,5,31,0.8627157399666895,27.200668939607922,2047
7,17,5,6,4,12,51,0.9326527691650254,26.96952792825038,2058
12,22,5,6,2,8,55,0.9903103917842988,26.91951017222783,2055
16,24,5,1,7,5,58,1.0485632790194586,26.45931646948637,2061
11,21,5,17,14,7,75,1.2088713587008193,25.926420304362125,2060
13,21,5,21,8,7,75,1.4571580608910883,24.934248741085057,2061
16,20,5,22,5,6,74,1.5554175054815296,24.719157857510343,2066
13,16,6,23,17,11,86,1.5306040607442042,24.68194669865647,2064
21,8,5,21,9,11,75,1.316911948444095,25.326078873937664,2043
1,9,6,20,10,6,52,1.1451380045882416,26.032411338230236,2038
21,5,5,13,9,6,59,1.0821886677211254,25.54409573706137,2019
10,5,8,14,7,8,52,1.0262395322471627,25.550092714163178,2014
9,8,10,2,8,7,44,1.1181549767799916,25.70720334099389,2025
12,7,7,1,13,5,45,1.087460681488991,26.28122681727254,2031
6,13,7,16,8,6,56,1.1607769671121975,25.981070997291134,2046
5,16,11,15,12,8,67,1.3046352175816045,25.469831962697832,2039
10,16,8,14,10,7,65,1.369166650621007,24.750981756267873,2027
10,9,4,16,22,5,66,1.3500054586327983,24.825983524402282,2034
10,7,5,10,27,4,63,1.4279073887822658,24.581425929133264,2030
10,18,6,12,25,7,78,1.6409943195964976,24.174661477072227,2027
11,17,5,15,8,6,62,1.5511127445275212,24.711078016989795,2056
7,11,5,8,8,12,51,1.3144659459899555,26.029086209364102,2079
11,7,5,8,5,18,54,1.2597164964944907,26.241191519091608,2089
7,11,4,4,6,16,48,1.1760439499400661,26.489992618115412,2101
3,12,6,1,18,11,51,1.2087186097396114,26.91913017736206,2104
26,15,4,3,11,11,70,1.2401311790084402,26.92310052994546,2099
11,15,6,6,12,13,63,1.1003254319344475,27.54098006506802,2086
11,10,6,14,10,13,64,1.0643329870725127,27.159487306517725,2093
10,8,5,9,25,6,63,1.2386049568196087,26.76737034438479,2108
10,11,0,5,19,6,51,1.2751147431410064,27.095933366941722,2128
10,10,5,9,6,7,47,1.107073648471677,27.727941945442964,2157
13,6,8,4,9,4,44,1.0663830272418753,28.060771248009527,2163
9,20,9,4,11,2,55,1.0927521465750083,28.24483084815055,2172
8,21,9,5,22,2,67,1.1287392083809733,27.76630671799277,2164
25,21,7,4,23,4,84,1.0879622162969722,27.510236598066157,2148
16,17,5,8,8,10,64,0.9992348248324039,27.41800274668631,2125
2,20,6,0,6,8,42,0.9218347056588458,27.932465740137264,2130
4,14,5,0,13,9,45,0.915443826708119,27.90343367471652,2133
3,16,7,0,11,8,45,0.9082690158760801,27.894105523645102,2137
12,13,9,11,8,8,61,1.019513892920119,27.90838193262331,2154
6,8,8,14,8,9,53,0.9618419096721128,27.309404631056964,2139
6,11,10,14,12,10,63,1.0733450540720797,26.80863799543972,2129
9,9,9,15,14,9,65,1.2125081210235418,26.27298610390251,2111
4,15,5,15,13,7,59,1.1382051678651823,26.597402178864016,2104
3,17,4,14,10,5,53,1.2411619174875692,25.900896063165213,2094
4,19,7,14,8,5,57,1.324225085962791,25.131271696055066,2086
6,18,5,15,13,5,62,1.4412534799101444,24.248440269779618,2079
6,20,10,17,6,5,64,1.4675491235021283,24.306574433664395,2099
5,13,9,12,5,6,50,1.359205278350655,24.989267990626374,2119
5,8,10,9,7,7,46,1.306195893503541,25.579108748770164,2125
9,6,10,2,17,5,49,1.2776639679175161,25.884108211465172,2134
3,4,10,3,20,5,45,1.2030281614278826,26.90398956117653,2162
7,8,10,13,18,5,61,1.1671546711298655,27.91513540042591,2192
14,9,10,13,9,6,61,1.167336345762318,27.52310737586227,2206
6,8,10,14,9,6,53,1.0821918047574055,28.340840204087993,2212
8,3,8,11,2,5,37,1.057275145802727,28.50104779559641,2221
8,7,5,13,11,5,49,1.0021438364266684,28.83493798174984,2232
6,9,6,11,7,6,45,0.9427203980119017,29.30630082296584,2243
7,14,11,14,8,5,59,0.9847816813295741,29.218508229529856,2254
5,16,7,13,8,5,54,0.9402944076097036,29.8075120594107,2273
8,10,6,4,8,5,41,0.9623961062067353,29.812547393546325,2304
4,8,5,5,11,5,38,0.9456794145707189,30.272180066567714,2322
8,6,12,7,8,5,46,0.9120323881273064,30.225272691075116,2320
6,7,6,4,4,5,32,0.9347864221853718,30.70723247314087,2344
3,8,7,2,5,3,28,0.9579758330552417,30.70031989091485,2359
7,7,11,9,9,3,46,1.0034429545267864,30.289625600214094,2363
8,10,12,10,4,4,48,1.018147374278472,30.202949078570832,2381
24,9,6,7,8,3,57,1.1010237212370586,29.926095903875797,2385
17,19,8,3,7,6,60,1.1187359734123423,30.06584717514079,2389
7,28,5,7,16,3,66,1.2057536233548218,29.043991016726583,2387
2,27,5,6,17,7,64,1.2703901172090486,29.1215903158412,2377
5,29,5,7,1,12,59,1.14209996399,30.025093574992646,2381
7,15,5,7,7,9,50,0.9671970157286575,30.80275290915258,2385
6,18,5,6,12,6,53,0.9999333724690518,30.686961123600227,2380
8,11,14,7,16,7,63,1.0790982291911255,29.76091180096004,2386
9,10,18,7,13,7,64,1.028444247475296,29.635812524218608,2383
3,7,9,10,10,4,43,0.9993448973117464,30.156661645977707,2399
3,20,9,13,19,6,70,1.0673342106546861,30.313471657910156,2395
1,19,13,7,7,5,52,1.1057227744655498,29.953809767521108,2409
1,19,12,8,1,16,57,1.2141563503568307,29.84964790125389,2416
0,21,11,8,1,19,60,1.1793789141746494,29.733602371093898,2423
20,23,8,7,12,21,91,1.1111722178431032,29.460273179704554,2397
1,12,4,16,11,15,59,1.1171301865647967,29.826382468006994,2413
3,11,8,16,7,17,62,1.05326876435962,30.201399002254934,2400
6,9,6,14,3,13,51,1.044173409038728,30.177006598677465,2389
1,11,7,14,16,11,60,1.114759660164168,29.046835090892,2374
0,12,5,13,16,9,55,1.2242898021134925,28.854989739601322,2368
1,7,5,12,13,11,49,1.1921240223196015,28.402531651500638,2344
0,12,6,13,16,12,59,1.103988939762785,28.76630408231483,2342
1,12,6,9,12,9,49,0.9616118653317525,29.814241076851157,2354
4,29,5,9,4,6,57,1.0579746124163707,29.101130802746805,2356
1,25,16,7,4,9,62,1.145735686397989,28.788375767690646,2368
2,21,12,1,1,12,49,1.0900726691731562,29.1903089198367,2382
2,14,5,6,1,12,40,1.0903670834984005,29.236865934750426,2390
2,8,9,9,1,17,46,1.004898624261586,29.386594593892518,2391
7,13,6,15,16,15,72,1.0535117455577596,29.594382288443892,2392
0,9,8,13,20,12,62,1.04133364729389,29.371722825749877,2398
3,14,7,11,10,11,56,0.9673343615201772,29.792736843549868,2389
1,19,9,13,10,16,68,1.0876584777898954,29.61041271090278,2396
1,19,10,12,6,15,63,0.9804528922034902,31.2764986305782,2398
0,7,7,12,1,16,43,0.8421069349503906,32.37721121375014,2406
0,3,7,12,0,12,34,0.7875322745849725,33.39714078144514,2423
0,12,5,8,0,11,36,0.7110529366150005,33.975022920618954,2428
24,11,10,6,21,10,82,0.757335823963415,33.582629309159095,2407
28,11,15,6,18,11,89,0.7512821634107799,32.959304340623646,2373
19,6,15,8,11,4,63,0.7033159724671575,32.854346263989584,2361
8,10,15,3,6,3,45,0.693611160877081,32.9921730197061,2354
3,8,15,1,0,5,32,0.7675707714461186,32.21601906020886,2368
2,7,15,6,2,7,39,0.8225012815339059,33.05739970782081,2367
1,8,11,0,2,6,28,0.7618592132684687,32.87213321398837,2367
5,10,6,2,5,7,35,0.7652896296295838,32.86501034529256,2369
1,6,5,3,22,5,42,0.7963693417056795,32.959064398721154,2374
11,10,8,6,13,8,56,0.8479367574759156,32.566907526653644,2364
6,9,5,12,8,1,41,0.9359353162096052,32.2188439134239,2374
4,9,5,15,14,0,47,0.9602496953558257,32.46246488577727,2389
13,21,9,9,8,1,61,1.0116414659958959,31.75366966124551,2398
10,29,8,10,5,2,64,1.0938591666649686,31.319511589378713,2398
14,23,8,7,7,0,59,1.0930849019978173,31.73598044463988,2416
8,15,5,8,7,0,43,0.982986444305019,31.906101546410017,2450
9,4,7,7,4,3,34,0.9153055776125767,32.9154016399654,2477
5,4,5,6,6,5,31,0.7419127160751539,33.68417602103468,2485
6,8,1,11,1,4,31,0.6460584125960346,34.53415701791388,2504
7,5,5,5,1,5,28,0.5901000894483772,35.24778015664168,2514
3,8,6,6,14,4,41,0.6622795557950272,34.97657838203086,2529
25,4,5,6,13,4,57,0.6904602463946553,35.09360083150372,2514
15,3,5,7,13,2,45,0.677184170981852,34.6774074636421,2521
12,3,5,10,13,1,44,0.6881752641556851,34.75727746579383,2510
9,7,6,13,18,2,55,0.7886044956455326,34.317301908234406,2513
11,17,5,14,19,0,66,0.8424145923714886,33.82554176111882,2509
14,15,5,11,6,2,53,0.9184989248261539,33.905219234988216,2528
12,14,5,8,7,10,56,0.8502841233254449,33.925182940503134,2523
7,13,5,8,7,12,52,0.8306381774304974,33.92268140370491,2526
7,16,5,11,4,11,54,0.7021721514320853,34.88274547065853,2518
14,12,5,5,2,14,52,0.6387143922011057,35.15331682600376,2518
8,13,6,9,7,10,53,0.5291367289154548,35.23135242663306,2502
5,12,0,14,5,10,46,0.4542386981577614,35.660388584541664,2495
4,10,5,15,1,8,43,0.5445563087169526,35.17739935204468,2484
1,7,5,15,2,9,39,0.6474800300840766,34.69139449050644,2480
24,10,5,14,0,9,62,0.714363516977845,33.749291048929315,2448
11,7,7,14,23,9,71,0.8805516639838095,32.47214506852473,2429
28,7,9,14,26,6,90,1.019931307280912,31.155930993167217,2395
27,20,10,13,19,3,92,1.0634418398022325,31.026231475554486,2362
18,16,10,11,12,8,75,1.1563092717722254,29.77170265217468,2332
8,18,12,9,7,6,60,1.1593255385262573,29.649321929198067,2314
5,7,10,11,22,7,62,1.1867501026739748,28.794295278129542,2300
7,9,7,10,22,5,60,1.2048644971744948,28.58725961529327,2296
6,8,6,9,2,4,35,1.2232739681213767,28.432410896700407,2289
6,8,6,9,3,5,37,1.246945747941729,28.40865263870783,2297
12,10,5,7,17,11,62,1.2892385243833249,27.725577317255063,2276
7,6,8,8,14,15,58,1.169321338292216,28.052970604655407,2253
4,13,6,7,10,13,53,1.0780370201251799,28.580289408319118,2245
7,9,6,7,5,10,44,1.0505552248054997,28.392592528792665,2240
6,7,10,11,10,2,46,1.1326601620589722,28.400289807853788,2246
3,7,5,12,14,4,45,1.1071944076025444,28.83828303689264,2255
12,14,11,11,10,6,64,1.132333486301658,29.01400514182727,2265
4,17,10,9,32,7,79,1.272455295022953,28.85587933695761,2281
7,13,12,9,26,9,76,1.1654243208247765,29.55780995495708,2289
5,7,12,6,3,11,44,1.0693802107857238,30.14241245889871,2301
4,11,5,6,1,9,36,0.9820916716877909,30.390455189517382,2307
23,11,11,3,6,11,65,1.074351112284748,29.336561074625322,2291
11,12,10,14,6,14,67,1.1309074139287685,28.39044427391472,2269
3,13,10,17,6,12,61,1.272813292624417,28.220390890819967,2295
11,13,10,16,7,3,60,1.4404981118731595,27.64977218430763,2330
12,19,11,9,15,9,75,1.4431960554689682,28.040095912301947,2349
12,15,10,6,13,5,61,1.4611239529155624,28.301656692742196,2370
12,9,11,5,16,7,60,1.4884089554387712,28.643428723162668,2397
14,7,10,5,14,8,58,1.44220635780442,29.396981046417462,2432
9,7,5,6,16,9,52,1.3634791214418114,30.686707639232957,2443
4,12,6,6,6,10,44,1.1980737820686347,31.260128112225438,2450
14,23,12,7,8,8,72,1.189987335167847,31.32478495181523,2458
9,25,9,6,7,2,58,1.1171034769622632,31.94479011751244,2463
8,28,11,8,7,12,74,1.0538496390756202,32.241377898537,2467
3,31,10,6,7,5,62,0.9293241438834813,33.197871352104166,2485
1,13,6,7,1,11,39,0.7826538220166336,34.453446634512325,2492
6,9,7,8,33,11,74,0.9326358294775708,33.80351971795635,2511
8,7,6,6,27,9,63,0.948057397815543,34.075336960732734,2510
12,8,9,7,14,9,59,0.853398526135921,34.71459326082094,2523
6,23,10,7,9,5,60,0.9011861334983928,34.288427516247715,2511
8,20,12,10,8,12,70,1.0255252693767163,34.1776948671643,2526
6,21,14,8,11,13,73,1.0941473391435481,33.692860636380196,2522
6,22,13,7,11,15,74,1.1273575480110138,33.62062742982288,2519
5,25,11,7,4,9,61,1.045298971276261,33.95774256277048,2517
6,21,11,17,9,8,72,1.06608242579537,33.48740182650676,2511
28,10,10,20,8,6,82,1.0492149024644282,32.37903066682122,2471
31,10,15,14,8,8,86,0.9891483798078682,32.00049024468105,2438
5,9,15,16,9,9,63,0.9694728124710142,31.683252393782457,2413
3,6,15,20,15,6,65,0.9601239876097339,31.722890782883784,2410
0,11,15,17,1,7,51,1.0113552285063614,31.96443678316392,2385
5,9,11,14,0,8,47,0.9195719227596308,31.966099812806487,2381
5,6,10,11,0,6,38,0.8253608152852845,32.28123095149947,2383
6,13,10,13,1,11,54,0.8224615721538989,32.462958045463715,2378
5,17,10,8,19,6,65,0.7974034043194763,32.374038784738744,2361
14,19,10,12,15,5,75,0.6997905299711139,32.36578396492843,2338
10,7,9,5,7,7,45,0.6619765478096578,32.53111123784063,2326
1,9,5,8,8,7,38,0.5946430537076405,32.886212420208274,2321
6,18,5,16,17,7,69,0.7152498350301177,32.169558533142734,2319
8,9,7,17,18,6,65,0.8108529131640602,31.710783916337952,2309
5,6,10,15,9,6,51,0.8803160580511146,31.386549651700527,2296
1,5,11,13,6,6,42,1.003951782662117,30.996032705894596,2305
6,7,9,12,7,7,48,1.0721262580416637,31.296698948136733,2322
8,15,5,13,9,6,56,1.0426963898267985,31.124374057215196,2331
2,13,5,5,11,4,40,0.9850063382232488,31.446481622819107,2346
2,12,7,11,14,5,51,1.0592528337709035,31.164768591793067,2359
4,13,11,8,14,12,62,1.213749380675616,30.695073869166208,2373
11,6,13,7,14,6,57,1.2056180554217424,30.49977048364133,2375
6,2,8,5,13,3,37,1.1732020503079852,30.413092513727236,2385
12,2,5,6,24,3,52,1.1798805839598807,30.727876378665393,2415
12,3,6,7,24,8,60,1.164620081756218,31.51998064434209,2421
12,4,5,5,6,9,41,1.0649804628493729,32.086409318246474,2438
9,0,6,2,8,7,32,1.0089575493253478,31.70013082094985,2461
14,1,5,0,7,8,35,0.7989794148123928,32.75202709002107,2469
13,2,5,13,10,7,50,0.8133747860151106,33.12744256037995,2493
8,18,1,6,10,2,45,0.7730877698533298,33.84268396127928,2506
5,21,9,7,11,0,53,0.8187953667067294,33.61960164061649,2520
8,18,6,2,14,0,48,0.9374302348189499,32.728589973135044,2527
6,19,9,9,12,2,57,0.9757359298354336,32.511611980735545,2519
6,3,5,12,2,6,34,0.906342088208759,33.7653365145051,2538
6,6,5,14,2,6,39,0.8859964334455656,33.182890965059265,2543
6,1,5,14,1,7,34,0.8603681533546169,33.26292093577315,2542
9,6,5,12,1,5,38,0.8340331182782262,33.120224058287185,2528
12,7,6,16,5,9,55,0.9424540765693751,32.74758786407372,2530
7,6,5,10,4,10,42,0.9309665798454287,32.60410875937271,2526
6,5,6,8,1,5,31,0.9221883795273511,31.97257898364903,2536
8,11,5,4,11,4,43,1.0971647221473604,31.698715241932476,2567
1,16,6,10,10,1,44,1.1612245960567298,31.120705777263048,2561
19,14,12,7,8,4,64,1.2567587682760317,30.717306867848368,2552
12,10,11,6,7,4,50,1.2431481059906426,31.161127343201265,2551
10,23,8,5,21,3,70,1.3452842065486386,29.797329281340467,2540
15,23,5,7,20,2,72,1.3184989798814626,30.005105266957955,2532
11,25,4,7,11,7,65,1.236317690364891,30.133999994898538,2518
3,18,6,9,6,8,50,1.1752857861529764,30.675101981861594,2526
5,10,7,6,11,8,47,1.1754992101665682,30.379506005629157,2541
8,12,12,7,6,5,50,1.126083715571816,31.217187897896125,2551
4,12,13,9,9,6,53,1.0206293662279071,32.661724023734514,2574
11,10,12,10,7,5,55,1.044452054614158,32.012388826733435,2572
2,9,12,7,16,6,52,0.9325037698079992,33.02147337115522,2569
2,8,10,6,0,5,31,0.9024686147379921,33.882091877859786,2581
1,8,5,5,2,6,27,0.9504145532256116,33.80950651418609,2586
1,1,1,10,0,5,18,0.96288863039545,34.816912551932504,2613
19,3,2,6,9,7,46,0.9015576528728112,35.47037571663772,2632
5,3,1,3,6,6,24,0.7720175820360332,35.170030930520994,2639
6,2,7,3,6,5,29,0.6946433770157278,36.05438033410908,2656
5,1,6,5,8,7,32,0.6862013412972512,36.65085908311769,2670
7,1,6,6,15,5,40,0.58955795803974,37.203692187589326,2660
0,1,5,5,13,4,28,0.5354827389399945,37.5290069803375,2673
0,25,5,12,11,5,58,0.6735346285530813,36.73645825559526,2669
5,27,5,8,11,1,57,0.7275620634934331,36.67733302559152,2658
1,27,8,0,1,9,46,0.7426831444174454,35.895577452746764,2646
0,23,15,8,11,7,64,0.8319268036886691,35.18531567069204,2636
1,14,12,14,2,5,48,0.82605492693165,35.09363133357223,2637
1,9,12,6,0,5,33,0.8500154035526881,34.570694862336964,2650
2,22,6,6,1,6,43,0.8634852928302249,34.83166550622696,2660
1,18,5,6,14,6,50,1.0091118301514033,35.095172872653,2692
15,15,9,10,14,5,68,0.9620151162231056,34.71996157088436,2685
0,20,12,5,12,6,55,0.8977296955905691,34.84298734278035,2690
0,22,10,5,9,15,61,0.8960538104178168,35.447205819797034,2691
0,15,5,17,1,16,54,0.8257615800914331,35.8494842716754,2695
0,14,9,10,0,19,52,0.9131344481917769,36.31072301193749,2708
0,12,5,4,0,19,40,0.869230097205608,36.47291376953984,2708
0,8,8,8,0,18,42,0.8553037224531008,36.67710573161872,2715
22,9,12,9,16,19,87,0.9921495285137683,35.40352195142463,2677
16,9,14,10,19,17,85,1.004404313545041,35.11944506760399,2655
15,14,15,5,19,11,79,0.9907880697952615,35.177645805412304,2643
10,10,16,6,18,11,71,0.9406209298873514,35.747001246321986,2629
3,21,16,7,1,14,62,0.9061150108861747,35.90745708175328,2622
5,23,15,12,2,15,72,0.8717827846156004,35.99445133886756,2621
0,17,14,11,2,19,63,0.9007946404440382,35.89448015758559,2625
8,20,12,7,2,13,62,0.8163406803682864,36.524016095779025,2614
1,11,6,5,19,20,62,0.8097644203167462,36.66154053267989,2613
13,14,3,6,15,19,70,0.7434709975454061,37.09840198030035,2602
9,11,8,13,9,16,66,0.6610991994092354,38.04759716067247,2608
1,8,5,6,10,5,35,0.7236496964868692,37.124213505780574,2621
5,10,6,17,3,7,48,0.7653303719640895,36.624652968808626,2632
5,7,6,7,2,8,35,0.7163792752805074,38.23843127216984,2645
12,7,3,6,2,4,34,0.6606357340566614,37.2346815173596,2640
12,7,5,5,5,0,34,0.6013872025864825,38.48254909167297,2655
9,9,3,5,7,1,34,0.538446744420354,38.46246066550958,2667
8,7,6,5,3,0,29,0.5257187833997826,39.54760429246695,2677
6,1,5,0,3,0,15,0.45968717053666985,40.1109484058591,2685
7,1,5,0,0,2,15,0.49649849809570373,40.50634456039689,2709
3,4,5,0,1,5,18,0.4464806534099571,41.038416444357416,2731
12,26,6,2,2,4,52,0.4831595525090058,40.86190753105099,2739
5,26,5,0,13,3,52,0.5625077349439519,39.953783660848295,2748
10,30,5,0,15,5,65,0.7363122104135115,38.178380058255115,2731
17,24,5,0,25,2,73,0.7848535363490866,38.57510244438812,2726
27,17,5,4,10,6,69,0.7279036025638931,38.280782753039276,2710
12,17,5,6,21,4,65,0.7342569577738571,38.84663465828485,2707
11,12,5,7,18,0,53,0.7109137755386872,38.697027533590365,2704
14,9,5,7,6,0,41,0.723156524122086,38.49175649099597,2709
11,9,6,8,6,0,40,0.722153839672296,38.20539484758806,2711
10,8,1,6,6,6,37,0.6729804678670223,38.01278646197397,2702
13,9,8,6,3,6,45,0.6431163195035345,38.35056329072415,2696
10,9,11,7,8,6,51,0.6654496586749313,38.33566151489402,2689
14,7,10,6,9,7,53,0.6919373448010785,37.99410159992368,2696
2,24,10,6,8,6,56,0.6891429890509366,38.01412245259728,2691
4,22,10,4,20,7,67,0.8384066648629102,37.68045953538893,2693
6,14,5,4,13,13,55,0.8872767957909596,37.275710005828635,2690
39,19,6,6,6,16,92,0.9044818739910405,36.771877032843165,2657
13,18,5,3,9,10,58,0.8276688681826426,36.63489015978524,2645
8,17,6,0,16,13,60,0.9183688672253282,35.83860383522183,2629
10,14,8,0,18,6,56,0.950340566632602,35.50273714386579,2613
9,11,11,0,17,5,53,0.9317325182893571,35.49403819743776,2605
5,4,12,4,7,7,39,0.9439286524928141,35.700153047299004,2605
7,12,11,7,7,8,52,0.9376283423240676,35.782951766748845,2604
5,23,4,8,8,8,56,1.006526414398479,35.46025064953061,2583
3,16,9,8,8,8,52,0.9954666680197345,33.59457610922258,2581
0,6,7,7,2,11,33,1.0128072482999162,33.50786341889685,2567
1,11,7,8,11,10,48,1.0422052407995024,32.85900279435263,2566
3,13,9,7,6,8,46,0.9848307908417481,32.79972584019092,2555
7,11,12,7,6,9,52,0.955919489567277,33.01538725697477,2555
7,10,10,8,6,6,47,0.9122147672460018,33.457404561462944,2545
6,8,11,7,23,8,63,0.8884767119399559,33.698915465653116,2559
3,8,10,7,22,6,56,0.9610793135510097,33.58179052479741,2559
6,6,10,8,13,7,50,0.9463811017289301,33.81633541517245,2566
5,9,10,8,2,5,39,0.9129075760938401,33.82096313691802,2574
5,5,11,7,6,12,46,0.8819604137955914,33.968582803080494,2575
6,8,10,4,4,9,41,0.7956373951382254,33.88439740872216,2574
5,18,10,0,3,12,48,0.9333184065253851,33.497389490492154,2584
7,19,10,0,3,14,53,0.9265815658442176,32.74573899410953,2582
6,19,10,6,4,15,60,0.8920969351876497,33.591650902736674,2603
7,16,10,5,1,5,44,0.9468963078605915,34.075579817244,2628
6,16,7,7,15,9,60,0.8945820201533793,34.798671083208454,2635
12,18,13,6,6,9,64,1.0236486280496466,33.634677189975996,2643
13,12,15,11,8,6,65,0.9468308584333947,33.92889656361779,2651
16,10,13,8,9,6,62,0.9810025099698269,33.90670328301035,2641
6,9,11,9,13,8,56,1.053193406076943,34.49233391068993,2648
7,9,7,7,7,8,45,1.0366871960799569,34.515450239298815,2649
15,9,8,5,29,12,78,1.0688526380506067,34.809187773331054,2644
16,9,9,7,28,9,78,1.0578935734967836,34.12374100708317,2630
14,10,10,6,25,8,73,1.0509252554710677,34.60441727219918,2639
11,20,10,9,13,8,71,1.0410159224910485,34.439568597109556,2629
7,17,6,5,9,8,52,0.9408199328704786,35.16592395201371,2632
5,6,8,7,9,15,50,0.9139013958457329,35.44599213280376,2636
4,11,7,6,9,12,49,0.6336051031261618,36.672024151203736,2625
3,9,11,6,3,8,40,0.5484959796342196,37.294528770415255,2645
22,8,9,5,18,9,71,0.601433103960057,36.23475514585975,2629
30,10,15,12,17,12,96,0.6490506377092187,35.55661084879748,2589
21,17,16,8,8,8,78,0.6526014381454502,35.337596438963935,2576
4,9,15,5,7,6,46,0.6962650744892086,35.240243141518945,2562
3,2,10,5,1,5,26,0.7182673156712741,35.016716325835084,2564
0,8,10,6,0,7,31,0.8334884869847826,34.39496570342555,2561
1,11,10,2,0,5,29,0.8568482072722985,34.41972662817495,2577
5,7,11,15,0,8,46,0.872715244103838,34.167101510145564,2580
0,16,11,15,18,6,66,1.0201030036767291,33.33358769848878,2581
14,18,11,13,18,6,80,1.072868725552322,33.38191050831214,2562
11,11,9,9,11,6,57,1.002673025922854,33.604430141159824,2557
5,8,5,7,16,6,47,0.8974802887062883,34.18896920962865,2550
8,8,5,16,15,7,59,0.9063831993677263,33.81971192836592,2542
9,10,8,15,18,6,66,0.8805292549702128,33.99367154603167,2531
13,10,11,1,8,6,49,0.8575811961244397,33.67196219747875,2539
8,17,7,4,10,5,51,0.9246945982033136,33.76710688476675,2553
9,10,10,8,6,6,49,0.9791836627603893,33.855109579448296,2551
11,11,6,10,7,5,50,0.8485755734105421,34.5302943463895,2567
4,10,6,8,8,7,43,0.8098948550254197,35.26080401719764,2595
17,9,12,8,1,10,57,0.7026503420247642,35.82507360594024,2578
2,1,8,6,9,9,35,0.6444921819007291,36.08078593739755,2579
5,2,8,2,9,3,29,0.680760333025896,36.13099078482936,2590
3,1,3,1,14,6,28,0.6535924624896515,36.170093334308454,2604
4,4,9,0,9,8,34,0.6501117051567099,36.65507725090424,2623
8,2,9,0,14,8,41,0.719471609725613,36.25047529014046,2622
8,2,5,0,21,9,45,0.8119017751562809,35.971706804872376,2637
6,0,5,0,26,8,45,0.8213514283020128,36.062726348447846,2640
4,17,6,6,12,4,49,0.808453099698974,36.271064681550854,2647
6,23,5,5,5,0,44,0.7567415614665741,36.39362398657381,2657
5,24,5,5,11,7,57,1.0418357775340181,33.69309466067795,2655
8,19,6,6,7,9,55,1.0096041583846458,33.504191000608266,2675
14,20,9,10,11,8,72,1.0617427452804247,33.81187068080581,2677
11,17,6,14,3,6,57,1.0036941791675347,34.10116709764714,2692
11,15,3,13,18,8,68,0.9912741474524182,34.979394843828736,2686
8,11,0,7,6,6,38,0.9529541317556407,35.56790808890422,2691
22,9,0,6,5,7,49,0.902049063131358,36.34895287510521,2697
10,6,1,5,14,5,41,0.8418117201148697,36.21170112313421,2702
10,9,5,6,6,5,41,0.8596382822679095,36.57077882224583,2701
17,8,5,2,9,5,46,0.8777160038978258,36.33811822567869,2703
16,9,7,7,9,6,54,0.8476415528459597,37.20246794745988,2695
10,16,10,4,7,5,52,0.871174767349751,37.311877835366126,2694
12,18,11,5,3,6,55,0.8853939177821879,37.44467873392558,2698
8,19,4,4,16,5,56,0.9678013374908879,37.31750245984612,2710
6,15,6,5,17,7,56,0.9576761076234239,37.567642316072636,2715
6,14,5,13,11,7,56,0.9062514297708384,37.616120106818514,2724
7,7,6,14,9,6,49,0.9052233634283031,37.16811691600251,2723
5,6,5,13,8,5,42,0.885032153682604,37.83067730730462,2740
5,5,5,14,5,7,41,0.8349256181215386,38.122428729847385,2744
3,7,5,15,9,5,44,0.8124857523345864,38.21090373618933,2749
11,4,5,13,7,7,47,0.8106023669541003,38.430294040098865,2770
3,8,6,10,6,5,38,0.7335163837789149,39.29540580944522,2800
4,15,6,6,6,6,43,0.6711895608001803,40.23835463457402,2813
2,8,7,4,16,6,43,0.7529659635747123,40.34050189746021,2839
0,9,6,5,6,6,32,0.6248007740441167,40.909742467916814,2853
0,9,5,4,0,6,24,0.5628279493976189,41.28344909202038,2868
1,11,7,2,0,5,26,0.5355707379244206,41.57949067184121,2886
0,6,6,7,10,7,36,0.6525854291780707,40.87202897170834,2895
1,9,8,9,12,4,43,0.8266233759325485,38.49541159725815,2901
1,7,9,15,6,6,44,0.7843615965121822,38.542374302104584,2912
0,9,11,14,6,3,43,0.7597142550473751,39.936910197327244,2927
0,7,7,16,1,3,34,0.6277949035415595,41.30966890449775,2964
0,25,6,6,0,3,40,0.5731502243605804,42.07161331356973,2978
0,28,7,6,0,5,46,0.6164548923358323,41.98520121903415,2983
11,27,9,7,0,8,62,0.6149087738067359,41.97985673816893,2980
0,19,7,6,10,10,52,0.5397464756530984,42.165029774640374,2976
1,10,6,8,9,9,43,0.5340867135388319,42.76149359105728,3007
4,12,7,6,2,7,38,0.4985805565332242,43.20060162065441,3016
3,9,2,16,1,6,37,0.4287002093308974,43.2659701318655,3017
0,20,5,20,15,4,64,0.5367905195145826,42.40826332933108,2996
0,18,5,14,19,5,61,0.5649227099622846,42.097732630069906,2979
0,15,5,15,14,5,54,0.5507201937808837,42.78916291315812,2960
0,11,5,14,6,19,55,0.6731846471519289,42.02456202511765,2950
0,9,5,14,7,18,53,0.6247165866022344,43.206983328263114,2936
0,8,5,15,0,16,44,0.6116059741324771,41.3951974982701,2928
0,7,12,7,0,18,44,0.6511965785100275,40.01794980639339,2913
2,10,7,1,0,18,38,0.6449287202131029,40.08124852231057,2906
0,9,6,2,1,18,36,0.6524495804874378,39.89151339870527,2898
7,9,1,14,13,9,53,0.7227592120366158,39.626523242780756,2890
3,9,0,2,18,12,44,0.7790208906706343,38.89653803043387,2891
1,11,0,2,13,14,41,0.8158584837845134,38.412290741573486,2898
0,11,0,0,8,19,38,0.7257576382465458,39.344973321406535,2900
0,19,0,8,3,14,44,0.7995425963234999,38.50228073572531,2913
0,20,0,5,0,13,38,0.799714657331274,39.97592555897385,2927
0,18,0,14,0,11,43,0.6867165833852044,41.51243265483322,2944
0,13,0,12,4,18,47,0.6703541350452555,42.51836591483878,2970
23,16,0,8,12,21,80,0.6711823651226269,42.134357703171254,2962
23,13,0,5,12,19,72,0.5936902902861528,42.58266776605244,2943
0,14,11,9,7,13,54,0.5381619870396599,42.10628089031935,2931
2,12,10,8,7,8,47,0.4796269878820318,42.42871543238205,2929
0,15,10,9,0,7,41,0.4260585010524329,43.10252424258815,2924
0,8,8,12,5,7,40,0.4711857504740548,42.800764327479094,2928
1,6,6,16,0,7,36,0.5313609827801126,41.92690053102375,2924
4,13,5,7,0,7,36,0.5637662592849967,42.20172586384539,2929
7,9,2,6,0,8,32,0.5622242122133481,42.17040742445918,2937
7,11,1,6,19,5,49,0.5253760833770461,42.41936467925734,2958
17,8,2,5,19,3,54,0.5266818271564898,42.56753602254819,2964
12,20,2,6,15,0,55,0.5233702378983517,42.6669269433695,2958
12,25,0,5,17,1,60,0.5977134488572663,42.02991710595477,2946
7,29,0,5,15,6,62,0.6061509561021735,41.87779620297849,2935
5,23,0,7,2,7,44,0.5784134463224848,42.2333602455091,2948
6,13,6,8,0,8,41,0.5227831154095032,42.618976317323934,2956
6,10,1,7,1,7,32,0.511260401531726,42.92943187269579,2965
6,9,0,7,3,12,37,0.5042022034250904,43.07602987039308,2965
3,13,0,6,2,11,35,0.4474700170438632,42.99559346266926,2969
2,10,6,8,24,3,53,0.47219504834199333,42.68982042866128,2957
18,14,5,8,22,5,72,0.5319217951645123,42.333546582470554,2945
19,18,5,7,20,7,76,0.5523094562664539,42.299245839852844,2919
18,22,5,7,8,7,67,0.48762927504657033,42.36701569793849,2898
0,21,5,6,4,6,42,0.4730262730104949,41.851825552767735,2899
0,11,5,6,1,5,28,0.43225492402412385,41.84722613606342,2890
1,6,5,7,0,6,25,0.43361654330478605,41.81593069885839,2887
0,6,5,9,0,5,25,0.4357190712106483,41.88594210657177,2891
2,9,5,7,12,7,42,0.44751384075863165,41.80206510747575,2874
8,4,5,7,12,6,42,0.4231299161509817,41.61873549629252,2856
5,8,5,8,11,4,41,0.41836540484883894,41.32857823796291,2840
4,6,5,5,9,6,35,0.4204643087165215,40.84280333433317,2828
0,4,5,7,0,6,22,0.4610319189932699,40.9436957714026,2838
5,7,0,8,0,7,27,0.4508805758465162,41.14262379086394,2838
4,18,3,7,4,6,42,0.5228123113414695,40.513369775478566,2838
13,15,0,6,4,6,44,0.615048942439419,40.302664825195606,2842
9,11,0,8,11,5,44,0.7624968582003034,39.04519327822182,2863
11,11,0,6,10,5,43,0.7452007600057903,39.749179678924946,2868
11,8,0,5,6,7,37,0.7295935774881734,39.40574355477362,2872
6,12,0,6,9,11,44,0.6623434626014901,39.567960364497985,2865
9,14,0,6,12,12,53,0.6155797991110696,39.70845854611341,2847
7,12,0,7,21,9,56,0.6839656394696139,39.090085272298474,2837
5,11,0,7,16,2,41,0.6998736807067246,38.98458326708773,2845
4,13,0,7,5,7,36,0.7040095500141776,39.25990067097864,2858
4,11,0,3,7,4,29,0.6642239564418119,40.21178889827909,2862
0,5,0,2,5,12,24,0.5263444339531429,40.86036691558026,2873
5,7,0,0,15,16,43,0.48219251305446004,41.66251847289476,2867
10,14,0,0,7,10,41,0.44522302168202865,41.69770285213776,2869
0,14,0,5,10,4,33,0.38826828083820825,42.24994567577685,2862
5,7,0,6,15,7,40,0.4051682150756458,42.37240006943873,2861
0,9,0,7,2,5,23,0.30967717879086676,43.07190971835721,2856
0,3,5,7,1,5,21,0.30459178486883415,42.98662233041366,2858
0,4,1,5,1,5,16,0.27598104761600945,43.1363213935989,2865
0,8,0,5,0,7,20,0.2790942588580876,43.45319417944006,2875
6,6,0,4,14,6,36,0.310352249942885,43.577926102434205,2873
9,5,5,2,7,6,34,0.31561115608457435,42.99302396994176,2867
1,15,5,2,6,5,34,0.36435581872923,42.34684332970789,2858
0,12,5,1,8,5,31,0.40434122927787264,42.10080310648341,2847
0,9,5,1,0,7,22,0.4272009409387113,41.92559762732595,2854
0,11,5,3,0,6,25,0.41141918837267416,42.48331025907925,2863
0,8,5,4,0,5,22,0.3604966889310899,42.62890543266484,2863
0,8,5,3,0,5,21,0.3802944515899645,42.612853842644846,2861
0,9,5,0,18,4,36,0.4316870428964552,42.61556235960046,2867
12,6,0,0,6,6,30,0.39795222939249514,42.70315042427378,2865
0,7,0,0,9,6,22,0.3946407738743572,42.2838247368489,2872
1,22,0,6,8,5,42,0.41745532834862903,41.979679915350964,2857
0,15,0,6,0,7,28,0.4863279500343237,41.913202233028066,2862
0,10,5,8,0,6,29,0.504996185078462,41.759351538400395,2866
0,3,1,7,0,6,17,0.4615557792261968,42.15412642026973,2871
0,6,1,7,0,6,20,0.454443067339563,42.12982451122067,2882
1,11,0,6,13,4,35,0.4327030743692869,42.34453069603376,2869
8,5,0,7,9,6,35,0.40943504641968226,42.60288561921199,2870
3,6,0,6,8,6,29,0.34856447887951697,42.68820164788587,2867
2,5,0,5,2,6,20,0.33639915752543426,42.79263770522681,2869
1,7,0,4,11,5,28,0.37943326361443513,42.27892340346315,2871
0,8,0,2,12,4,26,0.39445678823419217,42.26577312403386,2878
0,6,0,0,10,6,22,0.3817072434070991,42.665061331073154,2899
3,3,0,0,9,8,23,0.38034213043281495,43.60779013776916,2908
0,13,0,0,0,4,17,0.3933110748924226,43.31389607893342,2922
0,16,0,5,0,7,28,0.39337543430514216,43.78216861010788,2930
0,14,5,1,0,3,23,0.39418029011984834,43.88377348416807,2931
0,7,5,3,0,5,20,0.37492867823465265,43.88588665997093,2939
0,6,5,5,3,7,26,0.39262970284167614,43.93274310492687,2942
0,12,5,6,0,7,30,0.3861373659425662,43.87464862733735,2938
0,7,5,4,0,5,21,0.39763013393105345,43.564860873448914,2939
0,13,5,5,5,9,37,0.4139408223944506,43.42651869460519,2939
1,18,5,7,0,6,37,0.4221551120446247,43.055234799354224,2927
0,10,5,6,0,8,29,0.40591357314475995,43.30225942349095,2924
0,5,5,5,0,6,21,0.3914067479016595,43.4949326996394,2931
0,8,0,4,0,7,19,0.382026012741303,43.670420438627986,2948
0,2,0,6,13,10,31,0.45814037611272224,43.16171881409335,2949
5,5,0,5,14,10,39,0.3817445210694742,43.15190951959834,2944
4,11,0,1,15,1,32,0.3997140372305076,42.986195219641516,2944
3,4,0,0,14,0,21,0.4869343145364521,42.10253968756037,2956
0,2,0,0,0,0,2,0.5206705284112767,42.813257299195875,2994
0,1,0,0,0,0,1,0.4809166812998093,43.922862705575525,3025
0,4,0,6,0,0,10,0.46237578312897054,43.70227373990134,3041
0,3,0,6,0,1,10,0.42088426403930373,44.71426936543959,3056
0,7,0,0,9,1,17,0.4678980707687379,44.70965199812864,3068
0,6,0,0,5,2,13,0.4715926536926816,44.72439096495698,3092
0,6,5,4,6,6,27,0.512185445082214,45.05970728940021,3092
1,9,5,3,6,8,32,0.5060255552227276,44.474978503098455,3093
0,13,5,4,0,9,31,0.5202653829093443,44.65189357530864,3084
1,10,5,4,0,8,28,0.5087297194037794,44.897687381083145,3085
0,11,5,4,0,7,27,0.4616690271279259,45.1748101583259,3081
18,16,5,6,0,4,49,0.5391518679694485,44.589347665388104,3066
0,13,0,4,8,8,33,0.50775206865502,44.53448184031939,3072
0,7,0,7,8,8,30,0.5054484819634548,44.927812570044765,3080
1,7,0,4,6,6,24,0.48515564382775855,44.69212865114117,3077
3,9,0,0,4,3,19,0.5212161577590699,43.804030185161125,3100
0,5,5,0,0,7,17,0.47431253012804747,44.39076758459146,3099
0,7,5,0,0,3,15,0.3823878019964858,44.97879871983127,3109
0,7,5,0,0,5,17,0.37907404006293016,46.64134743454373,3125
1,9,3,5,0,6,24,0.32184175950063243,46.63361589461461,3127
0,5,0,7,7,4,23,0.31256304084290915,47.932021689382886,3135
1,4,0,6,8,6,25,0.3510056093126182,47.096219768686325,3135
0,8,0,3,6,5,22,0.3195032060587813,46.28346207303974,3142
0,6,0,0,7,7,20,0.3413637030046566,47.413316108654826,3162
1,8,5,0,0,5,19,0.30121663703225865,48.07958910055686,3176
9,12,5,0,0,5,31,0.31573295896704495,48.52287042662414,3180
0,10,5,0,0,6,21,0.3077337045982046,48.38714704249978,3192
1,9,2,5,0,9,26,0.3475909971020295,47.88079780681809,3209
0,10,0,8,9,4,31,0.35729939636774555,47.28059658566945,3215
0,14,0,7,5,6,32,0.41543072898432537,46.98538660200688,3215
0,8,0,6,9,5,28,0.41089377535791166,46.8420991460092,3209
0,6,0,5,6,8,25,0.42856112860601453,46.67157917723145,3214
0,9,5,6,0,5,25,0.4742461500690573,46.18377082522528,3199
0,7,5,4,0,5,21,0.46152171520730456,46.16714005341903,3201
0,7,5,2,0,8,22,0.4073680254657198,47.06304344389379,3204
0,6,0,2,0,6,14,0.41139120509060545,46.891585806873415,3219
0,5,0,1,8,6,20,0.38866653554301356,47.08085579184107,3217
0,7,0,0,10,6,23,0.40445389750948396,47.51703009182497,3237
0,10,0,0,7,6,23,0.40458497070824323,47.55346156114912,3235
14,8,0,0,6,6,34,0.3526391772900147,47.72232202712708,3230
1,5,5,0,0,6,17,0.3088967242372444,48.41489870144477,3234
0,8,5,3,0,5,21,0.3022155111502121,48.87581247506065,3240
0,12,5,2,0,6,25,0.31197007243792935,48.76212315138963,3243
0,6,5,1,0,3,15,0.3121090924593869,49.163875431271826,3255
0,3,0,0,7,1,11,0.31610523463815055,48.554924562232365,3264
0,2,0,2,6,1,11,0.33181899229066747,48.73122019680514,3278
0,8,0,7,7,0,22,0.35354676525557155,48.47880521588395,3293
0,4,0,1,5,0,10,0.32683793254159993,49.35555446252572,3318
0,2,5,2,0,4,13,0.28794105553346266,49.751792152224446,3317
0,7,5,0,0,3,15,0.3289225760120084,49.45951839963372,3320
0,6,5,0,0,1,12,0.2786967517997719,50.48649842830718,3323
0,8,5,0,0,1,14,0.3178936895405396,50.23292016519657,3329
0,7,0,0,8,0,15,0.33663267031604754,50.114243860699126,3336
8,3,0,6,4,1,22,0.38309061762993074,49.512337673984526,3335
2,5,0,3,5,0,15,0.33641741234203937,49.931097618554915,3338
2,3,0,2,6,0,13,0.29769073812168334,50.51526888010003,3338
0,5,5,2,0,0,12,0.2555727866761813,50.41559878428027,3345
0,3,5,1,0,0,9,0.2598205904162098,50.89832406324923,3358
0,2,5,2,0,0,9,0.23707438051707047,50.798617746537275,3364
0,0,2,2,0,0,4,0.23469591250679134,51.45576463335862,3375
0,1,0,2,6,3,12,0.20704030628296585,51.251564168536696,3376
1,4,0,0,4,3,12,0.1921697214313091,51.745235242386414,3381
1,8,0,0,6,4,19,0.2007900710384836,52.161253477594926,3393
0,6,0,0,5,4,15,0.19780056738657203,52.27654229713947,3394
0,8,5,0,0,4,17,0.18927868155344305,53.11888704848797,3395
1,7,5,5,0,4,22,0.18209375745577142,53.07540420955492,3389
0,7,1,7,0,7,22,0.17594812785796093,53.21752200565599,3389
9,9,0,4,0,7,29,0.17570418846449795,53.56624004452769,3386
0,8,0,5,8,7,28,0.20262151692110703,53.92371469403199,3376
1,7,0,5,5,8,26,0.22801406232043123,53.859488859192076,3380
2,9,0,6,4,5,26,0.25013246120502725,53.43571278295896,3375
2,10,0,6,3,6,27,0.26057916856498703,53.755871575522285,3371
0,14,5,5,0,8,32,0.297598312815361,52.91215967941035,3372
0,15,5,4,0,7,31,0.3153333173819431,52.92313369229772,3362
0,4,3,2,0,9,18,0.32419667150159304,52.782717622172555,3368
0,7,0,5,0,6,18,0.31775257729214096,53.68835886465945,3371
0,8,0,5,6,6,25,0.34218734758140484,53.87630170832973,3367
0,10,0,4,7,6,27,0.2918568741433175,54.14425901822777,3362
0,9,0,0,4,5,18,0.25586056536071394,53.76448486225702,3370
0,6,0,0,4,2,12,0.23950828364733207,53.97914638081703,3377
1,7,5,0,0,0,13,0.20623193136876555,54.82966597734397,3387
7,2,5,0,0,1,15,0.18003766835588972,53.810589450413474,3385
0,3,4,5,0,0,12,0.15559809841822325,55.7968965209791,3390
0,4,0,7,0,0,11,0.15222528177117123,56.20214279372053,3399
0,2,0,7,0,0,9,0.14410665894004618,56.45924473720637,3401
0,5,0,4,0,0,9,0.12584584724158807,56.630516079020495,3408
0,7,0,0,0,0,7,0.12379781497760434,56.89843007268112,3422
0,3,0,0,0,0,3,0.12530997012289302,57.104343655140575,3437
0,0,0,0,0,0,0,0.10646159609173168,57.45549585337625,3451
0,10,0,0,0,0,10,0.10978612096964417,57.74624051426823,3456
0,5,0,6,0,0,11,0.09881517822570783,57.93217953529941,3464
0,3,0,7,0,0,10,0.10749820641339147,57.919993682066725,3466
0,4,0,6,0,0,10,0.10350170139484212,58.05860557304143,3472
0,4,0,5,0,3,12,0.09770348003579463,57.98879663030476,3469
0,2,0,2,0,3,7,0.0985733517162412,57.97815874824909,3469
0,5,0,3,0,5,13,0.08099931052603503,58.17430767466365,3471
0,3,0,2,0,3,8,0.07627604482272049,58.28320347613094,3481
0,2,0,1,0,3,6,0.08608445749921782,58.23532892337802,3484
0,3,0,0,0,0,3,0.07880791107998349,58.36202088272888,3491
0,3,0,0,0,0,3,0.08651555927932172,58.415300283641,3495
0,6,0,0,0,0,6,0.07020340172347025,58.502291465791075,3502
0,2,0,0,0,0,2,0.061290028987960585,58.73489945394135,3509
0,0,0,4,0,0,4,0.07183810766115323,58.82777939874191,3516
0,2,0,1,0,0,3,0.07504697881444973,58.830714860839656,3519
0,1,0,0,0,0,1,0.0804853914193896,59.00419408152753,3532
0,1,0,1,0,0,2,0.07740391186305545,59.11022393043559,3537
0,9,0,4,0,0,13,0.08927445009017672,59.08913077957065,3542
0,2,0,0,0,0,2,0.0881726154106465,59.24932331411988,3547
1,2,0,0,0,0,3,0.07227461733987678,59.408497400999444,3552
0,4,0,0,0,0,4,0.05154284754891467,59.53336236359425,3554
0,3,0,0,0,0,3,0.03928146868207785,59.65316491215409,3556
0,0,0,3,0,0,3,0.052684994594856774,59.6983839630622,3562
0,3,0,0,0,0,3,0.059089208889085,59.71412036662971,3565
0,2,0,1,0,0,3,0.05568997056696032,59.79737697751114,3569
0,3,0,1,0,0,4,0.06407503491315482,59.83729778856676,3577
0,2,0,2,0,0,4,0.05850258228299356,59.89032109347343,3580
0,0,0,1,0,0,1,0.05647427172518811,60.01579842127782,3584
0,0,0,0,0,0,0,0.07331051111393173,60.084525825476575,3594
0,3,0,0,0,0,3,0.062353403153119415,60.14206628668943,3594
0,0,0,0,0,0,0,0.05953391405024689,60.19907083571836,3599
0,1,0,0,0,0,1,0.06143739386593745,60.308554821497935,3608
0,1,0,6,0,0,7,0.060371869826034735,60.353824726481456,3608
0,2,0,3,0,0,5,0.03891440853985887,60.40075900422146,3604
0,4,0,1,0,0,5,0.07122342058973943,60.35915086253159,3611
0,3,0,1,0,0,4,0.059769420846203625,60.390629561535704,3613
0,4,0,3,0,0,7,0.05843123751934549,60.48429630230719,3618
0,2,0,0,0,0,2,0.07283738366517081,60.57813906844007,3626
0,1,0,0,0,0,1,0.0664469809910234,60.61108497204798,3628
0,1,0,0,0,0,1,0.07327255355434342,60.71525608192891,3637
0,3,0,0,0,0,3,0.06352918634747383,60.82758191854774,3639
0,3,0,5,0,0,8,0.08494530861806468,60.75016473409035,3646
1,2,0,5,0,0,8,0.0972037079060574,60.81278906628161,3648
0,2,0,3,0,0,5,0.07436861038584246,60.828397022573476,3645
0,3,0,3,0,0,6,0.06047838850893887,60.948211683900986,3648
0,1,0,2,0,0,3,0.06320060940229554,61.07360489468627,3655
0,5,0,2,0,0,7,0.08147809584375347,61.12045764733844,3667
0,0,0,0,0,0,0,0.0702534121120016,61.246036562718956,3672
0,1,0,0,0,0,1,0.0825565461266348,61.31542138955156,3679
0,1,0,0,0,0,1,0.07632371458564759,61.41397134129338,3685
0,4,0,0,0,0,4,0.06762911467793097,61.5390865042671,3687
0,5,0,6,0,0,11,0.07854410157553682,61.48019618095765,3690
0,2,0,1,0,0,3,0.06859414007181729,61.58966203414431,3689
0,6,0,5,0,0,11,0.06795043042491714,61.61567828518307,3695
0,1,0,2,0,0,3,0.08685378453622392,61.69389481651716,3702
0,2,0,1,0,0,3,0.07191132703647772,61.74079543548115,3702
0,3,0,0,0,0,3,0.07394092444205193,61.82071465330279,3709
0,7,0,0,0,0,7,0.07403096188643325,61.86228835208125,3713
0,4,0,0,0,0,4,0.06885954358533324,61.987460426419624,3721
0,1,0,0,0,0,1,0.05461071268533385,62.18576250110174,3726
0,1,0,5,0,0,6,0.05444859592912831,62.18258639222216,3725
0,4,0,7,0,0,11,0.047103887332782465,62.18381368136062,3723
0,0,0,2,0,0,2,0.041605448538193285,62.2880046374753,3730
0,1,0,0,0,0,1,0.04485911978482992,62.37130108127801,3733
0,1,0,3,0,0,4,0.02890461326787477,62.40254907863554,3731
0,0,0,0,0,0,0,0.03951004762953521,62.45117705290541,3740
0,0,0,0,0,0,0,0.05512092466221631,62.48251246153282,3746
0,1,0,0,0,0,1,0.059323877090365136,62.592140467747186,3754
0,2,0,0,0,0,2,0.06155665041197478,62.664772647463245,3762
0,1,0,3,0,0,4,0.05314795089410022,62.78840632306331,3765
0,1,0,1,0,0,2,0.061214951882947545,62.86665824387019,3771
0,0,0,2,0,0,2,0.04119311155078609,62.96049159150165,3772
0,4,0,0,0,0,4,0.04136136826878997,63.00740603476219,3774
0,1,0,0,0,0,1,0.05320246669968944,63.05434335135408,3782
0,2,0,0,0,0,2,0.047675688425527385,63.15516604541029,3787
1,1,0,0,0,0,2,0.05610070818005205,63.2124208151167,3794
0,1,0,0,0,0,1,0.04680559429215655,63.37011757210164,3802
0,0,0,6,0,0,6,0.04693273808409048,63.36371902482819,3804
0,2,0,4,0,0,6,0.05188661347347295,63.39529798522045,3803
0,1,0,1,0,0,2,0.07365737134672853,63.46005267651686,3814
0,3,0,1,0,0,4,0.0761399684436868,63.532967716813395,3820
0,2,0,2,0,0,4,0.07518779859402346,63.5642689060624,3821
0,1,0,4,0,0,5,0.07529498658532864,63.61116399943407,3828
0,4,0,4,0,0,8,0.06279710335980969,63.70509395549136,3827
0,1,0,2,0,0,3,0.05266535356199962,63.75258737791154,3827
0,1,0,0,0,0,1,0.052861975134488204,63.81461456730195,3832
0,2,0,0,0,0,2,0.05502659854071026,63.88935964636598,3841
0,2,0,0,0,0,2,0.056220867451094336,63.97271862963969,3845
0,1,0,0,0,0,1,0.05953212472842367,64.07715726379335,3852
0,1,0,5,0,0,6,0.0604167441790665,64.02867232315515,3852
0,2,0,7,0,0,9,0.05111036280372309,64.05453096810928,3850
0,2,0,1,0,0,3,0.054565627682691235,64.14615639657409,3854
0,2,0,1,0,0,3,0.04505273863324277,64.23845225627458,3856
0,3,0,2,0,0,5,0.04641821236685354,64.25400521846296,3857
0,2,0,2,0,0,4,0.042820363892859974,64.25400521846296,3856
0,0,0,1,0,0,1,0.043145902314164215,64.29031252415518,3861
1,1,0,0,0,0,2,0.04086282542908793,64.32886180877847,3865
0,0,0,0,0,0,0,0.029362939060690152,64.48957898795086,3870
0,1,0,0,0,0,1,0.031425176791263484,64.55022629369897,3876
0,0,0,0,0,0,0,0.038820419803448344,64.63167070371243,3880
0,0,0,5,0,0,5,0.048488180520117614,64.53524413516082,3880
0,0,0,3,0,0,3,0.050391729084349045,64.64470335992954,3885
0,0,0,1,0,0,1,0.024963392569650245,64.78594531669636,3888
0,0,0,0,0,0,0,0.01787934965536998,64.8896567498064,3890
0,0,0,0,0,0,0,0.0247330609256932,64.96258797559261,3899
0,0,0,0,0,0,0,0.022631168927387955,65.0325501993631,3905
0,0,0,0,0,0,0,0.030009178036169256,65.0946222783225,3910
0,0,0,0,0,0,0,0.02491765208844053,65.15717580247097,3911
1,0,0,4,0,0,5,0.033808300398087764,65.18146993997455,3916
0,0,0,0,0,0,0,0.02465186294157157,65.29116710630264,3920
0,0,0,1,0,0,1,0.025338315553364698,65.37950338857358,3925
0,0,0,0,0,0,0,0.019825306527967847,65.44201915476964,3927
0,0,0,0,0,0,0,0.022240430048106483,65.5047711968172,3932
0,0,0,0,0,0,0,0.0159286194562939,65.5827894379014,3934
0,0,0,0,0,0,0,0.03348620395812719,65.59840382850892,3942
0,0,0,0,0,0,0,0.027634472179341375,65.66197726399118,3945
0,0,0,0,0,0,0,0.03476970638595296,65.7235084381396,3952
0,0,0,0,0,0,0,0.038442028976507406,65.83311368026331,3958
0,0,0,1,0,0,1,0.0275664058181997,65.89563813862415,3960
0,0,0,0,0,1,1,0.026999075635843715,66.0052812989736,3965
0,0,0,1,0,0,1,0.028298739227456866,66.07790096959768,3972
0,0,0,0,0,0,0,0.0248868725616431,66.1769054013037,3977
0,0,0,0,0,1,1,0.033965147583756884,66.24405419554184,3984
0,0,0,0,0,0,0,0.026037466710679774,66.30438933233532,3987
0,0,0,0,0,0,0,0.02083122891648887,66.37238881386585,3991
0,0,0,3,0,0,3,0.017680582099282166,66.44360487689981,3994
0,0,0,0,0,0,0,0.026747447330678784,66.53743496770791,4000
