throughput_KLONGTEI,throughput_KASEMRAT,throughput_NARANONG,throughput_SUNLAKAKHON,throughput_RAMA4, throughput_ATTHAKAVI_RAMA4,throughput,mean_speed,jamlength_percent,Backlog
0,0,0,0,0,0,0,7.841417690959361,0.013863418376537978,17
0,0,0,0,0,0,0,8.357546602692858,0.03191168924603467,40
0,1,0,0,0,1,2,9.663023622369332,0.048230105780546394,55
0,2,0,1,1,0,4,9.842885040256009,0.060112287641060164,83
0,0,1,0,1,0,2,10.12209787114272,0.0706214871830416,103
1,3,2,1,0,0,7,10.059055244369054,0.1069803474265167,134
3,8,1,0,1,0,13,9.65842452364896,0.17461158766080764,151
2,2,1,5,1,0,11,9.703742821120093,0.21100496624360263,176
2,3,0,1,1,0,7,9.091243356504322,0.34095288916929034,205
6,2,0,2,1,3,14,9.116048502407105,0.43117298239180113,221
2,2,0,0,5,2,11,8.643382649100566,0.6402674273007753,263
5,16,0,5,1,3,30,7.928249908865063,0.8370836539774348,282
2,3,0,7,2,3,17,7.506551505329557,1.1073237269441576,311
5,10,1,1,2,2,21,7.362210952769736,1.2623247328596152,326
4,9,0,1,4,5,23,6.739151446616983,1.671995834395115,356
7,4,11,0,3,4,29,6.484755375230485,1.8359568048329034,368
2,6,6,18,0,5,37,6.580115206979147,2.0090177818132227,391
6,14,0,6,3,2,31,6.533505344341429,2.171802578878041,426
3,5,1,0,3,6,18,6.02669539211979,2.5705850022062773,447
11,12,10,4,22,4,63,6.631763851304714,2.0517853292874233,474
6,6,12,3,19,4,50,6.604138952912499,2.2718994451630143,476
12,8,9,14,2,2,47,6.7003183798051,2.2874624940728356,501
13,2,11,8,7,3,44,6.59103041672559,2.4594097093549108,531
10,14,5,4,7,11,51,6.2941218186395,2.6626332189998125,538
9,10,9,5,5,12,50,5.790002539912138,3.0434567325192696,543
10,14,10,18,6,14,72,5.789675353170142,3.1351576979069575,559
12,10,10,17,4,15,68,5.551014174841163,3.6065438139850867,569
8,13,14,3,7,9,54,5.299254649937944,3.9722508712012625,585
10,10,7,2,21,7,57,5.375617330847615,3.9425994211278192,600
26,14,6,2,20,4,72,5.4007549604727165,4.20860036512479,615
27,6,11,2,9,6,61,4.774459692527513,4.386430786514404,617
7,9,13,3,6,8,46,4.54066459830912,4.821657381720499,624
7,9,11,11,7,9,54,4.51689736799652,4.919279859695793,632
6,8,15,5,5,5,44,4.24803947207487,5.249062326771712,640
7,7,4,1,7,5,31,3.9856738580300664,5.718896623767014,666
6,17,1,0,9,7,40,3.83589268413841,6.133735338063764,688
6,7,4,2,4,7,30,3.530981092872278,6.592402253757852,722
10,14,2,1,7,0,34,3.5336487271656694,6.908608870893006,743
1,3,10,6,9,3,32,3.511443069098737,7.175671640847702,753
23,3,5,17,12,5,65,3.6401974536156216,6.892345537204467,755
4,4,2,21,6,4,41,3.476400041186054,7.093263784509458,756
6,14,1,21,1,1,44,3.222405849610868,7.507333475587316,752
4,3,10,11,0,5,33,3.106913505916507,7.588430781772163,768
5,7,10,11,0,5,38,3.247817137121472,7.518810580125049,792
9,6,10,12,17,3,57,3.7248628164676063,6.807983180779088,806
11,8,10,11,21,5,66,4.1827309368289765,6.301438208153504,824
8,4,7,13,24,6,62,4.076682383767558,6.519349778094914,846
11,8,5,10,18,0,52,4.002135425972653,7.22836898891375,874
6,11,6,9,10,10,52,3.86480544660942,7.788632321012036,892
14,12,5,2,6,14,53,3.5530815845608017,8.290544974146552,918
6,29,7,1,11,14,68,3.5326877978722275,8.075485749591584,927
8,24,12,11,8,15,78,3.729711973464312,8.10799618088464,943
4,18,14,14,9,16,75,3.8475396127613477,8.32130073570861,947
9,14,11,8,35,8,85,4.06105120523684,8.0058952118013,947
9,8,10,3,29,15,74,3.876435420755477,8.363072725924143,959
26,14,11,3,11,13,78,3.4965654616591393,8.800300053761642,966
18,8,5,1,10,9,51,3.1323469230583956,9.020116315740468,964
9,7,5,1,10,8,40,2.8812651972927177,9.627070138949422,987
10,11,5,4,11,14,55,2.664508393805199,10.246944612579,994
21,24,9,2,6,1,63,2.7595593878306874,9.848871762759217,989
3,25,16,6,11,7,68,3.1205673002833603,9.407703312020443,1000
6,15,13,3,8,11,56,3.4292640455451933,9.131733823653445,1026
8,10,19,3,5,7,52,3.427338321417297,9.490163126037917,1054
7,13,11,5,5,8,49,3.2958479591150276,9.770641923985512,1069
4,10,10,12,6,11,53,3.0380609110546013,10.415710692254324,1066
5,5,8,7,13,11,49,2.804924499384932,10.796625340551161,1082
5,0,6,8,12,10,41,2.4812270904763345,11.685620048199036,1085
2,5,7,6,14,9,43,2.36939329222244,12.303416955947291,1111
0,17,13,2,7,8,47,2.3944725598779946,12.4578598760911,1126
2,24,6,17,19,8,76,2.69263595038506,11.910482914611672,1130
13,19,0,21,17,8,78,2.9522498119359253,11.094306903732877,1127
15,16,0,22,16,9,78,3.2090294599202775,11.005583025893216,1136
14,22,5,21,10,7,79,3.1189345846120875,10.907249304974695,1132
8,16,9,9,30,6,78,3.03110688513218,10.459580618267397,1128
7,4,5,12,23,4,55,2.712444334167033,11.047470182327679,1152
36,2,6,10,10,7,71,2.5050776321076422,11.759582527544037,1140
22,7,6,6,7,1,49,2.27184280681884,12.074828665528019,1135
5,22,5,11,5,1,49,2.201203873131537,12.06038223679628,1134
3,16,5,1,10,4,39,2.2116833438967904,12.373275915636034,1153
14,14,5,1,7,3,44,2.1970835452634336,12.738730972377418,1155
5,9,6,1,10,5,36,2.1772929335281606,13.362895486015272,1172
6,6,6,3,4,3,28,1.9951955464756361,13.512028677009083,1179
5,6,11,14,10,4,50,2.18686302652483,13.002144139731957,1187
4,9,11,11,4,6,45,2.2762777705399757,12.611642596491961,1212
3,9,11,9,5,3,40,2.3336184201090244,12.283626485253354,1214
5,10,7,13,4,6,45,2.5268064009613616,12.301101421347214,1242
7,9,5,13,5,4,43,2.4801989540095564,12.497924803814616,1243
5,5,6,7,14,4,41,2.4800231067376988,12.805064230538331,1268
0,6,5,9,7,3,30,2.243283029892678,13.756463742240978,1283
2,7,5,9,2,4,29,2.033028627308544,14.549322950567424,1304
2,10,5,6,0,5,28,1.8411052977441424,15.230803769561298,1322
4,10,5,4,22,4,49,1.9419758495257342,15.214185326375462,1347
3,15,7,1,24,7,57,2.0100459404146296,15.016322125598462,1344
11,19,5,3,20,7,65,2.1878265882405565,15.123621222042956,1362
13,13,7,2,20,5,60,2.126876049380627,15.038198297265918,1376
8,14,7,11,25,5,70,2.1641426127810766,14.999438310761091,1386
16,8,5,13,18,4,64,2.2542399729272513,15.334159058134059,1424
11,3,5,11,15,4,49,2.112172939527222,16.144786100516935,1447
5,8,15,9,11,6,54,1.8537581043777425,17.020736840737726,1461
30,9,8,3,5,20,75,2.0838354496591394,15.983897425800356,1459
6,11,11,1,9,19,57,1.9959028832102645,15.573436102047477,1455
17,26,8,2,14,16,83,2.1793964561191443,14.968105970365283,1446
12,19,5,4,8,11,59,2.069834014567659,15.215926771377228,1432
15,25,5,1,6,14,66,2.200530002202704,14.652877716200425,1427
7,15,5,7,7,20,61,2.218799588912733,14.707552570751142,1426
12,13,5,6,18,14,68,2.1871871176741604,15.230824119554937,1440
8,10,5,5,14,21,63,2.044582526961192,15.97633006600938,1459
9,11,5,5,3,15,48,2.0138990135918227,15.782492372860839,1468
0,9,5,14,9,17,54,1.8597988223146136,16.698188811196985,1486
14,11,13,14,21,11,84,2.1085836606293813,15.96717442049181,1480
32,27,14,13,8,15,109,1.9699091273775282,16.134889208613938,1463
5,22,13,4,7,13,64,1.8581530439458456,16.77830133666056,1473
6,23,15,17,2,8,71,1.7732767498656032,16.764224777421344,1454
6,4,11,21,10,11,63,1.8525169139128543,16.433759001909333,1460
5,10,12,21,6,15,69,1.9484063514359722,16.40982087912595,1458
7,10,14,21,4,16,72,2.0697082131155033,16.14448121045922,1440
3,7,10,20,5,13,58,1.9100626944373327,16.134741475013794,1434
7,10,6,23,4,12,62,1.756452861944332,16.63143572478125,1427
0,2,5,9,7,3,26,1.524872496603304,17.367107083933856,1448
13,21,5,10,17,3,69,1.7790929592644462,16.675189151764307,1450
8,18,6,11,19,5,67,1.9769292462179873,16.50148831062978,1468
10,16,6,9,12,7,60,2.119946806792706,16.03727067054016,1474
10,12,5,14,6,9,56,2.2736658261515514,15.928268723168694,1480
12,12,5,12,9,8,58,2.296400009421468,15.676077946931523,1491
11,8,5,11,10,10,55,2.2038704864256653,15.952993521928397,1516
7,4,5,9,8,9,42,1.9448530085713183,16.96102433393012,1540
9,3,5,6,3,9,35,1.7188163973704396,17.50708363124353,1564
7,3,5,6,3,10,34,1.729138265627566,17.95095427362439,1588
1,21,5,5,12,10,54,1.7408074704612613,18.00340186388184,1617
23,21,12,1,11,9,77,1.9126442182452656,18.33655745257931,1632
12,20,13,1,7,5,58,1.8193882263670262,18.735881365691053,1661
10,25,6,1,4,5,51,1.9603458648871666,18.3659883502318,1676
10,16,8,10,5,8,57,1.8783568118324523,18.9231463205482,1690
11,9,9,8,13,8,58,1.8541174850982949,19.34662863268736,1709
11,12,6,6,26,8,69,1.6603439174271724,19.966502227912034,1723
12,16,2,6,20,5,61,1.7562860784100054,20.133782002619682,1737
9,10,6,4,8,6,43,1.7277721479383388,20.431846421514965,1748
11,23,5,0,7,7,53,1.745397977708023,19.88107454320112,1763
2,25,6,0,11,6,50,1.6841776202178318,20.59077661261826,1784
17,21,8,0,8,6,60,1.7222438807002702,20.57856159340582,1799
7,15,8,1,6,7,44,1.5877241542778027,21.510576932423167,1824
12,8,8,0,8,7,43,1.5367932761462044,21.661642016915955,1849
8,9,7,0,14,6,44,1.4366627800373812,22.48279510228869,1861
9,14,5,0,15,6,49,1.3903807952263798,22.47566719552148,1871
4,10,11,0,17,7,49,1.3454079948909747,22.96501048288163,1874
8,11,16,18,12,5,70,1.360609909848335,22.791230528963723,1867
11,23,11,13,20,4,82,1.6454258142668856,21.910482057583895,1857
9,25,12,11,21,5,83,1.7093688426945868,21.31341207414645,1841
0,12,5,8,21,3,49,1.6311854242135542,21.84857158718545,1853
6,8,14,6,3,4,41,1.439641527433069,22.655624142814315,1846
7,6,15,10,21,6,65,1.3851759716541974,22.574339046906093,1858
10,6,14,6,23,6,65,1.376708280656129,22.748333805377143,1850
27,6,15,6,24,16,94,1.5956455970306636,21.500570998537896,1815
27,6,15,12,17,18,95,1.6481977337499372,20.85746711980656,1775
24,11,13,19,16,14,97,1.8077175642701842,20.186851589400987,1727
20,23,6,22,18,12,101,2.0164418020685893,19.167080115216105,1700
16,25,5,22,16,17,101,2.0654251837256195,18.663194349665396,1684
13,23,3,5,8,17,69,2.0251977919801876,18.571112979007463,1661
1,24,7,15,8,16,71,2.00130813164386,18.683922323889472,1652
19,19,11,12,7,12,80,2.0598724564313105,18.765747684950412,1649
10,10,10,14,4,8,56,1.9253401606696343,19.013904432690655,1657
11,10,6,15,3,14,59,1.7620871323137144,19.162251571117487,1653
8,6,5,15,12,14,60,1.724268239988958,19.102656712598385,1648
10,10,5,9,14,16,64,1.7939648684305995,19.278497541530555,1678
8,29,5,8,13,19,82,1.8995609915779792,18.779716592541718,1681
9,35,5,9,9,13,80,1.8550449740635189,19.007192166688775,1685
9,24,5,7,4,11,60,1.7291592714109392,19.362938058312956,1677
8,10,6,5,1,17,47,1.690533622103697,19.80576269698063,1690
5,10,5,10,2,15,47,1.6218540256090006,19.952555743064142,1710
12,11,5,7,4,12,51,1.3990734670091112,21.0224969896829,1710
6,6,5,3,5,13,38,1.2698435052569443,21.20082335393729,1720
9,9,4,2,4,11,39,1.30261579098951,21.633689823764083,1732
11,1,3,0,15,0,30,1.2735107275411999,21.731263495021306,1747
9,19,6,0,19,2,55,1.5179002801766235,21.363328382576814,1751
9,15,8,5,9,5,51,1.650757608176417,21.133137741696217,1764
11,18,11,4,3,8,55,1.754350943087586,20.93433410510805,1788
12,15,11,5,5,9,57,1.8273207333258419,20.934327684989558,1813
12,13,12,5,10,9,61,1.7972145438837408,21.42254141225277,1852
8,12,10,7,9,8,54,1.7996429126517883,21.796550541755764,1879
6,6,15,3,3,9,42,1.554640976077181,22.80403986263503,1919
30,4,12,0,1,9,56,1.4269385708759148,23.37457741369403,1938
7,5,10,0,7,9,38,1.4303756951683855,23.70613122428378,1971
11,20,9,13,19,7,79,1.5559180960056052,23.42408291484825,1980
12,23,5,7,23,8,78,1.6707801958247006,23.253129646307354,1977
9,24,5,7,16,6,67,1.6403209358979958,23.13814613647616,1974
9,22,5,4,8,6,54,1.4630081687878016,24.00348269915834,1995
11,9,5,11,5,5,46,1.4058019913780464,24.17970367318894,2021
9,6,14,13,6,5,53,1.4058242624171455,24.157905473225934,2018
13,9,8,17,4,6,57,1.5128888988936007,23.490861077805857,2010
5,8,6,17,9,5,50,1.453479715801833,23.666702169845422,2007
16,8,5,17,8,7,61,1.386949079117572,23.99699929742062,2014
7,25,7,3,8,6,56,1.374734436701267,24.581569618228027,2043
9,24,6,18,7,4,68,1.3542856674758392,25.114048170803997,2036
6,15,6,20,6,6,59,1.3562696684559148,25.086872565921787,2033
7,13,6,20,13,7,66,1.3240393678842852,25.081219606464185,2008
2,9,5,24,8,4,52,1.2160023667416333,24.79453099130165,1977
4,5,5,19,7,3,43,1.2443603559904033,24.81551230266145,1971
3,8,5,21,12,5,54,1.2045828801458915,25.17213093266365,1964
6,9,5,16,11,2,49,1.1661075858575622,25.412923182218428,1957
0,8,5,15,21,3,52,1.1003527917414133,25.404664328139496,1940
6,20,7,9,21,4,67,1.2061061293333322,24.906922384516182,1935
8,17,6,15,9,1,56,1.3298032818815382,24.421385307917635,1953
8,11,6,9,4,4,42,1.1516044236523217,25.164698003930244,1955
11,4,8,8,17,5,53,1.3857138507902054,24.418401080435583,1953
13,4,7,10,21,3,58,1.5238922879413364,24.144636836548692,1972
22,5,7,10,13,2,59,1.452587318849949,23.885930233025633,1954
20,9,6,15,23,4,77,1.498715118004452,23.638209976950478,1939
19,7,6,16,20,6,74,1.5180922262607313,23.510077035382164,1934
14,6,7,8,21,6,62,1.4697839186749742,23.818771823894373,1939
0,21,10,9,21,5,66,1.464372926024551,23.827687434787666,1943
25,21,9,2,9,1,67,1.4866363798494138,24.21570086168507,1970
11,14,5,8,13,2,53,1.353533317111075,24.645752658231924,1987
6,3,6,8,5,6,34,1.3083347380740875,24.740293435748097,2011
13,9,15,3,21,6,67,1.314664942351392,24.9377652501797,2015
21,9,15,0,24,2,71,1.359105715414053,24.709536571913556,2006
18,12,15,0,21,3,69,1.3899281281850397,24.274243870297294,1995
16,9,15,0,11,1,52,1.3497822003984001,24.68661574576023,1989
8,10,14,0,24,6,62,1.331489392548224,24.939138233878946,1991
6,18,6,7,10,1,48,1.2877313309043221,24.761796657991326,1988
1,16,5,6,2,17,47,1.3327147448148577,25.09165801544227,1994
12,12,5,6,1,20,56,1.4325720837064815,24.592317523055414,2003
6,16,5,8,16,18,69,1.51413119922621,24.19439787152768,2000
12,11,5,14,13,15,70,1.5119657022844266,23.6862809253573,1982
10,12,5,12,13,12,64,1.3557819773959077,24.25696692062877,1970
12,10,5,8,11,16,62,1.329225463781829,23.61299533908467,1938
10,10,5,7,16,16,64,1.486441428317131,22.77447720488325,1939
8,8,5,8,15,15,59,1.2977787358205812,23.530691315801956,1933
10,31,5,15,4,18,83,1.387376613420073,23.138590123788322,1923
7,29,9,20,6,13,84,1.5269294902099084,23.050777113868854,1925
1,20,10,22,23,6,82,1.5638686883157846,23.532962777899602,1912
30,16,7,21,25,7,106,1.6691404054564312,22.13709978460061,1893
29,11,7,20,22,16,105,1.4982910672290228,22.679313167851177,1866
20,12,6,9,9,13,69,1.2297200815655915,23.137512818014255,1848
6,9,5,1,15,11,47,1.2027917248665547,23.601697656768245,1857
4,7,5,3,4,12,35,1.0836324003876883,23.770624289454503,1864
6,15,5,4,1,13,44,0.9757252046684389,24.449532896606033,1876
8,25,6,4,1,7,51,1.0317498205358404,24.044972171515013,1888
2,32,5,12,18,6,75,1.1672311293878497,23.829111048862483,1889
13,24,5,7,8,14,71,1.31129035460569,22.928575531900805,1877
5,17,5,8,7,14,56,1.408649309838262,22.621093770644478,1872
17,9,5,9,10,12,62,1.5670704159512845,22.591164692277875,1875
16,7,5,9,12,14,63,1.5279918291802026,22.65764912343472,1870
9,7,7,11,11,13,58,1.3739152936696792,23.034601430642862,1871
6,10,8,14,4,11,53,1.1770090887945803,23.694610636063498,1883
4,7,6,8,4,5,34,1.0380189961306765,24.885088764313416,1913
2,21,6,4,5,2,40,0.9709013894754629,25.717537602591992,1938
6,10,7,6,22,3,54,1.2189917704796338,25.07347058319092,1960
5,18,6,5,24,5,63,1.3490956215989833,25.095001878666807,1975
8,12,5,5,0,7,37,1.4886354367635595,24.38988356204803,1995
3,9,14,2,2,7,37,1.524047865551064,25.19936743548857,2020
15,10,10,0,10,8,53,1.3021601947952066,24.926110782515536,2019
7,11,6,0,8,7,39,1.2814421485735696,25.324149403717556,2039
13,5,12,0,7,8,45,1.14111642651656,25.754646143627497,2037
13,6,5,0,7,10,41,1.075652947001888,25.89346944032289,2059
7,15,7,4,6,8,47,1.1712240882042302,25.64011226168145,2071
8,15,5,0,8,8,44,1.215794777984737,25.923031503410776,2100
5,17,6,0,9,9,46,1.3581549729642148,25.832574640275144,2103
9,15,6,1,10,10,51,1.3323257718888524,25.427160832788186,2119
8,20,5,3,14,9,59,1.3306522296181906,25.802382998226218,2126
2,18,3,7,13,7,50,1.2370120760207148,26.465964800547148,2126
14,11,6,12,21,5,69,1.2507221161809043,26.036320978891307,2123
9,6,6,10,26,6,63,1.211324147787858,25.977546458208938,2126
10,9,9,10,23,5,66,1.2024437926167264,26.469847667535305,2134
9,23,8,11,7,8,66,1.2343527629453885,26.088196859878245,2131
9,24,8,10,21,6,78,1.2622755739022749,26.19233074067664,2139
7,21,6,12,25,7,78,1.3216367293555198,25.723965307360338,2143
26,17,5,11,22,8,89,1.326249442937624,25.353358962750626,2126
24,12,7,12,17,6,78,1.2084752544468735,25.666105785487627,2104
19,9,6,7,8,5,54,1.1298472064238845,25.673882756492933,2100
0,9,6,7,8,7,37,1.071958422147795,26.136096531210676,2101
12,12,6,6,8,8,52,1.078958712790996,25.944044457542017,2091
10,8,16,9,7,5,55,1.132117541396085,25.796357463832774,2096
13,23,15,20,5,5,81,1.2363417357302227,25.59433271489358,2079
9,24,15,23,7,6,84,1.2718168823508245,25.678193275865862,2058
11,15,15,15,8,7,71,1.2600907922542703,25.773007310813355,2052
10,9,12,8,19,8,66,1.2719904547756127,25.74047793734108,2045
16,12,5,14,10,6,63,1.1133942929191218,26.217737367466704,2034
7,7,5,17,8,4,48,1.1605573312494601,26.3126992695072,2034
7,10,5,14,9,6,51,1.138882642367572,26.209021739150433,2028
1,10,5,15,16,3,50,1.0905769729942751,26.387124057922737,2023
7,7,5,15,7,3,44,1.0209461334723644,26.641166214243356,2036
11,6,5,13,4,2,41,1.011964861064653,26.799326835115117,2057
10,5,5,7,9,4,40,1.0074319542522874,27.307801876695052,2062
12,4,5,5,10,3,39,0.9725628414990474,27.73629500717342,2075
6,9,6,8,18,2,49,0.9552053921453875,27.21069428386553,2082
13,11,9,5,7,2,47,0.8956811507142255,27.587942303047054,2068
5,9,10,2,9,2,37,0.9607009056045711,27.938648083587903,2075
3,18,7,4,7,3,42,0.9838807167031643,28.091310066661936,2075
3,13,6,4,12,4,42,1.1130345429179922,27.771393924283473,2097
6,13,8,0,6,1,34,1.0638978261032532,28.160325531734465,2094
8,8,7,1,6,3,33,1.0328702562015755,28.43728056436209,2105
8,4,5,0,8,4,29,1.0267761091291507,28.46541539118546,2107
4,2,5,1,8,5,25,0.9958860699519777,28.561411029232048,2119
5,12,6,0,21,4,48,1.0303748806103696,28.45513594611173,2128
7,10,5,11,17,2,52,1.0462350310745123,28.269710327166553,2124
7,10,5,6,1,15,44,1.0123030898379508,28.115339763498923,2140
11,19,5,6,3,20,64,1.1471398333210998,27.065206225535785,2130
9,25,5,7,5,17,68,1.2998257558502329,26.453233611317753,2123
11,22,5,12,8,20,78,1.411197008074691,25.069208401021864,2096
6,26,6,9,10,15,72,1.474253226445632,24.875018652775207,2093
16,14,3,10,8,15,66,1.5292324609903674,24.60579617810951,2087
11,15,6,13,9,12,66,1.4078465369218163,24.58403751868993,2065
12,10,7,4,13,14,60,1.3535032858446532,24.407835083074996,2087
12,8,7,17,22,16,82,1.5682161513372046,23.81288722685695,2080
11,10,5,20,9,19,74,1.6732105933244354,23.967100381203483,2095
10,28,6,22,8,19,93,1.8445481301572315,22.6714015965693,2076
11,36,3,21,15,14,100,1.9381199945817222,22.06276579868861,2066
11,21,7,20,9,11,79,1.7890201025649295,21.96310512064472,2056
11,13,10,14,11,6,65,1.616247658868978,22.970131548117067,2047
0,9,9,1,4,11,34,1.496150535824453,23.94276827251101,2072
13,10,8,3,7,15,56,1.3366930993886477,24.606380439062384,2080
10,19,7,3,32,16,87,1.4596243104468947,24.43561351327784,2083
8,10,12,3,35,17,85,1.4183565756958347,24.778860217152506,2086
12,19,7,3,11,14,66,1.3438090794822752,25.7615728465019,2099
12,13,5,0,13,17,60,1.27643931343434,27.407364111577593,2117
10,11,7,0,10,15,53,1.0855624817440719,27.804097554799046,2118
8,12,10,12,6,14,62,1.0775362898652296,28.033620899562525,2125
13,25,7,14,3,17,79,1.130674335454549,27.660089234819534,2128
7,17,4,17,8,9,62,1.1853118587375724,27.96308853860782,2131
7,17,4,13,23,10,74,1.3405570733982106,27.32511618884627,2144
38,11,8,15,18,10,100,1.3285934091110316,27.580883640625927,2128
39,10,5,8,8,7,77,1.256183047440491,27.55672424485938,2105
23,7,5,8,6,8,57,1.0321242736082181,28.069480908362856,2102
12,9,5,8,10,7,51,1.0252603982160098,28.33952069311615,2110
8,7,5,10,14,5,49,0.9166812524650294,28.502599231384607,2113
8,6,9,6,13,4,46,0.8543707373230173,28.899184354791977,2121
2,20,10,6,10,5,53,0.9480007521948058,28.836730572586394,2119
5,14,6,2,7,8,42,0.9224221181670531,28.987822923233622,2117
4,20,7,3,7,9,50,1.0691966264064847,28.791859490121194,2140
3,14,5,1,10,7,40,1.0857143029658927,28.906261819178944,2147
6,10,9,0,13,10,48,1.0799562415073758,29.03503782561692,2158
3,11,12,0,9,10,45,0.9972216229759094,29.140094968054996,2162
4,8,9,0,7,8,36,0.9205239903611967,29.672204865843963,2174
4,4,7,11,7,9,42,0.8904527121656585,29.800904101811746,2184
4,1,9,8,5,8,35,0.875707417987661,29.20753927953616,2204
3,18,9,8,14,9,61,0.9579418721807582,29.290553206769193,2195
1,14,10,7,16,8,56,1.0346787175898984,29.625554724674007,2194
0,24,9,10,11,10,64,1.0429694959602405,29.0705487198835,2191
0,22,7,8,6,9,52,1.0490484011309307,29.022281500448067,2174
0,19,6,5,23,10,63,1.0508663690166016,28.461866779200125,2172
4,13,15,3,27,8,70,1.081069223056869,28.27825474523341,2173
5,9,16,17,21,8,76,1.1471638702826839,28.05024188114872,2169
5,3,15,21,1,6,51,1.1291288248956777,28.27251874393716,2162
5,5,15,21,17,7,70,1.1718166145375568,27.875748653000088,2141
12,9,15,20,13,7,76,1.2233318823952832,27.326765860651964,2129
14,20,12,22,6,5,79,1.159252431722077,27.501616966245333,2102
11,22,7,16,11,6,73,1.1517577807026527,27.645954989120174,2096
6,23,12,15,6,4,66,1.2283385209058806,27.27906976616705,2088
9,8,10,8,2,7,44,1.276063317542681,26.82570800372043,2095
5,8,11,10,14,6,54,1.2023638139680775,26.943412941059087,2091
40,7,10,2,11,5,75,1.2280302738056632,26.54375943396488,2086
31,12,10,3,15,5,76,1.2805537121539143,26.069723495667304,2081
26,9,5,7,9,3,59,1.1544925094615095,26.892599037673644,2089
9,21,6,7,17,3,63,1.225868574640238,27.318159245679983,2088
11,19,6,5,24,3,68,1.348636757532255,26.639423952460895,2086
8,10,5,0,22,1,46,1.37874067346058,26.65267238432987,2101
15,5,9,5,8,3,45,1.2048876756088545,26.722186571847846,2101
13,2,10,2,11,4,42,1.2193527085645566,27.16253267369128,2134
17,6,9,5,8,1,46,1.0577785207495265,28.263394876338115,2133
7,8,7,1,9,7,39,0.9727270348700325,28.580472020515668,2141
7,8,5,0,14,6,40,0.9487410584118141,29.137609840449098,2150
6,8,5,0,17,5,41,0.9755800040228525,28.956013497138038,2153
20,20,5,0,20,4,69,1.1612400142198533,28.60191821334357,2157
13,17,5,0,17,3,55,1.0897406775920089,28.41985453171936,2164
8,18,5,4,6,1,42,1.0396649856797686,29.00980865698617,2180
11,5,5,0,11,3,35,0.9780924937811148,29.957040493794082,2203
9,8,3,1,7,7,35,0.9263095945841461,29.80305496623019,2211
10,9,5,5,4,18,51,0.9462997691216114,28.967511167233788,2203
12,5,6,9,6,19,57,0.9940075617283468,28.314638759564914,2197
13,8,5,7,5,17,55,1.0102994386584727,28.195939707190366,2200
10,9,5,5,20,18,67,1.0759766243546456,28.535926955111105,2202
6,21,6,5,16,15,69,1.1804264432249372,27.742132938305712,2201
32,24,6,7,8,21,98,1.2720622553209524,27.242729659115817,2177
11,27,7,16,8,14,83,1.3724910109142863,26.18438726205262,2150
5,23,7,18,7,19,79,1.4028589583973385,26.19591239227275,2130
6,22,6,21,12,18,85,1.4577478551381806,25.59880638473219,2108
8,20,10,22,11,19,90,1.5764087165360972,25.040828059381067,2083
3,9,17,22,7,21,79,1.4493723250572361,24.713144322384675,2072
3,10,4,23,4,20,64,1.3051579615035553,25.143293093840946,2069
4,7,8,12,6,19,56,1.161216129120755,26.100420757272726,2072
12,29,3,8,6,10,68,1.157820369337917,26.251977723092242,2099
1,25,6,15,6,1,54,1.1530589414995291,26.208706039254373,2092
11,24,6,13,13,4,71,1.2367355456262494,25.32270143996866,2066
0,19,5,13,2,7,46,1.236244023190595,25.02585190323766,2054
1,11,5,12,3,7,39,1.4787830428722029,24.019328057351743,2047
2,13,5,12,11,9,52,1.5629645950399742,24.456767630722176,2062
2,3,7,13,9,10,44,1.4291999385524623,25.08379109302247,2061
4,3,5,13,23,10,58,1.3683633397714745,25.630874127938437,2084
7,1,5,4,26,9,52,1.4556042812736418,25.75499205802186,2110
8,17,8,7,26,8,74,1.4144555615488066,26.428667145558215,2112
10,21,6,9,9,7,62,1.50388975494207,25.965252174540293,2125
0,19,9,5,17,8,58,1.3614886422624883,26.593130399403734,2141
22,19,8,4,12,5,70,1.2821350829831017,27.19826556432123,2139
14,19,11,0,11,7,62,1.1941505528314085,27.836683217270377,2128
12,11,7,0,9,6,45,1.0843609782562509,28.20609907662064,2122
2,9,6,0,12,5,34,1.0089981652508258,28.36856666148665,2144
6,7,8,0,12,3,36,1.0341088871104764,28.869563096000604,2151
10,8,6,0,19,4,47,0.9605387392460466,29.028396330092576,2157
8,22,9,10,6,4,59,1.0418309079949584,28.483164996351306,2159
10,17,7,8,4,4,50,0.9772590979946639,28.854837975691847,2163
9,19,5,11,7,7,58,0.9844202363026663,29.27492863568984,2174
0,14,6,9,8,4,41,0.9050791341924801,29.604472113557836,2186
8,11,4,12,6,8,49,0.87803982831542,29.443407417323474,2174
2,9,5,6,10,3,35,0.7330304969166823,30.26985819494997,2172
4,8,5,6,7,2,32,0.7039988085641788,30.405430284132642,2170
6,9,5,10,9,1,40,0.7604418417976662,30.03590787970207,2172
5,10,5,9,1,5,35,0.6811306094915388,30.287288713006394,2168
5,13,5,15,1,3,42,0.7923827508017157,29.776197625797206,2168
5,16,5,22,0,4,52,0.9615857938268247,29.56563750352552,2170
15,14,5,20,2,8,64,1.0853441351699753,29.20253524256482,2165
11,10,5,20,22,4,72,1.2066318711241493,28.16926777000646,2142
0,9,6,21,10,2,48,1.0378320854725602,28.130261067929613,2134
32,2,6,17,9,5,71,1.0390489905168425,28.214111767968443,2121
9,9,6,9,11,1,45,0.8411762501811192,29.011315086906055,2113
8,7,5,6,13,4,43,0.8019184678716225,28.831844251928647,2100
5,9,0,3,14,4,35,0.8091236805353429,28.79565347776621,2091
10,23,7,12,19,4,75,0.924932573992914,28.13868531939119,2072
4,20,5,8,11,4,52,0.9554925129039642,28.017536203419695,2072
2,10,5,6,10,6,39,1.0169643908708152,27.842651849846888,2069
1,11,5,10,11,2,40,1.0755931521345088,27.758556695525204,2064
4,5,8,12,7,1,37,1.1400083282756983,27.937152612617904,2083
1,4,11,6,7,2,31,1.0354182076874274,27.90147948716773,2096
8,10,5,12,7,2,44,1.020910122806486,28.309793064505385,2098
4,9,7,16,5,5,46,1.0018922800310641,28.607518211984548,2110
6,10,2,10,20,2,50,1.0968971446695661,28.570643344160644,2124
2,20,5,5,17,7,56,1.059797462263156,28.973759200897284,2123
2,14,5,1,15,5,42,1.0244249891846373,29.03353180106946,2131
6,18,5,2,12,2,45,0.9957590604121732,29.444139908150596,2149
7,7,5,5,7,16,47,1.0254073874097331,28.909967341246748,2148
6,10,5,0,5,16,42,1.081175507098264,28.594404356132678,2165
4,11,6,0,6,11,38,0.945891857583568,28.69185623760651,2157
1,6,5,1,16,10,39,0.8911063921998023,29.18878476381701,2147
12,8,5,0,6,11,42,0.8961526330962892,28.396631026920254,2148
0,9,12,0,15,18,54,0.8973803203600748,28.493288438110245,2135
1,25,12,6,9,16,69,1.0076384024385687,28.52636313392701,2145
0,26,9,6,4,19,64,1.055763979879605,27.70115154630819,2137
0,20,7,6,0,13,46,1.124117519294846,27.298065234593405,2141
0,31,5,6,9,12,63,1.0243457053396259,27.483799316147483,2128
1,10,7,8,7,15,48,0.9583798521558247,28.130085824488877,2133
0,13,14,6,9,12,54,0.8078675471754483,27.939636107673078,2131
2,9,14,1,7,15,48,0.7937503440147279,28.285503157247394,2127
0,9,15,16,0,10,50,0.8907581561855564,27.687979047044493,2121
21,10,15,20,1,3,70,0.9785819345288923,27.372490289637273,2105
4,27,15,22,0,9,77,1.2208477336682702,26.52390012853742,2081
5,27,8,22,0,15,77,1.1533337398192303,26.730489850447302,2058
6,13,5,9,0,16,49,1.1448269280404675,26.304358633715673,2057
5,13,6,9,3,10,46,1.1040537974185014,26.401139106550847,2064
5,6,6,13,1,11,42,1.095171407880123,26.253965151386765,2070
5,5,7,14,8,10,49,1.1670757304299877,25.56901412439164,2082
5,15,5,14,12,10,61,1.2921122000396297,25.241574939400092,2078
6,9,6,7,8,4,40,1.3897944831352844,25.063009163898936,2091
1,7,9,6,12,2,37,1.287934070607445,25.99163860508313,2114
23,20,6,7,18,1,75,1.2703841494026509,26.328050268085626,2098
12,7,9,8,8,7,51,1.246192025198357,25.99844932708477,2107
9,10,10,5,6,6,46,1.3322075280158998,26.026198684479425,2127
11,8,10,5,23,4,61,1.3698068241916928,25.802473496127284,2133
10,5,4,4,20,6,49,1.2615906348384531,26.507698124335857,2151
10,8,5,4,3,10,40,1.2272332505560033,26.932049182064,2160
16,5,5,6,4,6,42,1.4120185269349055,25.189156526297875,2165
15,11,5,0,10,10,51,1.5861970359187534,24.38851463513502,2181
9,2,4,0,10,13,38,1.4992968366116672,25.22696248759915,2201
6,20,5,1,6,4,42,1.4179616875336212,25.54490031477825,2227
7,14,6,0,21,8,56,1.5312766707917684,25.660004501049986,2256
2,21,6,13,27,7,76,1.6275422327059643,25.72953658026308,2263
36,17,7,16,21,6,103,1.6222531640503728,25.461949045875244,2216
39,8,8,12,7,11,85,1.5453065798579024,25.80218519895497,2205
26,10,12,12,16,10,86,1.2976634136478704,27.190316103783708,2189
22,5,9,11,15,8,70,1.1639699015305256,29.272867103233132,2209
15,5,6,0,8,7,41,1.2624427503445061,28.222111555263247,2222
4,3,8,16,12,6,49,1.3629748739942489,27.773052602309548,2235
3,20,6,21,8,7,65,1.3816499145748231,27.482262702008793,2210
5,17,9,22,4,8,65,1.364512465229477,27.258378123173454,2194
2,19,11,20,3,7,62,1.3943895411137948,27.007940421491938,2171
1,19,10,21,0,7,58,1.2781682995277446,28.408918817888914,2156
4,15,12,20,13,6,70,1.2294126676577841,28.98959990698409,2163
8,13,10,9,19,8,67,1.2227135963767934,29.325935744439445,2172
5,12,11,8,21,8,65,1.1968728780280231,28.899791116816598,2177
9,10,9,10,14,6,58,1.1713423840065917,28.308060112304332,2183
8,10,5,12,6,2,43,1.039943315434058,28.21369409134174,2177
6,25,5,6,16,0,58,1.0498295127951163,27.675718667421233,2173
6,19,5,3,6,1,40,1.0790011739336705,28.523079424478322,2168
8,15,7,14,7,4,55,1.141578402794526,28.20545038506498,2176
4,4,6,8,8,7,37,1.1643927383303778,27.84407006849283,2186
10,9,7,4,7,7,44,1.158037081924063,27.750188760568527,2183
8,8,5,2,28,5,56,1.3103699125051929,27.45242108470107,2193
5,7,5,6,23,0,46,1.2184181254185436,27.589295470187,2188
8,9,7,7,10,6,47,1.1912906852898224,27.722050052508923,2194
6,9,5,10,7,5,42,1.1847610739646701,28.51584680397291,2219
7,22,8,12,9,4,62,1.0712235928345515,29.42035453279185,2231
7,8,7,5,5,5,37,1.0110623149980404,30.681589146913602,2274
7,13,9,1,8,6,44,0.9638729405129528,31.079519715219348,2299
28,10,5,6,18,3,70,1.0488888032267432,30.634590323562858,2300
19,5,3,2,22,4,55,0.9458548191651689,30.77218053988296,2306
1,7,11,2,20,4,45,0.925539972033363,31.001279660549255,2304
27,11,10,0,17,5,70,0.9891862645313071,30.630576453815372,2285
2,8,10,3,14,8,45,0.8727712223907363,31.126060781229516,2294
0,12,8,7,3,4,34,0.7774200161717219,31.584630844190777,2298
0,24,5,5,6,5,45,0.6742679748337276,32.230503862508705,2296
1,7,5,4,0,2,19,0.6621420893377477,32.83854100376711,2319
16,14,5,7,23,4,69,0.8167112429505102,32.08859337408189,2310
14,10,5,7,10,4,50,0.8512689382511497,32.298579226537754,2333
0,6,14,4,9,3,36,0.7516184070237765,32.635135365883954,2339
3,4,7,8,8,3,33,0.7833817623383659,32.72190599815197,2346
5,9,7,10,5,6,42,0.712705400893903,32.87607321111414,2354
5,7,12,5,1,5,35,0.7600880179593738,32.93306010960831,2376
1,9,11,4,4,6,35,0.6888497339788395,33.4316906991033,2380
1,23,6,7,1,6,44,0.6860382905726051,33.45434964758444,2388
2,7,3,7,16,4,39,0.6770588225103571,34.02586445647417,2397
11,19,1,6,6,6,49,0.638584879898315,33.861464368461064,2388
0,12,3,6,8,4,33,0.5712705188800845,34.21087612031942,2382
2,9,15,8,8,6,48,0.4701995937201527,34.16597387842989,2370
1,8,15,5,16,5,50,0.5946857030652274,33.77541982095942,2376
0,11,16,6,16,5,54,0.6118160833558552,33.50236230787779,2360
0,12,15,7,15,4,53,0.6792097553024091,32.76824335460232,2327
1,8,15,7,12,3,46,0.6299654997996078,32.682585099521404,2307
0,19,11,9,7,3,49,0.6646541585091008,32.924970340157586,2296
0,5,7,16,9,16,53,0.6666387603530176,32.425948735290746,2290
0,18,5,21,6,19,69,0.7815778548305439,31.476438677965202,2267
0,22,6,21,7,17,73,0.8435424273776767,30.920410923729676,2244
1,12,9,21,3,18,64,0.9367267987534623,29.926217534088554,2217
1,14,10,22,7,19,73,1.0663139675482796,29.277813079625325,2206
4,14,9,18,2,16,63,1.1564950735957298,28.186350277512624,2176
5,13,9,15,0,19,61,1.1431655239604592,27.967881482327833,2169
5,16,5,14,0,16,56,1.0792268324724175,28.263411437282087,2151
2,23,5,16,5,18,69,1.0001877716044798,28.11627211323706,2124
1,18,6,6,8,20,59,0.9980680807942839,27.993473741160603,2112
7,15,6,2,5,13,48,0.9016515505755118,28.222146105485006,2101
4,12,8,2,4,14,44,0.8904264805879655,28.114152592750333,2093
8,10,5,4,2,19,48,1.0461934500613514,26.603569591119324,2080
7,13,7,13,8,20,68,1.0956498306595779,26.73445807398186,2080
7,15,9,14,16,19,80,1.1905649053737253,26.399315752453187,2099
9,17,5,15,2,13,61,1.1310813940064246,26.32499553252341,2099
13,18,5,12,4,6,58,1.1353698315704566,26.47406394456458,2097
2,8,6,15,8,4,43,1.141098837937725,26.75062320730843,2109
6,8,5,14,9,12,54,1.1767604972801533,26.266056787336375,2103
3,7,5,16,8,12,51,1.1909603396105755,27.063552684058802,2126
7,8,7,13,7,7,49,1.012592822004701,27.781536963264557,2140
4,22,6,11,3,9,55,1.0702402857553581,26.9198104045298,2130
4,25,12,5,5,5,56,1.139110091907341,26.630350898290356,2139
7,17,9,5,12,4,54,1.2924136739889613,26.528766532856952,2149
6,9,6,4,2,5,32,1.2879106052196025,27.122538560361978,2169
9,7,3,4,0,7,30,1.1798845659882695,26.91717415536086,2175
12,5,4,8,3,8,40,1.0854155098295302,27.31842588265621,2185
0,11,5,0,8,10,34,1.0321299189312154,27.42546021602898,2213
11,10,5,1,6,8,41,1.122717276768907,27.368945563339008,2236
10,8,8,1,9,2,38,0.998290631064071,28.328303697004458,2270
10,21,6,5,8,5,55,1.0387522622899814,28.09688201310726,2266
7,11,5,1,7,5,36,1.1201711138316162,27.360370087271843,2275
8,16,5,4,23,5,61,1.2422605478619315,27.097359054229848,2264
6,7,5,5,10,8,41,1.4938878110254405,25.898928623522437,2289
6,7,13,7,2,8,43,1.519601147992966,25.87385817709718,2315
10,8,7,7,0,9,41,1.465569158486866,26.796608443854417,2352
8,12,7,6,4,9,46,1.4322731233416197,27.16344025818847,2384
1,3,12,6,4,9,35,1.2923304789681662,28.17506186889905,2421
13,2,10,1,9,9,44,1.2820653187064088,28.632419072370627,2431
8,17,13,14,11,8,71,1.3546384148365822,27.805394516473935,2435
10,12,13,11,7,9,62,1.2788965039133022,28.48679099630294,2427
11,18,10,9,4,8,60,1.226701684532786,28.982974184199527,2452
7,18,7,7,5,7,51,1.2380961592788482,29.489978598995055,2486
6,22,5,7,19,8,67,1.295260400619513,29.828752887131113,2494
12,13,5,8,9,7,54,1.1690827082872253,30.590037893400943,2520
11,8,5,10,5,8,47,1.1203173552214039,30.99119576337189,2524
8,9,5,12,7,7,48,1.0302314308173588,31.598471846334704,2527
0,9,5,14,13,7,48,0.9711520449106075,32.36670946740795,2524
3,22,6,15,9,5,60,0.960716049663103,32.64588620009113,2509
2,18,12,18,10,5,65,1.0064943641713922,32.963232833206476,2502
2,14,5,22,15,6,64,1.0675639524232639,32.19745583346103,2479
4,13,6,22,5,6,56,0.9060555195271273,32.738041027411874,2457
5,3,6,21,9,6,50,0.9850859147649974,32.1653368699063,2449
7,4,5,21,0,6,43,0.9829489324993088,32.25319292092217,2455
13,10,6,18,1,8,56,0.9565310723021303,31.38659550214534,2435
7,11,7,12,6,6,49,0.9976348493872442,31.215890367937323,2433
10,11,5,12,5,7,50,1.0314725043327728,30.52023212143375,2431
0,19,5,14,9,5,52,0.9882066333686512,30.542009436972844,2426
13,10,5,15,10,4,57,0.9748141844373417,30.748597089819942,2421
11,18,1,15,6,3,54,0.8665028740095692,30.953515226583065,2415
7,16,6,15,6,6,56,0.9901786489008388,30.517810930103494,2413
6,12,1,12,5,4,40,1.2006270630453937,29.17857309862633,2431
5,8,6,11,4,4,38,1.2563236280103842,29.37754328473663,2445
8,19,5,8,16,4,60,1.346564404702408,28.932007504773292,2447
10,7,5,8,3,6,39,1.325584924020726,29.392957055132175,2456
10,11,5,9,10,4,49,1.1405574572249981,30.520704323048598,2452
8,5,5,9,6,2,35,1.1136644312044317,30.924021231072416,2471
1,2,5,3,4,5,20,1.0374140270206171,31.397272735163575,2488
3,6,6,5,9,5,34,0.8910609378128499,32.01002496962914,2489
2,9,5,7,7,2,32,0.8727917121118195,32.71899724550683,2518
4,9,7,4,8,2,34,0.8881276527370666,33.31520403719239,2534
7,10,7,8,7,4,43,0.8539160704378136,34.57327136513027,2550
3,18,6,9,5,7,48,0.837638679342678,34.42089388506421,2566
5,9,6,6,9,4,39,0.8328958588700177,34.877223107983795,2581
5,19,2,7,1,3,37,0.751281630326364,35.683770041423124,2595
4,9,3,6,2,4,28,0.6650026691190448,36.88133602513739,2626
4,6,1,2,0,4,17,0.5993550608671645,37.492276667049275,2651
0,7,2,3,8,6,26,0.5412989557602074,38.0323561678398,2654
4,10,4,3,6,6,33,0.489475805090107,38.130872793356595,2667
2,11,7,1,2,5,28,0.49501708895135804,38.004109265262606,2683
2,9,5,1,0,4,21,0.53480032069861,38.332992798318045,2696
4,25,5,0,1,5,40,0.6667287704750827,37.63726281719255,2710
11,8,5,1,3,6,34,0.6321892159852773,37.30056919418715,2723
11,16,5,0,7,4,43,0.6888671562477721,37.11177903807158,2717
5,9,5,3,8,3,33,0.7336765814351758,36.67360966317253,2718
6,5,5,3,2,2,23,0.6972785376956302,36.579053512768105,2727
4,5,6,13,10,5,43,0.6734377175691668,36.972049802184,2736
1,11,5,8,7,2,34,0.6667893007120947,37.071180723680925,2738
10,6,7,6,12,0,41,0.7252833592897845,37.36412421539094,2765
8,8,3,4,6,3,32,0.7158092659977409,36.929819107011085,2763
3,10,0,11,5,3,32,0.6960526932761399,37.329571001205764,2775
4,4,0,9,16,5,38,0.5582844905210578,38.51850295152827,2781
1,11,0,6,7,5,30,0.489448078911082,39.48244249872588,2805
1,6,5,10,1,5,28,0.429425009550556,39.678167463434555,2804
0,6,5,10,1,6,28,0.47009601162678255,39.57386123862989,2815
0,7,5,17,8,3,40,0.5559416108594958,39.34811506991057,2821
1,9,7,20,4,1,42,0.5948254702136436,39.218884838693405,2817
0,8,7,22,7,3,47,0.7471803327560204,38.61930482095651,2806
9,8,6,22,4,2,51,0.7665790184525691,37.63496617438671,2779
2,9,5,19,6,4,45,0.7984748664894795,37.62773672833363,2769
0,1,5,12,0,18,36,0.7405363410729994,37.57869301949337,2766
0,17,5,13,0,18,53,0.764379852219505,36.8686315912682,2758
0,18,0,9,0,22,49,0.8395335758461934,35.829147274440054,2754
0,13,0,13,0,16,42,0.8230935300540948,35.462653112212756,2748
1,11,0,9,7,17,45,0.9196890862309982,35.09096023137737,2754
0,9,0,8,9,18,44,0.9452200618112611,34.79804789833287,2753
0,11,1,4,6,15,37,0.8845398632367888,35.5392060271755,2761
0,16,1,3,9,19,48,0.8459142105704505,35.90922055060898,2755
12,11,3,12,11,19,68,0.8099660034553392,36.60001789331464,2749
1,14,0,14,0,18,47,0.8052987822887943,36.54679824037183,2755
1,13,0,13,0,17,44,0.7212738696258153,37.59556839699249,2752
0,13,0,12,0,18,43,0.6915892530038974,37.70356691270846,2760
0,14,1,10,0,12,37,0.6434939948203938,37.865711840478006,2775
0,11,0,8,12,16,47,0.5615536696951912,38.502240420835506,2772
0,9,1,4,6,10,30,0.5236686909006701,39.34505842817428,2793
1,7,9,5,6,6,34,0.5248483195403564,39.88943807062109,2807
0,2,6,5,4,8,25,0.48967720507582324,39.95108359346117,2821
1,17,6,6,5,7,42,0.41201508102278284,40.69631588676206,2834
17,11,5,6,0,7,46,0.4287534421172315,41.09916187215079,2836
0,9,5,7,0,5,26,0.4132576626632818,41.353712116932535,2840
0,6,5,4,0,6,21,0.38782547009634843,41.369596086430334,2843
0,11,5,6,0,5,27,0.370035601891165,41.28648499962309,2840
0,9,0,3,10,7,29,0.4634562848606864,41.07875195606485,2846
0,7,1,4,10,4,26,0.4715940947125387,40.669385464339165,2868
0,10,1,3,10,5,29,0.49022619920932053,40.49531121975886,2884
0,11,0,3,6,4,24,0.44645538624105363,41.09077825061491,2894
1,14,1,8,5,6,35,0.43239358594796756,41.70552496539227,2908
0,7,0,0,0,5,12,0.5190289604903864,40.34146333459531,2928
11,6,0,2,0,6,25,0.5005706356016021,40.78853142826604,2934
0,8,0,5,0,4,17,0.5429378439514385,41.105993316295205,2966
0,9,0,7,0,1,17,0.5610229891917122,41.1836799586938,2979
0,9,0,5,11,6,31,0.5593162251574278,41.50652511801628,2993
0,7,1,4,7,3,22,0.5334414721359565,42.198687413784405,3014
0,7,7,5,4,2,25,0.5766904852632103,42.47589888060823,3041
0,2,0,13,4,5,24,0.5597407843976897,43.221179972598385,3056
0,10,5,0,8,1,24,0.5690590377148751,43.65421160021303,3070
0,4,6,0,0,8,18,0.5605677873242918,43.95901746445518,3077
0,8,6,0,0,8,22,0.4640819915002852,44.03792734310498,3068
17,7,5,12,0,8,49,0.46592465865482113,43.947837851358216,3049
0,7,6,13,0,8,34,0.4368841706006625,43.5351028623875,3049
0,5,5,14,6,7,37,0.41179789367942204,43.58651385502729,3030
0,16,1,16,8,10,51,0.4642518737435604,43.10645016397159,3020
0,10,3,14,6,10,43,0.5109115003528037,42.64792142960435,3020
0,10,2,11,6,8,37,0.5170642785656994,42.04093033438098,3011
1,12,1,14,6,9,43,0.5301912998532794,41.98567709490893,3000
1,10,1,12,0,7,31,0.46351519080218656,42.537367260273555,2994
0,10,0,13,0,8,31,0.44586794894159765,42.61130143604169,2986
0,4,0,11,0,2,17,0.3593002538980317,42.98296573723708,2972
8,7,0,12,0,3,30,0.36232713028969626,43.018993113159006,2954
0,3,1,10,6,4,24,0.411622230469178,42.44341477436139,2956
2,5,0,6,9,4,26,0.39433503220144955,42.66454203085704,2955
2,4,1,3,6,4,20,0.39251842276597865,42.972323494573025,2953
2,0,1,0,4,2,9,0.3751874174140649,42.99963787851448,2964
1,2,0,0,4,3,10,0.35703115182882317,43.16525639168519,2965
0,8,5,0,0,6,19,0.39630375713124444,43.0636728492395,2975
0,7,5,1,0,5,18,0.3410306431746235,43.213592068931625,2969
0,5,5,0,0,6,16,0.3679014756852195,43.070808028606976,2974
0,6,5,0,0,5,16,0.352831766844963,43.01149201381822,2966
4,6,5,0,10,2,27,0.37016444399174586,42.95453151046249,2960
2,2,6,0,7,3,20,0.40013710930690927,42.655655817761435,2958
2,4,8,0,9,6,29,0.42895980258490063,42.05780736178549,2957
3,8,1,0,8,3,23,0.5432056590971307,41.662546808875156,2978
2,5,1,0,7,2,17,0.5328270912778778,41.645727999987734,2982
2,1,0,11,0,4,18,0.5466819961475325,41.54810942563266,2982
1,2,1,14,0,6,24,0.5798463423291559,41.37306374352905,2978
0,8,0,15,0,3,26,0.5706490608425393,41.72573958562041,2976
0,5,0,2,0,4,11,0.5423851579806525,41.92243842125169,2991
0,5,0,2,6,4,17,0.5230598440679701,42.60594424056648,3005
2,4,0,5,7,5,23,0.48729596799035807,42.86659577400957,3017
2,5,2,3,6,4,22,0.4474017920277101,43.081808385283324,3020
4,4,1,4,4,3,20,0.40732220154886906,43.446601381450435,3026
2,6,0,0,5,5,18,0.33104999526981305,44.001089643090666,3027
0,2,0,0,0,8,10,0.2870206930674864,44.64914234808534,3041
0,8,0,0,0,3,11,0.2925510251278338,45.247536769103924,3060
0,5,15,0,0,5,25,0.3064000450313375,45.17579057842759,3053
1,3,15,1,0,5,25,0.3797482561738392,44.271594248458555,3049
4,6,16,0,9,3,38,0.39160790736916706,43.987166519404695,3033
2,2,15,0,6,6,31,0.4220289657338493,44.04142091193886,3034
12,4,15,0,7,0,38,0.4135795751176604,44.14255962579233,3030
6,2,8,0,7,3,26,0.43347088424926994,44.02695158736344,3040
5,1,8,0,7,3,24,0.43235316479957203,44.434305447978794,3039
5,1,7,0,2,6,21,0.4042402507941454,44.03047108526306,3042
7,4,5,0,0,4,20,0.41537701950900774,43.88557939160947,3047
5,2,5,11,1,5,29,0.3873212172227774,43.87440634719222,3031
6,2,5,14,0,3,30,0.3855223248350624,43.94075994549567,3030
6,1,9,4,10,8,38,0.4464957975771648,43.38996025203778,3026
6,3,8,1,8,3,29,0.49287248717524657,42.59744546832869,3028
4,2,7,0,6,4,23,0.6800887155532149,40.98136029131788,3035
3,2,1,0,7,5,18,0.6564724026862447,41.3465137164563,3048
4,2,6,0,5,1,18,0.6417764521946777,40.8754476244457,3064
21,1,5,0,15,2,44,0.7186402150851472,40.893909229584686,3065
2,2,5,0,18,5,32,0.6717459377222155,41.10169027295576,3064
1,2,6,0,12,4,25,0.7705046069131626,40.678454930842484,3070
0,1,1,0,14,4,20,0.7273226373548931,41.13709578966106,3065
0,4,11,0,14,5,34,0.7018022188974943,41.71417109924391,3071
5,2,8,0,18,2,35,0.6675808393073706,41.53058878334129,3067
5,2,9,0,0,3,19,0.6305536544814935,42.47338666866429,3087
5,1,11,0,0,4,21,0.5794799580395585,43.15525349462769,3099
7,1,10,0,0,4,22,0.5624899689194851,43.289386644506564,3142
3,2,8,4,1,3,21,0.5709373151685773,43.87354199242299,3159
5,2,5,0,15,4,31,0.5519928452390207,44.61985782591257,3183
4,1,5,1,18,2,31,0.4987052487921793,45.305324995005904,3202
40,3,5,0,15,3,66,0.639343904551894,44.489660203540026,3187
24,0,9,0,23,3,59,0.7000018337031134,44.11554338498234,3186
27,4,15,0,23,1,70,0.7330206992911611,43.32279954894931,3169
21,5,14,2,13,2,57,0.7192096880871185,43.256534768269105,3167
11,4,11,3,19,2,50,0.7773372540945024,42.665615891954275,3199
9,0,13,6,20,1,49,0.7992806802781507,43.077196823816706,3213
10,0,11,1,14,0,36,0.7285037652804888,43.143146175606816,3235
7,0,13,0,6,2,28,0.6245777981991418,44.6290045662891,3253
9,4,6,0,4,0,23,0.5519891338975393,45.402543868920084,3282
0,3,8,0,20,3,34,0.5293559523277622,45.62845350323939,3300
26,3,10,1,21,0,61,0.5811637434196844,45.9195333474561,3299
22,5,10,0,13,3,53,0.5239371904704904,46.02253714474727,3289
7,4,10,0,15,0,36,0.437949970174812,47.27571911544262,3283
5,4,10,0,19,0,38,0.47125903868810154,46.961352641602204,3281
3,13,10,9,4,2,41,0.4693340481546173,46.37060023138235,3272
0,14,11,0,3,2,30,0.43042573881998075,48.06318605182348,3276
0,11,7,0,0,1,19,0.43443346520992887,48.33654572679498,3291
7,14,6,0,17,4,48,0.49522142319540613,48.49148865294244,3295
13,15,9,0,15,5,57,0.5011075610702316,48.182122940741785,3283
11,14,5,0,8,8,46,0.5029296485588556,48.9714397200027,3278
17,14,8,2,12,9,62,0.5527031223183012,47.65000488543197,3275
8,12,5,13,17,5,60,0.6103423420106929,45.926863632162515,3252
4,13,9,21,14,7,68,0.6732582049787863,45.126088114912086,3230
6,13,3,21,10,5,58,0.7152445334933524,44.934118321166956,3218
8,14,9,16,8,7,62,0.7774996941634533,43.86340199572612,3197
7,9,11,14,8,5,54,0.7322545105900411,44.152493146144295,3179
8,8,10,8,2,8,44,0.6730868679587174,43.79008324783468,3173
4,11,10,11,0,5,41,0.6701433540075966,44.18254892863818,3172
3,23,11,9,0,5,51,0.7109965357721704,44.545992470407725,3186
7,20,10,0,0,8,45,0.7617275433335907,43.88654214788633,3175
4,9,10,2,5,7,37,0.7647434813923137,43.76890083315864,3183
2,7,9,3,17,8,46,0.7123758586267893,43.92704291448723,3189
3,8,6,4,20,7,48,0.6909705939786978,45.07402268515459,3194
0,7,8,8,9,18,50,0.5886132034082366,45.55037937022001,3198
1,8,2,13,7,20,51,0.5362276598353596,46.36959442119121,3223
0,9,1,4,5,19,38,0.6066486686121766,46.749194652654914,3243
0,13,1,4,3,20,41,0.5783848824461324,47.53485321210919,3257
0,22,6,9,1,15,53,0.6346619004940035,47.202501387732745,3258
0,32,5,9,5,14,65,0.6923214223801452,47.373189284005484,3255
1,25,5,6,4,6,47,0.6942639647560469,47.09530176589731,3271
0,22,5,9,7,9,52,0.6856207592183469,46.43051458008469,3266
6,24,5,5,7,10,57,0.638991449521497,47.32004004018466,3265
1,22,5,7,8,11,54,0.658626816627688,46.14469140968864,3282
9,19,5,4,6,9,52,0.6027686293262103,46.984404573813876,3318
0,18,5,0,7,18,48,0.6351000130077723,46.372762818644674,3348
0,20,5,17,6,18,66,0.698125625841365,46.53636481040246,3374
0,26,8,20,0,16,70,0.6315595651469355,46.831714888265495,3373
0,23,10,16,0,15,64,0.5996109844558485,46.82125969427871,3377
0,28,10,16,0,4,58,0.5839699538874658,46.84725452361142,3385
0,26,8,14,13,9,70,0.6186283266598085,47.259711827143114,3372
0,23,7,12,13,14,69,0.5854299137447768,47.38516323906407,3375
0,16,8,8,0,16,48,0.5369986964995375,47.87349759086427,3371
0,12,10,12,0,18,52,0.490161704929202,48.152686071191376,3359
23,12,10,11,0,14,70,0.522954002014493,47.657014441327625,3333
0,8,9,11,1,12,41,0.4616240970086932,48.32197403117666,3327
7,12,7,13,20,16,75,0.4671883194585899,48.25826454241423,3304
15,10,6,10,24,18,83,0.3925258970604532,48.79515462644605,3279
19,18,13,8,26,6,90,0.38782863072501716,48.12524973512955,3229
17,14,10,6,19,3,69,0.45944467295212704,47.27584341665611,3204
4,14,15,6,5,6,50,0.48687994300593673,47.36456237743006,3196
3,5,16,6,3,6,39,0.4776607275067726,47.37790702371439,3181
4,4,13,7,0,7,35,0.46250264824040715,46.87732001426434,3171
1,7,13,7,2,6,36,0.42707663528623874,47.2038746624977,3167
10,10,9,6,22,4,61,0.510587719443436,46.44344276287947,3152
17,10,8,6,25,2,68,0.48414441580954615,46.30928714908527,3126
21,6,5,6,15,5,58,0.47690434438058965,46.4572210390756,3115
9,10,3,5,12,6,45,0.4552810354354637,46.868103935156114,3118
5,13,5,18,3,6,50,0.518415706151392,46.039710132804515,3112
6,19,10,19,0,7,61,0.6249698122719833,45.08769588341282,3103
8,17,8,21,0,6,60,0.6644601175773419,44.823325371811585,3102
11,12,7,8,2,6,46,0.6412704998143025,44.36688899940053,3088
13,10,2,2,19,7,53,0.6428288720841625,44.17804425879312,3061
5,5,5,7,25,6,53,0.6297660100496637,43.770926074100664,3059
34,9,5,5,16,3,72,0.5777768374687545,43.35208680799344,3023
24,18,5,2,10,7,66,0.5751533918754501,43.422180809058936,2998
10,21,5,3,22,7,68,0.7404982327104677,42.00733213878569,2985
7,11,5,6,11,6,46,0.8039358927487915,41.62808246176768,2975
11,6,5,2,2,6,32,0.8527357397708086,40.80950890332158,2986
15,6,6,5,3,5,40,0.8598900556052685,40.508530994142745,2974
10,6,6,6,9,12,49,0.7511707795684802,41.43526981542893,2975
6,16,0,12,6,12,52,0.7546360866320567,41.451742311146816,2982
11,20,7,11,23,12,84,0.9441479828571038,40.42165091915021,2976
1,11,9,11,26,6,64,0.9565149588499443,40.18114862716231,2976
35,7,5,12,15,10,84,1.0404226394906202,39.237312305109995,2951
25,12,5,12,7,8,69,0.951300160194762,39.546588245943624,2923
10,8,9,9,18,6,60,1.0276853863143656,39.32141777429545,2931
13,9,9,7,6,4,48,1.0435697407091244,38.895729950891095,2922
11,9,6,12,6,4,48,1.0576362192053315,39.27319012069173,2942
11,13,6,12,6,7,55,1.0977476678264584,38.383552154417664,2951
7,21,8,8,10,11,65,1.089906444322076,38.35884089699277,2953
10,16,7,4,8,10,55,1.1020071901646986,38.3625499727848,2984
5,24,1,6,13,4,53,1.0876646426328058,39.034134399978825,2985
2,14,0,9,11,8,44,1.0643646008154064,39.59012801418708,3017
13,9,2,9,17,9,59,0.8995491134044465,41.09862157638175,2998
8,10,0,11,11,9,49,0.8106110761950213,42.50750885633276,3017
5,4,3,7,15,7,41,0.7260832809856523,42.639611054099646,3046
1,2,0,5,15,10,33,0.6466560025622821,43.64020861090743,3057
9,0,0,6,11,8,34,0.6484733299937023,43.98181880746686,3087
7,17,5,8,13,8,58,0.6906193231140164,43.23711323956608,3080
6,17,15,8,14,7,67,0.6865785518887109,43.77562089180403,3077
1,17,15,4,7,9,53,0.6840650947888766,43.69142777081492,3084
2,13,9,6,5,10,45,0.6445883889760398,44.855358683499574,3111
0,16,0,7,0,6,29,0.5838798513604407,45.0678472420904,3141
6,20,0,6,0,10,42,0.5030158614805262,45.503862833569286,3151
4,1,10,5,1,8,29,0.5516499896508068,45.064711524886334,3168
8,0,10,6,18,8,50,0.553530338007434,45.31620508995852,3169
6,0,11,17,17,8,59,0.6397733988031382,44.95332783369644,3167
6,17,10,20,7,9,69,0.6861909425149499,44.139313598881934,3155
7,16,10,20,7,8,68,0.7744022711444308,44.18408319545665,3160
5,15,10,14,5,8,57,0.7491752420017029,43.50877311012626,3141
8,17,11,11,8,9,64,0.728429826658802,43.174388032423636,3129
5,14,10,11,7,8,55,0.6532022992839555,44.103499489325415,3114
6,16,10,11,6,10,59,0.6260277403108818,44.659345522309586,3101
9,3,3,9,9,5,38,0.5500985449458196,45.16896177489719,3108
7,12,0,12,10,5,46,0.578054347779282,44.23567310536271,3117
12,11,0,12,15,4,54,0.5753465260672003,44.62801910768831,3114
10,20,0,7,4,4,45,0.6657436689717119,43.590053887930296,3125
10,22,10,14,2,4,62,0.6841003684607121,43.26284367127617,3122
8,18,7,10,1,2,46,0.6996964675914693,43.47017907376351,3131
11,21,5,11,12,4,64,0.7492814781236871,42.801609302986996,3117
11,7,5,13,12,6,54,0.8748372939473731,41.670881520209,3137
15,9,5,11,10,2,52,0.8589416616715261,41.94961426064797,3138
12,11,5,6,9,6,49,0.7903026820658375,42.15993630775887,3142
19,15,5,4,5,6,54,0.8799374129284323,42.073765094268126,3133
5,16,5,8,9,2,45,0.8509025839896673,43.89959681832879,3142
8,19,7,4,8,4,50,0.8037253205836683,43.05657635748093,3154
10,17,4,4,7,2,44,0.8420122298216196,42.45228136570643,3158
1,18,7,9,8,3,46,0.9009053824630664,41.03571093560723,3167
1,12,5,6,7,6,37,0.9342465856928751,41.6475158673226,3189
11,10,1,7,21,3,53,0.9177263157901048,40.86021467719823,3191
9,6,0,2,21,5,43,0.947553509743925,40.35823014841705,3216
12,15,0,8,18,3,56,0.8686539830575211,41.54077808025336,3228
7,8,5,9,18,0,47,0.8298299057102041,42.46742440861783,3246
13,9,5,5,26,1,59,0.757405899626117,42.95841896028474,3221
14,18,5,3,33,2,75,0.784041333386429,43.03181518008633,3226
32,17,5,0,18,6,78,0.8123066870171398,43.12261095695551,3225
29,14,10,5,12,4,74,0.7341717531220323,43.18863876025157,3217
8,7,0,5,11,1,32,0.6091666786224091,44.90805011536569,3227
10,0,0,5,10,5,30,0.6376675639518917,44.1708840956919,3226
8,4,2,7,20,5,46,0.7416775857973879,43.60542527008808,3243
10,7,0,5,18,4,44,0.7196085201777234,43.78095361166599,3245
10,12,0,6,12,17,57,0.7249873228885263,44.24527354074557,3250
6,13,0,5,7,21,52,0.6864692842690436,45.0986866909087,3261
7,20,0,6,19,21,73,0.7846062268140055,44.412348876674194,3260
3,31,5,6,21,20,86,0.7824812504283901,43.422666364265154,3225
33,22,5,12,15,20,107,0.8282948467282476,44.57765899901469,3207
19,23,5,13,13,17,90,0.826861518982438,44.23280998824916,3159
10,20,0,14,14,13,71,0.882581847401488,43.49036609207196,3134
10,13,0,16,13,14,66,0.7488595235683603,43.137940679055404,3112
12,15,0,11,18,14,70,0.817198990476905,43.603890006909374,3103
9,8,3,11,10,12,53,0.7927991167442499,43.69540119499796,3094
10,7,4,11,4,13,49,0.7293005856225973,43.13689840847849,3078
11,24,0,9,21,16,81,0.7678496575543698,43.08495931940145,3066
19,30,0,12,16,15,92,0.787521870967898,43.25077689247414,3020
0,26,0,11,8,13,58,0.898532319059847,42.62378321015654,3029
19,26,2,10,7,19,83,0.853819545139762,41.53168994619693,2994
11,16,0,12,20,17,76,0.8295179084805031,41.76077254345623,2971
12,17,0,9,5,16,59,0.7904010042972189,42.05587296500734,2961
14,16,0,15,9,18,72,0.7718553138021854,42.50827923135522,2959
12,23,0,13,9,12,69,0.8006626021348487,42.416621243667194,2960
7,16,5,8,12,12,60,0.7471873169690837,42.59611177683899,2948
9,7,5,8,18,12,59,0.8061505891585524,42.39798481019591,2945
20,6,5,9,13,4,57,0.7196729828103517,41.76634266008271,2923
9,7,0,5,8,9,38,0.6554221962327602,41.95422755526958,2919
0,6,0,5,9,7,27,0.6387239827435608,42.32123606674052,2911
17,0,0,5,15,9,46,0.7667852296107062,42.06233132660808,2933
6,0,2,4,14,11,37,0.7870153467554007,42.09926654448345,2949
9,17,5,7,4,8,50,0.7585846373801073,42.07847068163684,2948
8,20,5,8,4,8,53,0.7868819728434369,42.517088449205005,2966
9,18,0,7,8,9,51,0.7668401849942598,42.77226913304202,2976
8,15,0,2,9,8,42,0.8374555891436734,42.60610048515228,2984
7,15,0,3,19,10,54,0.7790124676253315,42.46982696704979,2987
15,16,5,1,9,7,53,0.6336787577488783,43.051285370451644,2979
5,3,5,2,10,8,33,0.6225105736853619,43.65653357690004,2991
0,0,0,4,12,9,25,0.5893232465533005,44.08717198411291,3008
16,6,0,6,21,5,54,0.6475101672476251,43.81421473266175,3009
2,22,0,5,13,8,50,0.6276299745961099,44.10207339477259,3027
1,24,4,6,4,5,44,0.6084131248004179,44.368042925054546,3035
1,20,1,6,2,7,37,0.560200959032154,44.89906679284245,3052
1,14,0,7,8,6,36,0.5701708377878921,44.894063401306866,3066
4,12,0,5,8,5,34,0.5091753692652249,45.21617523376624,3061
5,7,0,7,9,2,30,0.44063133987469444,45.40162216981146,3068
4,11,1,5,6,4,31,0.3882962470187438,45.84451118400166,3055
3,14,0,7,8,3,35,0.4436264527592159,45.87617612318576,3067
1,13,0,11,4,5,34,0.42261644328952463,46.03337440588671,3050
4,19,0,13,0,4,40,0.514257541625911,45.265690017773125,3053
2,16,0,15,3,6,42,0.5562373863186671,45.34512836561775,3044
4,5,4,13,14,4,44,0.6044736351043202,44.76499653212523,3031
9,2,1,14,8,2,36,0.5573020414628288,44.80289693994396,3023
1,3,0,12,7,4,27,0.4899407793099142,44.73955048907424,3004
6,13,0,9,7,2,37,0.4441295447359618,45.24064958463654,2998
0,9,2,10,7,1,29,0.40503484209808105,45.21117937621499,3002
0,8,0,9,0,4,21,0.39222470256580366,45.36271677543808,2992
0,14,2,11,0,2,29,0.34639957781071024,45.53480882243568,2978
0,17,3,9,0,1,30,0.39629505865092274,45.73742342738892,2979
3,17,2,10,12,2,46,0.4942999813397118,45.45990251588389,2975
7,15,4,10,7,3,46,0.5060389590390132,45.138279494949685,2958
0,4,6,12,5,3,30,0.5163053320584974,44.94777160389377,2961
0,6,3,8,5,4,26,0.4616872349719109,45.520352194542156,2970
6,5,0,10,11,4,36,0.4206660233857026,45.477390312840676,2967
2,15,0,8,10,4,39,0.47923269760734805,45.19376032869348,2974
2,19,0,8,4,2,35,0.5070725186848231,44.882752930632755,2971
2,10,7,11,5,0,35,0.4688524188404625,44.774255822693135,2960
2,3,5,14,5,3,32,0.5006334300966829,44.45391125342216,2964
0,3,1,11,0,1,16,0.4385417019014606,45.170660121881745,2959
3,4,0,3,0,3,13,0.3756386593549504,46.13109888028496,2982
0,7,0,6,0,4,17,0.33881337111404486,44.841803381259226,2993
1,11,5,2,0,5,24,0.36377060774902087,46.42302286260785,3008
1,8,1,3,7,4,24,0.3452249737029976,46.22420857245397,3015
0,17,0,3,5,5,30,0.3939054429829222,46.14111891992747,3033
0,18,0,1,6,5,30,0.43813704482187055,46.06463441930553,3041
1,18,0,7,8,3,37,0.4788720120372674,45.76549079833525,3043
0,10,5,1,5,7,28,0.44435498825884995,46.341351557268936,3057
1,7,5,0,1,2,16,0.3594334773101386,46.714863996423475,3062
0,3,0,0,0,5,8,0.3564291211507422,45.37171404459644,3080
11,11,0,7,0,4,33,0.32560556563514426,45.169461448426944,3070
0,8,0,7,0,4,19,0.3336432514009506,45.203809391770356,3076
0,10,5,5,7,4,31,0.4304254125693175,44.755767051531095,3078
0,18,0,6,12,6,42,0.4682613635275895,44.24918899058382,3067
2,19,1,5,6,2,35,0.4631636830664155,44.585144280271365,3072
0,14,0,2,8,3,27,0.46787486566951186,44.418398567740375,3063
0,4,0,1,0,7,12,0.3829802957122546,45.28488435334394,3075
0,5,4,10,0,3,22,0.32652642820517214,46.73358238079496,3067
0,4,5,10,0,4,23,0.293808248976632,46.134431041219365,3064
0,7,5,8,0,4,24,0.27880937136651757,47.072622326719625,3063
10,15,5,10,0,2,42,0.3523227221521041,46.67499712395654,3047
0,17,0,15,0,5,37,0.45035884120441383,46.237206317017574,3047
0,9,1,16,0,3,29,0.45355316241677396,45.343454025397264,3034
1,5,3,19,0,3,31,0.4141525199112172,45.69865335457545,3032
0,5,2,15,0,2,24,0.3745199631149802,44.62586045573184,3014
0,4,0,11,2,3,20,0.4331362449933272,44.13889187417933,3015
0,16,0,6,0,3,25,0.5059979098464631,43.44519327224487,3014
0,8,1,7,0,5,21,0.532474231221562,43.26129296466122,3017
0,6,7,6,0,4,23,0.5063879321792503,43.45129688057848,3019
0,4,5,7,0,5,21,0.44611820339190383,44.87577527431211,3015
1,6,1,6,8,7,29,0.38989382366287967,44.29857891647606,3012
1,7,4,7,9,2,30,0.3707809993444039,43.89644092208761,3005
1,9,7,6,8,2,33,0.3901963423797081,44.28460947756363,3017
2,3,7,4,6,6,28,0.3717319413927592,44.94917622006156,3009
2,7,7,4,11,5,36,0.5181689739142709,43.17989630340834,3023
1,5,7,2,0,4,19,0.49558149453001676,43.334452947739535,3031
0,4,7,2,0,8,21,0.45158276623340027,43.57279952001974,3037
