throughput_KLONGTEI,throughput_KASEMRAT,throughput_NARANONG,throughput_SUNLAKAKHON,throughput_RAMA4, throughput_ATTHAKAVI_RAMA4,throughput,mean_speed,jamlength_percent,Backlog
0,0,0,0,0,0,0,9.904311108768514,0.0,12
0,0,0,0,0,0,0,9.510618986914455,0.01033450002829683,29
0,0,0,0,0,0,0,10.022759566896088,0.025972844830059516,47
0,0,0,0,0,0,0,9.870536560620804,0.025972844830059516,74
1,0,0,1,0,0,2,10.333945156036938,0.08519748163136198,102
1,2,2,0,1,1,7,9.692544718728476,0.1610700015374209,136
0,5,0,0,1,1,7,9.59040697712632,0.21950449024332105,151
1,3,2,9,0,1,16,9.781123340995398,0.22396879390330995,183
1,4,1,0,1,2,9,9.565911879737097,0.3048554958352322,215
4,7,1,1,2,2,17,9.609625254065127,0.3680565639198997,243
5,5,1,2,3,7,23,9.189191544933953,0.5175431478361121,276
5,9,0,4,3,6,27,8.801754790284336,0.6614450677980692,295
2,18,2,3,4,5,34,8.091185174206931,0.7841682703197494,329
18,10,1,0,2,5,36,8.058923419855786,0.9231542675832608,344
8,13,0,2,9,6,38,7.6906583991621265,1.2702216059362201,367
6,6,0,17,3,4,36,7.2251683175567365,1.4735316566947083,383
8,10,8,6,9,4,45,6.976430203527641,1.6296321900755324,393
7,13,3,3,5,7,38,6.913962118930531,1.86907877695987,411
7,10,1,3,5,10,36,6.385114760790056,2.1514412787870896,429
11,11,4,5,6,8,45,5.762254530778522,2.5890359297851004,431
8,8,10,14,12,1,53,5.936731849637194,2.3015304652445128,438
8,4,7,11,4,8,42,6.443676126846525,2.134033213535294,475
5,5,12,2,4,7,35,5.954884994084839,2.634501668342636,505
4,6,8,2,5,3,28,5.596015419233568,3.0979506061065982,528
8,7,14,17,10,6,62,5.865770536502213,3.1931292794688964,541
5,10,10,7,11,7,50,5.466727797367209,3.6103062857194446,546
9,10,5,1,3,6,34,5.115366369841638,3.9292957596883924,568
10,10,6,3,4,2,35,4.933409772570178,4.25002240383219,589
7,6,9,9,21,5,57,5.1625355625,3.7004760845418887,594
13,5,11,7,27,12,75,5.37818626318537,3.679036419320554,608
8,24,5,2,22,8,69,5.370243883911851,3.644067460353758,629
9,19,8,1,5,5,47,5.028423092596481,4.413532172641768,657
10,8,7,16,3,10,54,5.191666428464085,4.486164411887822,662
11,9,6,11,18,13,68,5.132541059855737,4.437808866066407,663
9,17,6,12,15,14,73,4.573462480019267,4.919067307624814,655
9,15,8,6,9,14,61,4.450883731574257,5.322215620237299,677
12,12,10,4,7,13,58,4.400370102953078,5.554526665400758,694
35,9,10,4,6,9,73,4.4415510253685255,5.321330820343749,693
15,8,12,5,4,13,57,4.382531589787874,5.266175514756457,685
6,9,12,4,9,7,47,3.9622789548373665,5.6287488442581814,689
11,8,8,14,14,10,65,3.806026452082301,5.783668225119468,683
19,8,6,17,7,8,65,3.69913274659943,5.866303764383336,688
10,5,4,12,10,6,47,3.7483621874524933,5.86456288678036,707
5,5,6,5,9,8,38,3.687412504409329,6.406841263583429,740
6,10,17,17,6,1,57,3.9825063661979847,5.927145976157587,768
17,13,14,15,5,7,71,4.1832490895910555,5.864068584890627,774
10,12,11,2,17,7,59,4.334977678430476,5.795839576936982,775
2,12,10,2,14,7,47,4.304922151515448,6.1140063287941855,798
2,10,10,12,7,5,46,4.042921444571974,6.4473800175976015,787
1,10,7,9,4,8,39,3.7070556952589184,7.031728074291457,796
8,10,6,7,23,9,63,3.578972592708266,7.1837296913884945,794
8,7,8,4,26,8,61,3.6677843856724004,7.165380443633873,802
19,10,6,18,25,10,88,3.354426999361439,7.581657560454425,813
12,2,5,4,16,4,43,3.314266131708064,7.812525005911745,847
11,22,8,2,24,9,76,3.6829129547858868,7.197623935457127,842
28,28,8,3,16,7,90,3.8418936726950963,7.075709845501039,832
9,30,15,15,10,11,90,3.7078355880388143,7.062180026542878,817
9,22,12,15,5,12,75,3.983241770155274,6.947794284957753,835
8,12,12,16,5,11,64,3.5920333175517354,7.5308720689743085,847
10,22,7,4,4,12,59,3.430302985926577,7.762623418537698,866
11,23,6,2,6,14,62,3.4322143945498134,7.785178884540749,864
9,16,6,7,7,12,57,3.1988811779007733,8.375787583845817,878
8,9,5,16,5,7,50,3.3092190987586805,8.575388260316783,902
6,10,7,17,3,7,50,3.2545913724287474,9.109156409104903,931
5,9,8,1,14,8,45,3.200552986653217,9.404801793574395,957
6,12,7,5,12,7,49,3.008223992965162,9.631651926163954,969
29,6,5,3,12,9,64,3.042973772407982,9.64052194612083,991
29,7,14,1,11,5,67,2.7172885678839553,9.937937477652644,976
3,8,15,2,8,8,44,2.536390136432044,10.219833654139064,999
19,6,15,0,7,9,56,2.50048850326317,10.61281010725469,1013
11,8,14,18,7,5,63,2.370000528064235,10.686585746947078,1009
6,7,5,23,11,4,56,2.3777547397107552,10.660186124959909,1012
4,17,5,21,5,6,58,2.6551321875486904,10.195484201323634,1025
6,23,6,9,4,5,53,2.5557097328196163,10.650418898687304,1047
7,13,11,12,4,6,53,2.577638935060566,10.714350961213281,1070
5,12,10,13,6,5,51,3.011515347157117,10.481801877385614,1094
5,13,7,13,4,5,47,3.0264720926359847,10.601947337525388,1108
3,12,7,14,6,6,48,3.001721252222053,10.868276557183655,1133
7,11,5,8,7,5,43,2.8258887443569463,11.19584850676237,1140
8,7,4,3,9,6,37,2.672150696684039,11.991859461615356,1160
11,8,5,12,7,6,49,2.5504678739568107,12.362554902849249,1172
8,10,3,13,9,8,51,2.5689224139733553,12.754406142711986,1184
1,13,3,5,10,5,37,2.4867549936869136,13.134845396489728,1211
13,10,4,7,7,5,46,2.330414699566715,13.368217112158893,1208
4,7,12,9,18,6,56,2.304683850833965,13.461747048660284,1205
2,8,11,15,11,8,55,2.1289412394096425,13.296516170554494,1196
1,5,11,16,7,9,49,2.015815829784996,13.796670328737267,1194
0,5,11,9,2,9,36,1.710826371284414,14.315490821193368,1199
0,2,10,7,10,8,37,1.7110866437696828,14.502367484213009,1222
0,23,8,9,13,6,59,1.711242671418198,14.186640331893825,1202
0,31,7,3,8,5,54,1.9518461966062284,13.786726654715293,1199
0,33,5,17,9,2,66,2.110860537730449,13.786582040472355,1197
1,21,9,18,7,8,64,2.155198208849154,13.726319977505606,1196
1,11,6,22,6,6,52,2.200637159675604,13.53192445482226,1189
2,10,5,16,22,6,61,2.176887564098497,13.53741184906939,1194
8,5,5,15,24,6,63,2.5173036872421792,12.544144859305247,1205
12,8,5,16,25,3,69,2.513514001767388,12.904820819267181,1221
7,6,5,16,8,0,42,2.5867312349648217,13.39362610615805,1241
14,4,9,15,26,1,69,2.762842344205706,13.029707880319863,1261
14,6,11,5,30,0,66,2.517261521122196,13.27656698980305,1264
13,2,6,17,26,0,64,2.489596710305027,13.391589220233655,1283
15,4,7,17,17,0,60,2.462057366294186,14.093316287179816,1307
33,18,14,4,15,0,84,2.5246982884463054,13.330835309612265,1313
32,19,15,2,11,0,79,2.7298449146955805,12.561318071420997,1317
31,16,13,2,12,11,85,2.649418471503435,12.70681840320795,1298
6,18,14,6,9,20,73,2.5811327003556945,12.490307438935499,1286
9,10,14,3,20,21,77,2.5279287673831647,12.926691751151905,1294
11,10,6,2,13,18,60,2.4093042318862095,13.813370839212096,1325
8,11,9,0,10,15,53,2.095191433648891,14.632175191103961,1327
6,10,5,17,3,14,55,2.1000402216103287,14.587284225797845,1342
5,14,6,19,16,12,72,2.0961958982049644,14.714304700376804,1335
3,10,5,22,9,14,63,1.7839237677891298,15.02275103429952,1330
24,8,5,20,5,9,71,1.6152942123791234,16.22262501108835,1329
3,3,5,12,8,8,39,1.4628123505655313,16.67897075089073,1344
7,24,6,2,11,1,51,1.6880946493921665,15.951181744780486,1354
9,23,6,14,12,1,65,1.8896580939310916,15.187424535344327,1352
10,18,8,14,6,4,60,2.112030238390348,14.488543354650416,1366
12,16,6,12,7,7,60,2.305708032068562,13.930375659538281,1364
8,19,5,15,22,9,78,2.3966733586885796,14.004301352672964,1360
4,15,5,13,23,7,67,2.2907541322772262,14.36273526103639,1357
12,13,15,9,8,9,66,2.3160672934570643,14.46226698063131,1388
12,17,12,16,6,9,72,2.4919810048088333,13.766442339484971,1380
12,23,12,17,10,11,85,2.4304518883771054,14.11165829371452,1392
10,20,15,2,8,6,61,2.4494334377206544,14.244878587715178,1418
10,19,6,0,9,7,51,2.1836577007948934,15.340904516973557,1459
1,15,8,2,5,6,37,2.125219144766377,15.828305547684161,1473
27,17,5,4,17,10,80,2.307427452937757,15.768591572648237,1485
8,10,5,12,14,9,58,2.227040451054913,15.651724692306988,1485
10,11,5,6,2,9,43,2.227418874306715,15.623499242074793,1493
9,13,5,9,8,5,49,1.8765343212866354,16.19993459819207,1480
12,12,5,2,9,6,46,1.8370604194570637,16.49833893040826,1485
12,8,7,16,4,6,53,1.8717270823311467,16.278070096245102,1483
10,4,8,21,9,7,59,1.9810433861618637,16.12195359039384,1488
13,9,5,20,9,7,63,2.1485278977903537,15.176567889010022,1470
15,12,7,18,16,6,74,2.136204228803895,15.327446990455485,1476
14,8,6,13,21,5,67,1.9204293309359568,16.15231759237771,1461
16,10,5,15,17,5,68,1.918096409310684,16.426812967994064,1489
13,7,11,14,15,6,66,2.000395462432923,16.734919300410432,1509
14,10,14,9,8,5,60,2.0372930154370406,16.74889095373644,1515
1,9,12,5,6,5,38,1.740120946675789,17.621685971520446,1534
19,10,12,17,7,5,70,1.7754354695444157,17.751231840486412,1531
11,11,11,9,5,5,52,1.7850886831701023,18.48910358318043,1550
12,23,12,3,4,4,58,1.7667862817917561,18.366081421868536,1559
11,26,12,1,8,6,64,1.8572492980719937,17.899882112939526,1561
9,29,3,9,6,5,61,1.891532836726424,18.062970124525236,1562
10,31,5,7,8,5,66,1.774423935951172,17.89554897311296,1556
13,25,5,0,8,5,56,1.6341013117200962,18.57538728651973,1565
14,8,5,1,2,5,35,1.4765134853905946,19.646181807029887,1581
1,5,6,17,6,4,39,1.4438610330888138,19.28239769347298,1580
1,5,6,6,8,1,27,1.3744868724373034,19.554983438875,1600
1,4,5,4,16,0,30,1.2976082546114236,20.094231901329255,1601
3,3,5,2,10,2,25,1.3675117104967434,20.20534812774445,1613
4,5,5,2,11,2,29,1.3038892275940104,20.510281843672047,1612
0,4,5,11,14,2,36,1.4071343768977784,20.154585785320645,1630
3,4,16,14,17,3,57,1.633275059800791,19.628280315330965,1626
2,16,13,14,3,4,52,1.6946507591895115,19.234722493465494,1629
9,16,15,8,24,5,77,1.7542964688510259,19.655739893319737,1642
8,19,15,4,23,7,76,1.7667802909614936,19.28778980161824,1635
17,17,11,17,20,8,90,1.7566903515009746,19.365611369837808,1650
15,12,11,19,16,4,77,1.658338608019244,20.080928233933157,1661
9,5,10,3,10,21,58,1.646690001662605,19.85900305971954,1676
12,12,10,2,7,14,57,1.652962364022621,19.79122484093182,1680
9,10,7,8,10,15,59,1.6089246840755804,20.028964976824163,1682
12,6,11,6,7,20,62,1.4893121571468788,20.093832415388263,1687
16,7,13,2,5,18,61,1.5177430374178624,19.929225422178604,1685
8,10,12,1,2,18,51,1.5710161944785994,19.923916438953462,1691
12,7,8,18,1,18,64,1.6757605175015344,19.707047114670758,1687
0,13,13,21,4,10,61,1.613399399838511,19.378281372885123,1673
14,6,16,21,31,9,97,1.8905169971103772,18.98531074928323,1664
15,23,15,19,30,7,109,1.8733476941878366,18.583399420056544,1638
12,27,15,14,26,5,99,2.000027681316915,17.76097805719682,1633
15,25,15,13,24,14,106,2.1787294838157045,18.22691080701451,1631
27,31,15,3,12,13,101,2.1888320139754858,17.83680395797008,1596
32,14,15,8,11,18,98,2.16803956138517,17.452673277282127,1583
31,16,13,3,23,16,102,2.098160589385851,17.722941292530024,1565
24,14,9,17,21,16,101,2.0971415246817657,17.659050858199656,1544
18,21,10,10,14,12,85,2.117335173452158,17.605923908302664,1535
13,25,6,1,12,15,72,2.1382407048227154,17.477737557132194,1530
8,24,0,5,16,11,64,2.235891533058147,17.514698695307313,1526
15,22,1,16,4,15,73,2.0445215543459185,17.497749602819052,1511
7,15,5,9,4,17,57,1.762585956751135,18.08907600139285,1513
2,7,5,9,1,14,38,1.6522836651454733,18.18770114214106,1520
7,8,5,5,0,15,40,1.4391451745746262,19.22806315532604,1529
6,8,5,7,0,9,35,1.3300151826433677,19.750936777312997,1537
0,8,5,19,0,13,45,1.2188436017083335,20.409731222054237,1551
1,3,6,21,0,10,41,1.1406434010871203,20.26531291813678,1547
0,5,5,11,0,1,22,1.0465491281195027,20.738391015910313,1555
0,4,5,4,4,4,21,1.092949995007698,21.0262287014795,1580
3,4,7,12,6,6,38,1.2755811603505889,20.055741625371944,1593
4,17,5,15,6,5,52,1.4428164260595615,19.51108399706419,1614
5,17,6,12,4,5,49,1.4796887259872242,19.536869771971368,1618
3,12,2,12,8,4,41,1.4846053913728194,19.735915486647137,1634
2,7,4,15,14,6,48,1.4206114794152038,19.735863490628837,1639
1,14,5,16,12,7,55,1.3556613673655202,20.147461742670195,1637
1,13,6,1,13,5,39,1.3724831297265976,19.92384868149364,1648
0,14,5,3,16,6,44,1.4123128887505842,20.67737704739513,1661
1,12,5,5,5,7,35,1.368601891823034,20.801713278802072,1676
6,11,6,9,23,5,60,1.6487230236483321,20.127802092308034,1704
5,9,6,0,24,6,50,1.7254770591051067,20.081891103576204,1701
12,8,6,2,22,6,56,1.7026690649775487,20.11826949622624,1724
10,11,6,0,16,7,50,1.6992208337821018,21.000836939049385,1752
13,6,5,16,18,12,70,1.696377753402603,20.493589740351446,1751
14,7,5,21,18,17,82,1.7485557800113125,20.31722442639764,1739
13,6,5,22,23,12,81,1.6832570012708787,20.7370446070262,1739
9,2,5,9,18,10,53,1.480426852926211,21.419412416297845,1757
5,3,5,16,8,9,46,1.3694713176509565,21.70536388578801,1769
6,26,5,16,7,6,66,1.504530589305452,20.68457351978036,1774
6,28,5,16,3,4,62,1.7018412123231828,20.484381506510754,1782
5,32,5,10,2,4,58,1.8438780623421187,20.56876381937514,1808
5,28,5,4,22,13,77,1.7153033269998992,20.747309385567036,1792
38,13,5,14,11,16,97,1.6229105387751201,20.93932239386255,1770
41,15,5,6,17,10,94,1.5855575576893202,21.067023937732607,1765
34,17,5,0,14,8,78,1.3903090837270078,21.314021015583158,1752
12,14,9,0,24,7,66,1.5015464676398405,21.13652885803541,1759
14,10,14,3,28,5,74,1.6361675920712646,20.26612316150204,1755
17,12,15,9,12,5,70,1.6352619778277016,20.437469711128653,1776
14,2,13,6,11,6,52,1.6635764356482874,20.969697477142518,1788
7,7,13,3,19,10,59,1.6396715582145147,20.853954378003493,1791
21,8,14,3,8,10,64,1.4417235839682443,21.388716360197545,1785
9,21,10,1,7,8,56,1.4338322591400317,21.343046467519343,1797
8,21,10,17,7,8,71,1.4859573972983606,20.995615732637784,1789
9,19,11,13,10,14,76,1.5010862745740299,21.34932424652529,1796
9,15,11,9,11,10,65,1.4067022875305666,21.61507903334157,1794
0,12,11,10,11,5,49,1.3437148981347602,22.00253683594053,1799
21,8,12,13,11,6,71,1.2596195586699586,22.043294219915573,1776
10,20,10,13,12,7,72,1.1768439832159152,22.234258429973952,1769
9,15,11,7,12,6,60,1.2064426684735357,22.285228340908937,1771
5,5,15,6,5,6,42,1.1600083853721925,22.383362420209505,1764
6,5,15,5,23,6,60,1.2752916802903818,21.683826104737093,1761
7,4,6,15,26,6,64,1.514707236651634,21.444822155912366,1785
12,8,5,12,9,5,51,1.7007886633910203,21.343635809657417,1816
13,9,5,9,4,6,46,1.6743564846434,21.578262808543624,1835
11,11,5,12,6,12,57,1.5597517884082772,21.95435084977224,1836
8,12,5,13,15,16,69,1.6095369128732804,21.948092835886147,1850
18,13,5,14,8,14,72,1.4903993890464202,22.568519225722987,1848
13,15,5,7,6,15,61,1.2510235948045685,23.1269343900025,1851
7,16,5,4,8,10,50,1.2163573507395218,23.805155109984156,1871
2,10,5,8,20,8,53,1.3253943857169181,23.61217988454301,1878
9,12,6,13,28,6,74,1.4088662729536265,23.727396223778953,1891
8,21,5,10,7,3,54,1.48039712753359,23.528005831812997,1904
16,26,5,5,5,3,60,1.54499908995645,23.12537758941822,1891
7,31,5,15,25,12,95,1.5022269453873824,22.94401241049043,1863
23,27,5,12,11,10,88,1.1524862507977727,23.760183279593125,1834
8,8,10,5,9,13,53,1.0337373565985346,23.76937388584534,1827
6,8,10,0,5,15,44,1.023674683092875,24.308271987749286,1843
8,8,7,18,11,15,67,1.1079720296789732,23.957928991772757,1847
8,10,6,21,7,8,60,1.177088988196529,23.69693300345736,1851
4,13,7,15,10,2,51,1.09158904971656,24.156949200408494,1836
6,11,10,7,6,5,45,1.1613457855824805,23.77845019663151,1850
10,12,3,13,16,5,59,1.2151311101625846,24.024847897449295,1866
7,7,7,13,22,5,61,1.3716673473970078,23.379810325182856,1896
6,1,3,14,8,6,38,1.400468257716443,23.87164782844227,1934
11,5,4,9,10,7,46,1.352396976902446,23.510714872294646,1938
6,2,5,9,4,9,35,1.3578911022642413,23.3766570290739,1952
6,2,5,4,8,6,31,1.3512781656226478,24.050091536136076,1964
9,17,5,2,11,2,46,1.2971193631770936,24.4686177480905,1984
5,22,11,0,5,1,44,1.3631866087293287,23.72404513287801,1976
6,26,9,13,19,6,79,1.3614634345117067,23.73632118857145,1980
7,25,2,1,5,8,48,1.2999452806361498,24.455509551912243,1990
10,20,3,0,5,8,46,1.1676558813493212,25.015112040625816,1989
10,8,2,0,4,10,34,1.1304680105088452,25.47285734975964,2016
6,11,1,11,8,10,47,1.0790976178667697,25.84229341817214,2032
11,12,6,15,5,7,56,1.1618355709386186,25.2056728646983,2021
12,10,6,13,5,10,56,1.1583803819969485,24.925757001471034,2027
9,12,5,10,6,9,51,1.1510244690531664,25.041443769236103,2035
6,9,5,10,19,8,57,1.281039755339143,25.087434529276226,2029
23,9,5,11,6,6,60,1.2446213182029109,25.065990596601733,2009
9,21,6,10,15,5,66,1.3081123050699397,24.373911546326525,2007
12,15,4,8,8,5,52,1.3512848945709446,24.26282586519959,2012
10,17,5,8,7,5,52,1.4088848742512958,24.238605797896003,2018
11,23,6,3,6,6,55,1.4831727545052078,24.785864249604735,2040
13,19,5,2,7,5,51,1.5784888324062436,23.88751889617425,2045
14,19,7,2,7,6,55,1.6019636363263159,24.494648653992126,2064
11,20,11,0,6,5,53,1.454964397620406,25.387688033035253,2076
12,17,10,0,4,5,48,1.3207997223969157,25.543036014273593,2086
10,8,13,0,4,5,40,1.284986638935276,25.744507359204874,2104
12,8,10,0,6,5,41,1.254254764746589,26.353241251029058,2127
3,10,10,0,8,5,36,1.135403587989718,26.33160280222172,2139
5,3,9,0,4,5,26,1.131793731662641,26.892989295647112,2156
7,5,6,0,4,6,28,1.1032074829371012,26.79433220683641,2172
29,17,5,3,17,7,78,1.1700186522940634,26.16424899142633,2147
14,15,6,0,14,5,54,1.1436636332794141,26.247049215229776,2132
5,13,11,0,16,5,50,1.1479766058702467,26.262370727806065,2136
0,8,11,0,12,5,36,1.0852469157114586,27.220014657958284,2154
0,14,11,11,7,6,49,1.2735089747373425,25.594763790369143,2161
1,13,6,17,8,5,50,1.3441146542022522,25.767527522102096,2190
2,6,9,13,9,6,45,1.3262399005545464,26.505635115183388,2184
2,8,8,5,20,5,48,1.361678481058136,26.725534121682653,2209
5,7,8,7,18,5,50,1.366739628040535,26.820904024771078,2218
11,6,11,3,23,6,60,1.3350458121134112,27.51134169137942,2232
13,13,8,0,16,16,66,1.2904590346518194,26.76133661137585,2229
13,10,8,0,10,15,56,1.1936185478122274,27.465786000597436,2262
9,10,7,0,23,12,61,1.1841858841990758,27.645441149502954,2274
8,8,6,9,27,12,70,1.2120325930991778,27.22613570551224,2272
29,8,6,0,24,13,80,1.1813223492080474,27.90725404420735,2276
7,9,7,0,9,12,44,1.11015257448691,28.6133834367437,2276
27,10,6,0,7,9,59,1.0216138379050963,29.450705489708938,2279
30,20,15,0,4,8,77,1.1101666053564974,30.211954398897582,2266
5,19,16,0,9,7,56,1.118517900312688,30.603534312622408,2264
8,21,15,0,17,12,73,1.1858026183204118,31.95208549292031,2249
10,15,15,0,20,20,80,1.2271431097220142,31.223463707084218,2234
10,15,9,6,17,17,74,1.098830704762441,31.990035051819476,2217
6,15,10,0,8,15,54,1.0731479917193407,32.04802787224496,2219
10,10,11,0,2,15,48,0.9686215165211477,32.10600095515695,2217
14,14,10,0,3,15,56,0.8374945311619034,32.57365002182523,2211
21,19,9,0,14,13,76,0.8610344809847061,32.58684179985518,2184
12,24,5,0,6,13,60,0.8838431762509847,32.87059957007837,2178
8,11,5,0,6,15,45,0.722367856340867,33.10975013037822,2165
13,11,5,0,6,13,48,0.7141336857998211,33.02914873611143,2164
6,8,5,0,15,16,50,0.7652317368717969,32.80960960603096,2155
3,9,6,0,17,14,49,0.7641882356754357,32.51498963763943,2137
4,9,5,0,11,14,43,0.7206681796523952,32.59954613079174,2124
4,8,5,0,6,13,36,0.711590553014297,33.00507582095212,2129
5,6,9,0,7,10,37,0.7230034245618581,33.33237637273816,2139
1,5,9,0,8,11,34,0.7047018954936602,33.64427552375528,2152
0,5,8,0,12,12,37,0.7425381311537416,33.45662149612269,2150
3,4,8,0,11,5,31,0.7168289286739035,33.450026664341436,2140
0,4,8,0,14,6,32,0.7531894559343444,33.227427635406805,2154
4,16,9,0,9,9,47,0.8106004988489645,30.109446332733985,2147
13,18,1,0,20,4,56,1.051437056541455,29.857690578904215,2165
8,14,6,0,21,3,52,0.9974180143369248,28.738435137554582,2173
5,7,5,0,16,7,40,1.0323491409232664,29.279702585508215,2200
7,15,7,0,9,8,46,1.0435048915745795,29.496620496700192,2210
0,7,5,0,8,12,32,1.0154985054421135,29.475999585011973,2229
2,8,5,0,9,13,37,0.9626961372465714,29.344985736148466,2241
6,9,6,0,10,14,45,0.9752564823249343,29.39083477682444,2241
5,11,6,0,9,10,41,0.9518767227527917,29.44127756877214,2243
8,10,11,0,10,11,50,0.8859415062480862,29.054623682737247,2232
8,12,6,0,9,12,47,0.8269036590272013,29.21360988630639,2228
5,10,6,0,8,14,43,0.8285209038211124,29.750256601663416,2239
8,11,5,0,0,7,31,0.8013182011366773,30.183046751412856,2246
10,6,5,0,9,9,39,0.8818127391481786,29.74750156387763,2262
8,9,5,0,11,12,45,0.8559177567153956,29.947255261928117,2252
12,8,1,0,6,7,34,0.8288912546333165,29.825048052731155,2264
10,9,6,0,6,6,37,0.8633669263289483,29.627503519818614,2281
5,17,6,0,11,8,47,0.9230869220854421,29.33068611110717,2262
25,18,6,0,7,7,63,0.9709837913834323,29.503811507970163,2262
10,13,5,0,5,6,39,0.9460489327540376,29.298797012732596,2278
8,3,6,0,0,6,23,0.9910932970870165,28.88320091148911,2281
9,16,11,0,23,5,64,1.2448818052619246,28.003438441328484,2281
15,9,10,0,27,10,71,1.5083859367645505,26.354137217301144,2288
6,11,11,0,19,9,56,1.5552827997062963,26.15393290346871,2307
2,8,11,0,6,9,36,1.5642437715822088,26.004837674362292,2321
5,7,10,0,5,11,38,1.5038230834534485,26.485526519679805,2336
2,5,10,0,13,15,45,1.472737625533102,26.639873608092287,2344
5,4,10,0,15,12,46,1.4848314465267625,26.883610510363578,2353
5,8,10,0,10,15,48,1.386765990556975,27.17080804989223,2368
4,8,11,0,10,15,48,1.2193755048367287,28.59278548735949,2374
28,11,5,0,9,12,65,0.9292005071917742,30.14392425637169,2349
10,7,5,0,7,2,31,0.778287409248581,31.36660564948651,2351
25,6,5,0,6,4,46,0.8076438692774756,30.801636154872966,2338
4,2,5,0,7,9,27,0.7968775220683504,31.553116453742096,2353
4,2,5,0,6,6,23,0.7797754279590516,31.569830588470303,2355
1,2,7,0,7,6,23,0.6996455999007036,31.920779865549846,2366
0,3,8,0,7,8,26,0.7236137578802717,32.54503181537122,2391
0,3,5,0,8,3,19,0.7314384781208204,33.158426921240334,2408
1,12,5,0,9,2,29,0.8498754716981018,32.78080703953318,2423
0,1,6,0,10,3,20,0.869157598548857,32.88239991413858,2430
3,6,9,0,11,1,30,0.9980770913579824,31.864295485730118,2453
1,2,7,0,10,0,20,1.0097392806585954,31.988739721813346,2491
3,4,3,0,4,0,14,0.9421369254635985,33.042173407595385,2506
0,2,7,0,19,0,28,0.9557809515097175,33.684431005962644,2528
0,2,5,0,10,0,17,0.8970358387648267,34.3739611286968,2568
2,4,10,0,0,0,16,0.8052565509734393,34.75233398316362,2591
5,2,11,0,1,0,19,0.7401105724957031,35.61552691909043,2596
0,2,10,0,6,0,18,0.6475566529428278,36.596394387043624,2613
4,2,10,0,9,0,25,0.5851208641129487,36.63185140147004,2620
3,5,10,0,7,0,25,0.5413110443370156,36.96420958298759,2629
4,3,14,0,5,0,26,0.49672939282945755,37.164652558382876,2636
1,0,10,0,6,0,17,0.45028247377256087,37.460771946593155,2648
0,0,11,0,0,0,11,0.4712767940744784,37.95562843078741,2660
0,0,11,0,0,0,11,0.4100477699101381,38.217262003617044,2670
0,0,6,0,0,0,6,0.4030228504696729,38.53535414249575,2694
0,7,5,0,5,0,17,0.4409942033816314,38.549154074195904,2706
0,1,8,0,5,0,14,0.43602029174832196,38.65085262340837,2722
1,1,5,0,12,0,19,0.4403669928550913,38.756041622083025,2728
1,1,16,0,13,0,31,0.44548321305742666,38.39304876486149,2724
10,4,15,0,12,0,41,0.4972538747699803,38.7146177581705,2718
17,5,15,0,12,0,49,0.5350604749406063,38.11002387580246,2692
0,2,15,0,8,0,25,0.49697340665370515,38.29210847745359,2691
0,3,13,0,8,0,24,0.48275545958700083,38.40218985047017,2689
0,3,10,0,8,0,21,0.44454670155141923,38.49060813392847,2697
0,5,6,0,3,0,14,0.399312387993633,38.77925014726856,2701
4,1,5,0,4,0,14,0.38627588045157807,38.76285326643832,2709
5,2,5,0,0,0,12,0.43755108623988265,38.81535897968858,2728
5,4,7,0,0,0,16,0.4741048574092884,39.099419799043844,2737
8,0,8,0,1,0,17,0.3892910127469988,39.42817033376601,2756
5,0,7,0,18,0,30,0.4529316357096972,39.59675121610505,2766
10,0,4,0,12,0,26,0.5312816720543095,39.27674564387726,2783
6,0,11,0,13,0,30,0.5007340501894486,39.47525234888497,2789
8,12,10,0,5,0,35,0.5780414124166277,39.4065766968828,2807
7,6,6,0,2,0,21,0.5855298844508858,39.29807823285449,2823
7,2,5,0,5,0,19,0.5782423077628633,39.964311343396936,2845
8,3,9,0,7,0,27,0.5502538234044919,39.966034302026316,2839
37,2,7,0,7,0,53,0.5411681365006372,40.12482400857131,2843
35,1,2,0,10,0,48,0.47060692537121673,40.87114888927448,2855
16,3,8,0,5,0,32,0.5665024842014375,39.84751939754081,2834
3,5,6,0,7,0,21,0.5541944998458097,40.028806158306395,2850
1,3,4,0,6,0,14,0.4941837825734435,41.033889625415604,2870
3,2,10,0,5,0,20,0.4814944727683622,41.11487002671509,2874
1,2,12,0,6,0,21,0.47335317105662217,40.7344430958424,2873
5,3,10,0,18,0,36,0.5804201155725307,39.82578799779385,2867
5,4,10,0,19,0,38,0.6577474711660035,39.65015294111177,2873
7,0,10,0,5,0,22,0.6073898922787666,39.342417326009816,2873
7,0,6,0,3,0,16,0.5582751411464723,39.9153922932743,2875
7,0,5,0,22,0,34,0.5179042366517612,40.79231280611685,2869
21,0,5,0,18,0,44,0.4391494393845659,41.4653318986642,2864
12,10,5,0,11,0,38,0.3935346064581779,41.33259843948461,2852
20,8,5,0,11,0,44,0.3918569036932023,41.41273375924864,2846
10,1,5,0,16,0,32,0.43144079351310405,41.385806750015995,2845
7,3,5,0,11,0,26,0.4232124296592763,41.5187220700644,2847
4,0,7,0,7,0,18,0.47962603106423723,40.38335735353768,2853
4,2,10,0,7,0,23,0.4951072022128346,39.998420724551714,2852
6,4,11,0,8,0,29,0.5445579927135441,39.39989095130743,2856
3,2,10,0,7,0,22,0.5654276559323079,39.867150238668344,2865
4,2,7,0,9,0,22,0.5234751410923321,40.27751026791627,2871
3,0,6,0,6,0,15,0.4786578554753133,40.859240021660746,2884
2,1,5,0,6,0,14,0.48511890620816395,41.0424590975235,2911
3,3,8,0,8,0,22,0.5045827929194099,40.90238210931427,2912
2,1,6,0,8,0,17,0.4975504880295278,40.71596989334592,2928
4,0,7,0,5,0,16,0.508246856792357,40.730591796415766,2935
5,0,9,0,16,0,30,0.5012942744399773,41.096596580009795,2932
6,0,10,0,14,0,30,0.47980352876183235,41.25441002241281,2938
6,0,10,0,5,0,21,0.4666435117372606,41.745198016732985,2952
5,11,8,0,4,0,28,0.45714147915299197,41.60650788363675,2960
6,4,10,0,9,0,29,0.5125163190138484,41.48345358536942,2974
8,3,12,0,4,0,27,0.5013978390071867,41.25455706993818,2980
7,1,10,0,9,0,27,0.5217290985276047,41.12242581409373,2993
7,3,10,0,5,0,25,0.5511986855487104,40.71938575816857,3002
8,0,10,0,8,0,26,0.4747020234787465,41.037114205379865,3003
5,2,5,0,9,0,21,0.48683672576117515,41.71731002345202,3027
8,3,5,0,8,0,24,0.41326020205417113,42.51141134072328,3049
7,0,5,0,2,0,14,0.3825723692622013,42.569923977237906,3047
6,1,5,0,0,0,12,0.4222017543445097,42.452698532339134,3055
10,1,5,0,0,0,16,0.39298638407220643,42.51474926673922,3064
13,2,4,0,0,0,19,0.4034498983798151,42.71017269955309,3068
23,0,0,0,10,0,33,0.45394538206449386,42.316088187164695,3065
3,0,0,0,14,0,17,0.5063774469572471,42.63349065594202,3081
5,0,2,0,16,0,23,0.4705916553883463,42.767791213513,3089
5,0,11,0,14,0,30,0.40533823087246973,42.909409790089526,3083
8,0,10,0,3,0,21,0.4808825856786954,42.01927448353168,3084
5,0,10,0,0,0,15,0.45320672638768517,42.42230334354884,3078
2,0,10,0,0,0,12,0.4436392767343229,42.91880103358813,3087
0,0,7,0,0,0,7,0.3337357043568165,44.17326582035592,3095
0,0,0,0,10,0,10,0.34779607851337063,44.2558823966009,3102
1,0,0,0,6,0,7,0.3925576598147816,43.17183450189791,3111
1,0,0,0,6,0,7,0.39788082446939943,43.99246576542379,3117
6,0,5,0,6,0,17,0.44426542895303267,43.58704736640581,3142
2,0,5,0,0,0,7,0.4620501883822115,44.19574640989315,3152
0,0,5,0,0,0,5,0.4370211108019018,44.7842799685713,3167
11,0,5,0,0,0,16,0.4887883774450917,44.93376796708375,3174
0,0,5,0,0,0,5,0.45260871664493024,45.09615326143094,3179
0,0,5,0,0,0,5,0.4079792048693704,45.496287396239694,3189
0,0,5,0,0,0,5,0.3736148851620928,45.65666702535462,3198
0,0,4,0,0,0,4,0.4271233582153909,44.89975525241236,3211
0,0,5,0,0,0,5,0.44298461190468214,44.71535544258817,3224
0,0,4,0,0,0,4,0.3675343289748124,45.50388447659972,3239
1,0,1,0,0,0,2,0.33578347474715436,46.05577610722272,3258
0,0,0,0,0,0,0,0.26044304706884563,47.52418953286399,3266
0,0,0,0,0,0,0,0.1968872602829235,48.60160416674379,3281
0,0,0,0,0,0,0,0.1916258623857563,48.52080962822805,3295
0,0,0,0,1,0,1,0.17778730585661398,49.384671476955184,3298
0,0,0,0,0,0,0,0.15083316706673403,49.816464820901174,3311
0,0,2,0,0,0,2,0.14951622301263404,50.00060475256559,3315
0,0,0,0,0,0,0,0.12095907637358505,51.32642072451325,3324
1,0,0,0,15,0,16,0.16027818881470113,52.52246879890649,3334
1,0,0,0,13,0,14,0.17466439697659578,50.91539614210032,3332
0,0,0,0,9,0,9,0.14756898362320284,51.507542234062626,3343
0,0,0,0,5,0,5,0.12410887270084918,53.111877242983965,3353
0,0,0,0,0,0,0,0.09106339270172022,52.7753290077081,3367
0,0,0,0,0,0,0,0.046647362807011476,54.04945213317218,3372
1,0,0,0,0,0,1,0.030898902568343524,54.3557008911574,3382
0,0,0,0,0,0,0,0.03196891047723237,54.44873807673149,3386
23,0,0,0,11,0,34,0.06961945193287551,53.75162985682065,3364
25,0,0,0,4,0,29,0.04528733563032741,53.71766408643408,3345
0,0,0,0,1,0,1,0.03806379134371214,53.87047943612188,3347
1,0,0,0,0,0,1,0.03471152768362231,53.9482047076256,3349
0,0,0,0,2,0,2,0.02951827012870484,54.0160128159991,3354
0,0,0,0,0,0,0,0.039542309407807855,54.129703720369385,3363
0,0,0,0,0,0,0,0.027556995949717243,54.21082506112013,3364
0,0,0,0,0,0,0,0.03196123624821093,54.20415439140788,3367
0,0,0,0,0,0,0,0.02675750050562646,54.27090084335828,3371
0,0,0,0,0,0,0,0.03372213859137639,54.34047325895302,3374
0,0,0,0,0,0,0,0.04054508282616275,54.36884878618405,3378
0,0,5,0,0,0,5,0.03842244530643468,54.27093652843026,3377
0,0,1,0,0,0,1,0.050853992974111376,54.44812769555138,3390
0,0,0,0,0,0,0,0.04704528812374271,54.54851189735651,3394
0,0,0,0,0,0,0,0.038186967946950374,54.605856376460764,3396
0,0,5,0,0,0,5,0.04426245161379493,54.516067489924104,3395
0,0,5,0,0,0,5,0.05330522922750499,54.36294460478871,3395
0,0,5,0,0,0,5,0.04206535848802482,54.427104005305296,3393
0,0,5,0,0,0,5,0.04575918374177574,54.47501698283411,3391
0,0,5,0,0,0,5,0.035793029163651895,54.52833049491421,3389
0,0,0,0,0,0,0,0.0343680034180298,54.585505664675566,3394
0,0,0,0,0,0,0,0.02050706886539284,54.765360522165615,3399
0,0,0,0,0,0,0,0.03025776580562129,54.78090704338974,3403
0,0,0,0,0,0,0,0.03446212002155235,54.83816426603345,3411
0,0,0,0,0,0,0,0.03493064680122404,54.91643765413959,3414
0,0,0,0,0,0,0,0.0343205685609893,55.0147735259303,3419
1,0,0,0,0,0,1,0.039923633797714256,55.06369190482651,3425
0,0,0,0,0,0,0,0.03546537819180001,55.14012771807137,3428
0,0,0,0,0,0,0,0.03124940208848285,55.17506140096726,3429
0,0,0,0,0,0,0,0.019647589180628595,55.246415931496266,3432
0,0,0,0,0,0,0,0.017829883710353392,55.29324493504952,3432
0,0,0,0,0,0,0,0.018579814286099658,55.34103376256675,3437
0,0,0,0,0,0,0,0.022737341266977955,55.39552016364327,3442
0,0,0,0,0,0,0,0.03487864500815438,55.42679226120168,3448
0,0,0,0,0,0,0,0.04145956324251427,55.487865838338976,3455
0,0,0,0,0,0,0,0.06229928483878236,55.51534293863591,3462
0,0,0,0,0,0,0,0.06504861025479863,55.58573480739472,3468
0,0,0,0,0,0,0,0.05591651317367634,55.67976623138435,3473
0,0,0,0,0,0,0,0.04837414279756779,55.81576060985606,3478
0,0,0,0,0,0,0,0.036653513094316914,55.92557012835097,3483
0,0,0,0,0,0,0,0.037683242953181074,55.981321123348984,3487
0,0,0,0,0,0,0,0.043713735308587014,56.06196793808263,3493
0,0,0,0,0,0,0,0.04380247400548087,56.11927751853869,3496
0,0,0,0,0,0,0,0.03160370355142484,56.197580453204495,3498
0,0,0,0,0,0,0,0.01677223747969799,56.29155197351725,3500
0,0,0,0,0,0,0,0.01708291793891641,56.36982532906428,3506
0,0,6,0,0,0,6,0.027695855393393278,56.27676458625734,3506
0,0,3,0,0,0,3,0.03726885982403298,56.35498279094261,3510
0,0,0,0,0,0,0,0.02197588140972154,56.3862495905813,3508
0,0,0,0,0,0,0,0.015841515093896696,56.483207975810146,3513
0,0,0,0,0,0,0,0.009443642621156986,56.561949974490354,3513
0,0,0,0,0,0,0,0.01823209357499196,56.59322363996286,3518
0,0,0,0,0,0,0,0.023055550173966353,56.62116777640584,3520
0,0,0,0,0,0,0,0.028653003876932,56.67518283269267,3527
0,0,0,0,0,0,0,0.030419624551607273,56.72222695373086,3531
0,0,0,0,0,0,0,0.037014910931958425,56.81596332873676,3539
0,0,0,0,0,0,0,0.021069866981835886,56.9098052354291,3540
0,0,0,0,0,0,0,0.019969190965595237,56.972405701411354,3545
0,0,0,0,0,0,0,0.022437765595595904,57.01934134180281,3548
0,0,0,0,0,0,0,0.013856712786540215,57.14092922860236,3551
0,0,0,0,0,0,0,0.029318210465565785,57.18785957910869,3561
0,0,0,0,0,0,0,0.03005410624531353,57.214227982114025,3565
0,0,0,0,0,0,0,0.019729686001689634,57.33914045617877,3567
0,0,1,0,0,0,1,0.01084520802524283,57.35063521557967,3571
0,0,0,0,0,0,0,0.020836876829612116,57.413290078210004,3574
0,0,0,0,0,0,0,0.02517008911772817,57.46016278449851,3578
0,0,0,0,0,0,0,0.019193525313795486,57.491458646687356,3579
0,0,0,0,0,0,0,0.017043032016285223,57.53844801073237,3581
0,0,0,0,0,0,0,0.016597475222926976,57.60104835687779,3586
0,0,0,0,0,0,0,0.02740859741431986,57.64798983338769,3592
0,0,0,0,0,0,0,0.03262040984115237,57.7262403854153,3600
1,0,0,0,0,0,1,0.030357557820690502,57.83581947939043,3606
0,0,0,0,0,0,0,0.0376817198923232,57.91437575497673,3612
0,0,0,0,0,0,0,0.02186192372507048,58.018344739735035,3615
1,0,0,0,0,0,1,0.020913898463402743,58.08117307607733,3616
0,0,0,0,0,0,0,0.02508599852932087,58.085984515409585,3618
0,0,0,0,0,0,0,0.023462430077595593,58.15341445390865,3622
0,0,0,0,0,0,0,0.014282999704898332,58.21770596836196,3625
1,0,0,0,0,0,1,0.020537736455528425,58.27918122290063,3630
1,0,0,0,0,0,1,0.01701900457006605,58.31049363022213,3631
0,0,0,0,0,0,0,0.016107546690695886,58.35748527530653,3634
0,0,0,0,0,0,0,0.023286406474842324,58.40445075149442,3639
1,0,0,0,0,0,1,0.018110864634694697,58.45210415379947,3641
0,0,0,0,0,0,0,0.029535817153076366,58.46748124919253,3646
0,0,0,0,0,0,0,0.026279447176984754,58.54586778866006,3651
0,0,0,0,0,0,0,0.02242635050569041,58.65580872117564,3656
0,0,0,0,0,0,0,0.023543846846307667,58.73859517650958,3662
0,0,1,0,0,0,1,0.025530605749741923,58.78244825196384,3666
0,0,0,0,0,0,0,0.02937367370777698,58.84443127922623,3671
0,0,0,0,0,0,0,0.023944431274997402,58.89935894187157,3675
0,0,0,0,0,0,0,0.008944480117040651,59.05639898998959,3679
0,0,0,0,0,0,0,0.01271941385265168,59.07206131151876,3681
0,0,0,0,0,0,0,0.009920907408502273,59.10336765346411,3681
0,0,0,0,0,0,0,0.01378420759002618,59.119033387153145,3686
0,0,0,0,0,0,0,0.01561324964431953,59.16621389452509,3687
0,0,0,0,0,0,0,0.01631340509611134,59.19761441600159,3690
0,0,0,0,0,0,0,0.021966241118329406,59.2290652297451,3694
0,0,0,0,0,0,0,0.017400783042128706,59.307482839348744,3699
0,0,0,0,0,0,0,0.022231688913409677,59.35440820209947,3701
0,0,0,0,0,0,0,0.022251355928223884,59.38578920239701,3704
0,0,0,0,0,0,0,0.020798326403539794,59.448811168939926,3708
0,0,0,0,0,0,0,0.01650308682653437,59.52744154427071,3711
0,0,0,0,0,0,0,0.018699419962844428,59.54327173867539,3713
0,0,0,0,0,0,0,0.02418156852064198,59.58545356191914,3718
0,0,0,0,0,0,0,0.023242365574762096,59.632030475467886,3720
0,0,0,0,17,0,17,0.06547480223884851,59.35417880674853,3717
0,0,0,0,4,0,4,0.021361618117344897,59.620443497251806,3720
0,0,0,0,0,0,0,0.006555229859167563,59.70261159792485,3719
0,0,0,0,0,0,0,0.01222720567798254,59.733914614598575,3724
0,0,0,0,0,0,0,0.015205963697344007,59.733930676036636,3725
0,0,0,0,0,0,0,0.017348212921916028,59.76534908374249,3729
1,0,0,0,0,0,1,0.029770590062324315,59.79665583156337,3734
0,0,0,0,0,0,0,0.016368404122244835,59.82811901426689,3734
0,0,0,0,0,0,0,0.012904988262274054,59.93274529483462,3737
0,0,0,0,0,0,0,0.019281917835119147,59.96396094845007,3741
0,0,0,0,0,0,0,0.022570222168395916,60.06230599416597,3747
0,0,0,0,0,0,0,0.014766843109299193,60.101031575328605,3750
21,0,0,0,0,0,21,0.014903217441261496,59.97735671481428,3736
0,0,0,0,0,0,0,0.00418755167772952,60.02380276555525,3736
0,0,1,0,0,0,1,0.011937628631213648,60.04152751160868,3739
0,0,0,0,0,0,0,0.012773656853918394,60.0415525758695,3740
0,0,0,0,0,0,0,0.011388669324237929,60.08851795212894,3744
0,0,0,0,0,0,0,0.009822810396948095,60.13552907925249,3744
0,0,0,0,0,0,0,0.0005674355314992391,60.18259189193872,3745
0,0,0,0,0,0,0,0.008911968109965748,60.18261711863742,3748
0,0,0,0,0,0,0,0.01750846546393254,60.198314167918966,3751
0,0,0,0,0,0,0,0.018181884436757046,60.261611198973135,3755
0,0,0,0,0,0,0,0.00878811666259002,60.29292338906337,3755
0,0,0,0,0,0,0,0.013445355159754528,60.33465701076626,3760
0,0,0,0,0,0,0,0.014078219296888872,60.41305599655091,3765
0,0,0,0,0,0,0,0.01979085005970032,60.46006401407577,3771
0,0,0,0,0,0,0,0.022075213762513358,60.50731557701797,3774
0,0,0,0,0,0,0,0.014249590387469908,60.585511596600455,3778
0,0,0,0,0,0,0,0.02642719887136778,60.616814749170175,3782
0,0,0,0,0,0,0,0.02254487840646021,60.64289967770436,3784
0,0,0,0,0,0,0,0.022341026500327106,60.70806183019587,3789
0,0,0,0,0,0,0,0.011584840637574485,60.81835503735088,3792
0,0,0,0,0,0,0,0.008511816378146136,60.864622895726335,3797
0,0,0,0,0,0,0,0.01028799138498408,60.911599499617274,3800
0,0,0,0,0,0,0,0.011454380258491088,60.99000152419837,3803
0,0,0,0,0,0,0,0.009334665761373965,61.0213075302542,3803
0,0,0,0,0,0,0,0.018750532032565773,61.02132690994077,3806
0,0,0,0,0,0,0,0.012097544642647602,61.08389476954739,3809
0,0,0,0,0,0,0,0.016958283058179837,61.08391390992291,3811
0,0,0,0,0,0,0,0.0029749987672019564,61.162299283468414,3810
0,0,0,0,0,0,0,0.0060224166398133465,61.193539072731085,3813
0,0,0,0,0,5,5,0.0339097263022768,61.02867470099575,3824
0,0,0,0,0,4,4,0.02890939992445241,61.12012839083021,3828
0,0,0,0,0,5,5,0.03225308880763263,61.36886804908513,3841
0,0,0,0,0,5,5,0.015035127035775038,61.54342690303085,3845
0,0,0,0,0,6,6,0.02359925472725337,61.76785145193297,3859
0,0,0,0,0,4,4,0.026044569362590655,61.78310142595353,3861
0,0,0,0,0,5,5,0.026878095978735392,61.87960855670233,3869
0,0,0,0,0,3,3,0.01611804922344139,62.076273021498444,3872
0,0,0,0,0,0,0,0.016746970317712124,61.93785896868907,3873
0,0,0,0,0,0,0,0.0133419406553669,62.04842119316812,3873
0,0,0,0,0,0,0,0.019453993479374168,62.06395895833034,3877
0,0,0,0,0,0,0,0.02584007471499632,62.13916075926625,3882
0,0,0,0,0,0,0,0.03237703819555085,62.18037392564587,3888
0,0,0,0,0,1,1,0.01966074825045837,62.255703760618545,3887
0,0,0,0,0,0,0,0.016150043422136818,62.33542180346513,3894
0,0,0,0,0,0,0,0.02121217474776701,62.383333474616286,3898
0,0,0,0,0,0,0,0.0186524615750699,62.42917143658885,3898
0,0,0,0,0,0,0,0.02230710311951507,62.47154042414705,3903
0,0,0,0,0,0,0,0.032541144477837965,62.42924514877945,3907
0,0,0,0,0,0,0,0.032371589337916444,62.47108212677594,3906
0,0,0,0,0,0,0,0.02263483157435063,62.507890543472165,3908
0,0,0,0,0,0,0,0.020505918539075706,62.57058915364212,3910
0,0,0,0,0,0,0,0.02191355735742426,62.633265802619476,3914
0,0,0,0,0,0,0,0.02274372271698992,62.664488491486175,3917
0,0,0,0,0,0,0,0.015557782760113999,62.72707454939276,3917
0,0,0,0,0,0,0,0.024374342219156117,62.737409878114285,3921
0,0,0,0,0,0,0,0.025148326932494008,62.79663536431589,3925
0,0,0,0,0,0,0,0.03451189859767892,62.844197954087875,3932
0,0,0,0,0,1,1,0.020886284228409182,62.88057282844337,3932
0,0,0,0,0,0,0,0.03175943245260387,62.90159249204941,3937
0,0,0,0,0,0,0,0.04361173511442871,62.958875886065954,3941
0,0,0,0,0,0,0,0.04034294870381536,63.00826816151863,3945
0,0,0,0,0,0,0,0.0160717305078169,63.152341038116745,3948
0,0,0,0,0,0,0,0.02228720187852745,63.21526007588307,3951
0,0,0,0,0,0,0,0.025351879657050255,63.23627990635074,3954
1,0,0,0,0,0,1,0.02275952820578064,63.29371285952775,3959
0,0,0,0,0,0,0,0.025704682096941,63.32515370672834,3959
0,0,0,0,0,0,0,0.01882204533667753,63.366930012066085,3961
1,0,0,0,0,0,1,0.02720483210272292,63.382562983884185,3966
0,0,0,0,0,0,0,0.023503292366629,63.439829245471735,3968
0,0,0,0,0,0,0,0.03177648890711372,63.51820912233082,3977
0,0,0,0,0,0,0,0.024032585042429652,63.62410393469893,3979
0,0,0,0,0,0,0,0.019850927443221485,63.64533274303987,3981
0,0,0,0,0,0,0,0.026382888251383674,63.63972296246745,3985
0,0,0,0,0,0,0,0.025804032566529352,63.73359327088243,3987
0,0,0,0,0,0,0,0.019600531503250924,63.79636558534834,3990
0,0,0,0,0,0,0,0.02170189777943714,63.81202412877623,3992
0,0,0,0,0,0,0,0.020240945508915628,63.87834792798666,3994
0,0,0,0,0,0,0,0.020039676556805712,63.91494653504104,3998
1,0,0,0,0,0,1,0.02185904887153363,63.97758687406381,4002
0,0,0,0,0,0,0,0.020088936020160195,64.02636619877802,4005
0,0,0,0,0,0,0,0.02684865316428181,64.08897892841493,4012
0,0,0,0,0,0,0,0.023849609905768395,64.16735068090692,4014
0,0,0,0,0,0,0,0.026680850661606182,64.19049630583017,4018
0,0,0,0,0,0,0,0.01732280025556856,64.28132886607379,4020
0,0,0,0,0,0,0,0.017579930466614508,64.29705307978632,4024
0,0,0,0,0,0,0,0.006084414014079298,64.3937173130714,4025
1,0,0,0,0,0,1,0.013321612871425187,64.42241419086969,4027
0,0,0,0,0,0,0,0.01680057832138615,64.39624164009366,4028
0,0,0,0,0,0,0,0.00577860347605745,64.46945550516399,4028
0,0,0,0,0,0,0,0.013872345921383577,64.45917783551334,4031
0,0,0,0,0,0,0,0.007553120509968846,64.52193796400172,4031
0,0,0,0,0,0,0,0.008577236453367354,64.5218022838888,4033
0,0,0,0,0,0,0,0.01116879643671107,64.53750461750852,4036
0,0,0,0,0,0,0,0.0090862670981238,64.59479009196896,4036
0,0,0,0,0,0,0,0.02381460510821827,64.58445559194067,4042
0,0,0,0,0,0,0,0.006976351944687485,64.68876402363638,4042
0,0,0,0,0,0,0,0.0034884403576323436,64.7060744174289,4044
0,0,0,0,0,0,0,0.015029164807925006,64.72172402905275,4050
0,0,0,0,0,0,0,0.019964917322136254,64.79888256426975,4054
0,0,0,0,0,0,0,0.015132484831466099,64.81753924140216,4054
0,0,0,0,0,0,0,0.019767927089614026,64.84574194690357,4057
1,0,0,0,0,0,1,0.01542111760196177,64.8983397524373,4060
0,0,0,0,0,0,0,0.009376426409712145,64.98707176994026,4063
0,0,0,0,0,0,0,0.005879423586011186,65.03397899501287,4065
0,0,0,0,0,0,0,0.007502109657195574,65.04968901065686,4065
0,0,0,0,0,0,0,0.007814247955934014,65.07089321856536,4068
0,0,0,0,0,0,0,0.01613894541883792,65.11269162411591,4075
0,0,0,0,0,0,0,0.012979064739744826,65.20657151765948,4078
0,0,0,0,0,0,0,0.009940940651594997,65.25471889975347,4079
0,0,0,0,0,0,0,0.01049969438720776,65.24317377310334,4081
0,0,0,0,0,0,0,0.007217338573049663,65.30048566402067,4083
0,0,0,0,0,0,0,0.009313063672938396,65.34753857588217,4085
0,0,0,0,0,0,0,0.010922547326290336,65.35286081804577,4088
0,0,0,0,0,0,0,0.012607863732453659,65.41396861154875,4092
0,0,0,0,0,0,0,0.012042148111808438,65.50488114615808,4096
0,0,0,0,0,0,0,0.00931596015664654,65.55098754999895,4098
0,0,0,0,0,0,0,0.008850316200758577,65.57702751290918,4099
0,0,0,0,0,0,0,0.0029947421145024447,65.60844921539316,4099
0,0,0,0,0,0,0,0.010287158942784095,65.63978030602816,4104
0,0,0,0,0,0,0,0.010896027990986665,65.655380596987,4105
0,0,0,0,0,0,0,0.01686443716070644,65.67101885997633,4110
0,0,0,0,0,0,0,0.010159235974707661,65.76512723593926,4112
0,0,0,0,0,0,0,0.01285807881275667,65.7338507926227,4114
0,0,0,0,0,0,0,0.019283430679976527,65.81205653398351,4118
0,0,0,0,0,0,0,0.016638422691280786,65.84334341252799,4120
0,0,0,0,0,0,0,0.013279430084371897,65.91429937107235,4123
0,0,0,0,0,0,0,0.01158111825735092,65.97780031776684,4127
0,0,0,0,0,0,0,0.013635933446652872,66.07039737568047,4132
0,0,0,0,0,0,0,0.01773486577400039,66.0860269735219,4136
0,0,0,0,0,0,0,0.017699684212050815,66.13296428273945,4138
0,0,0,0,0,1,1,0.015053372511599295,66.21142276995745,4142
0,0,0,0,0,0,0,0.0075622870107388985,66.2768936202115,4145
0,0,0,0,0,0,0,0.002900439977170611,66.37290847558856,4147
0,0,0,0,0,0,0,0.007864660822297294,66.3885985759804,4151
0,0,0,0,0,0,0,0.011334987050574754,66.43826644175664,4155
0,0,0,0,0,0,0,0.008753889779718289,66.45391306254704,4155
0,0,0,0,0,0,0,0.0070815907917014505,66.4662161249873,4156
0,0,0,0,0,0,0,0.0,66.50244361531544,4156
0,0,0,0,0,0,0,0.004249330914472016,66.51809426762507,4159
0,0,0,0,0,0,0,0.005929352757648613,66.5180817370746,4159
0,0,0,0,0,0,0,0.0028376906419837066,66.5440681998287,4160
0,0,0,0,0,0,0,9.627363527372742e-08,66.55970683558351,4160
0,0,0,0,0,1,1,0.0013053207650954414,66.57547533938566,4162
0,0,0,0,0,0,0,0.0009896008961047258,66.59926264418282,4164
0,0,0,0,0,0,0,0.0,66.65366428398407,4167
0,0,0,0,0,0,0,0.0028464043490925703,66.65366428398407,4167
0,0,0,0,0,0,0,0.0,66.65366428398407,4166
0,0,0,0,0,0,0,0.0,66.66930265132171,4167
0,0,0,0,0,0,0,3.8394403348786613e-05,66.66930265132171,4168
0,0,0,0,0,0,0,0.002935542455788187,66.69259454781603,4170
0,0,0,0,0,0,0,0.0029358172249127116,66.69259454781603,4170
0,0,0,0,0,0,0,0.005175428642313932,66.69259454781603,4171
1,0,0,0,0,0,1,0.008679322004265803,66.72406015245032,4174
0,0,0,0,0,0,0,0.007282654238697666,66.72406015245032,4174
0,0,0,0,0,0,0,0.005011396653871678,66.75184505712932,4175
0,0,0,0,0,0,0,0.003902034771255447,66.78320710238344,4177
0,0,0,0,0,0,0,0.0028390710375793054,66.79354160241174,4177
0,0,0,0,0,0,0,0.00505965132141817,66.80918731879001,4179
0,0,0,0,0,0,0,0.008471059445447722,66.80918731879001,4180
0,0,0,0,0,0,0,0.00787884707347389,66.80918731879001,4180
0,0,0,0,0,0,0,0.004427164802484941,66.85613602334678,4182
0,0,0,0,0,0,0,0.005699222777156843,66.85613570042413,4182
0,0,0,0,0,0,0,0.002864368153458817,66.85613570042413,4182
0,0,0,0,0,0,0,0.0043746571011941794,66.88749316056668,4185
1,0,0,0,0,0,1,0.005746513494165791,66.90333911645433,4185
0,0,0,0,0,0,0,0.00032057434984734224,66.91631930446728,4185
0,0,0,0,0,0,0,0.0,66.93195758528448,4185
0,0,0,0,0,0,0,0.002730483278363847,66.93195758528448,4186
0,0,0,0,0,0,0,0.005643956078903399,66.9476539585924,4188
0,0,0,0,0,0,0,0.005777561916425333,66.94759597843957,4188
0,0,0,0,0,0,0,0.002824607914998097,66.94759597843957,4187
0,0,0,0,0,0,0,0.004995353280760724,66.95793047846787,4189
0,0,0,0,0,0,0,0.009159651355714804,66.95793047846787,4191
1,0,0,0,0,0,1,0.01487673081832778,66.95793047846787,4194
0,0,0,0,0,0,0,0.0038731621132804873,67.02094574028924,4194
0,0,0,0,0,0,0,0.0012176767080751413,67.06833561103898,4195
0,0,0,0,0,0,0,0.0,67.09977241146127,4196
0,0,0,0,0,0,0,0.0028872029930628322,67.09977241146127,4197
1,0,0,0,0,0,1,0.004772108250304604,67.09977241146127,4198
0,0,0,0,0,0,0,0.0,67.11544676613629,4197
0,0,0,0,0,0,0,0.005481305423896539,67.12251017577849,4200
1,0,0,0,0,0,1,0.00990703889165874,67.12251017577849,4202
0,0,0,0,0,0,0,0.0059983648194071836,67.1539699222529,4203
0,0,0,0,0,0,0,0.005786741645996734,67.1853541420462,4204
0,0,0,0,0,0,0,0.0037848207602860983,67.1853541420462,4204
0,0,0,0,0,0,0,0.0012023048764858817,67.21664627740311,4205
0,0,0,0,0,0,0,0.002726216298482612,67.21664627740311,4205
0,0,0,0,0,0,0,0.005582978963587101,67.21664627740311,4206
0,0,0,0,0,0,0,0.0046253167452239945,67.23228492344919,4207
0,0,0,0,0,0,0,0.005096874914988813,67.26368938347063,4209
0,0,0,0,0,0,0,0.0029398470908202435,67.26368938347063,4208
0,0,0,0,0,0,0,0.0,67.27937071349065,4208
0,0,0,0,0,0,0,0.0,67.27937071349065,4208
0,0,0,0,0,0,0,0.004348773433054817,67.27937071349065,4210
0,0,0,0,0,0,0,0.00508746907987466,67.29507963978438,4212
0,0,0,0,0,0,0,0.008248970454916677,67.34209381261562,4215
0,0,0,0,0,0,0,0.008680840562840181,67.35783038618274,4216
0,0,0,0,0,0,0,0.009152684104020257,67.37347461037899,4218
0,0,0,0,0,0,0,0.005516060843007937,67.42047417423494,4219
0,0,0,0,0,0,0,0.005644596298081774,67.43611347586157,4220
0,0,0,0,0,0,0,0.007410991331180483,67.43611347586157,4222
0,0,0,0,0,0,0,0.009490329090781326,67.46744472275417,4224
0,0,0,0,0,0,0,0.0047000866437489925,67.49873217996274,4224
0,0,0,0,0,0,0,0.006941356356106919,67.49873217996274,4225
0,0,0,0,0,0,0,0.003695630145817854,67.49873217996274,4225
0,0,0,0,0,0,0,0.0026447376318099584,67.53001548287376,4225
0,0,0,0,0,0,0,0.0,67.54565379151904,4225
0,0,0,0,0,0,0,0.005216366405729252,67.54565379151904,4227
0,0,0,0,0,0,0,0.009929966188747533,67.54565379151904,4229
0,0,0,0,0,0,0,0.0016750944637154833,67.59259670300571,4229
0,0,0,0,0,0,0,0.005648334070265775,67.60823506894187,4231
0,0,0,0,0,0,0,0.01262907696034269,67.60823506894187,4235
0,0,0,0,0,0,0,0.011255801568472966,67.67081437165564,4237
0,0,0,0,0,0,0,0.010501198491639552,67.68645263205812,4238
0,0,0,0,0,0,0,1.8397426352911653e-07,67.73686264238056,4238
0,0,0,0,0,0,0,0.0,67.73686126986718,4238
0,0,0,0,0,0,0,0.0,67.73686126986718,4238
0,0,0,0,0,0,0,0.0,67.73686126986718,4238
0,0,0,0,0,0,0,0.00034257014800327993,67.73686126986718,4239
1,0,0,0,0,0,1,0.0028116732816985015,67.73686126986718,4239
0,0,0,0,0,0,0,0.0,67.73686126986718,4238
0,0,0,0,0,0,0,0.006215358239383196,67.73686126986718,4242
0,0,0,0,0,0,0,0.005637120706276417,67.75287106219348,4242
0,0,0,0,0,0,0,0.00037339590303091616,67.76851143710488,4241
0,0,0,0,0,0,0,0.0,67.78414970154138,4241
0,0,0,0,0,0,0,0.0042241168088794825,67.78414970154138,4243
0,0,0,0,0,0,0,0.005311086635659236,67.79996702274033,4244
0,0,0,0,0,0,0,0.0022640181450004054,67.81560658206256,4244
0,0,0,0,0,0,0,0.002337551129116518,67.83106456774976,4245
0,0,0,0,0,0,0,0.007961630940255234,67.83106456774976,4247
0,0,0,0,0,0,0,0.0056280148750367945,67.86235074884084,4248
0,0,0,0,0,0,0,0.0003386231820609046,67.87800318920414,4248
0,0,0,0,0,0,0,0.002865581966982179,67.89364895727523,4249
0,0,0,0,0,0,0,0.0,67.90932260685113,4249
1,0,0,0,0,0,1,0.0029270177545792915,67.90932260685113,4250
0,0,0,0,0,0,0,0.0028893633334623543,67.90932260685113,4250
0,0,0,0,0,0,0,0.0024588147512096506,67.94076247861804,4252
0,0,0,0,0,0,0,0.007053722638867675,67.94076247861804,4255
0,0,0,0,0,0,0,0.00419652879283142,67.97207136382069,4256
0,0,0,0,0,0,0,0.0008873072975289769,68.00336103713401,4256
0,0,0,0,0,0,0,0.0026619802217399246,68.00336103713401,4256
0,0,0,0,0,0,0,0.00571520444960307,68.00336103713401,4258
0,0,0,0,0,0,0,0.0027975852292028425,68.05031368369016,4259
0,0,0,0,0,0,0,0.00126261388773294,68.05031368369016,4259
0,0,0,0,0,0,0,0.0029282003832922852,68.08170518984235,4261
0,0,0,0,0,0,0,0.002156386953025238,68.09735072495158,4262
0,0,0,0,0,0,0,0.0006683683987003875,68.112991997753,4263
0,0,0,0,0,0,0,0.0027892712110851843,68.12880207585265,4264
0,0,0,0,0,0,0,0.0,68.12880207585265,4263
0,0,0,0,0,0,0,0.0026863497713523594,68.16012155807218,4266
0,0,0,0,0,0,0,0.0029292318261648974,68.16012155807218,4266
0,0,0,0,0,0,0,0.0,68.17575997557371,4266
0,0,0,0,0,0,0,0.0,68.17575997557371,4266
0,0,0,0,0,0,0,0.001742887818458919,68.18414613046924,4268
0,0,0,0,0,0,0,0.0028825531542824787,68.18414613046924,4268
0,0,0,0,0,0,0,1.4487646094191947e-05,68.21557028273556,4269
0,0,0,0,0,0,0,0.0,68.21542620480463,4269
0,0,0,0,0,0,0,0.0,68.21542597235718,4269
0,0,0,0,0,0,0,0.002801186247172501,68.2362574991874,4271
0,0,0,0,0,0,0,0.002800279319280681,68.28320784150569,4274
0,0,0,0,0,0,0,0.004116265828310039,68.29885166439585,4277
0,0,0,0,0,0,0,0.005789506060290824,68.31449460895193,4278
1,0,0,0,0,0,1,0.007133755376813643,68.340482652607,4280
0,0,0,0,0,0,0,0.0019429053176981451,68.35612607212614,4279
0,0,0,0,0,0,0,0.004809911571518085,68.35612607212614,4280
0,0,0,0,0,0,0,0.0,68.37177063529663,4279
0,0,0,0,0,0,0,0.002838499721144889,68.48064749752649,4282
0,0,0,0,0,0,0,0.0028083539592247456,68.48064749752649,4282
0,0,0,0,0,0,0,0.00393546666534927,68.50662020864938,4285
0,0,0,0,0,0,0,0.00565191451073269,68.52909356103352,4286
0,0,0,0,0,0,0,0.003353843767643859,68.5451618964415,4288
0,0,0,0,0,0,0,0.0008124432782096124,68.57598512856771,4288
0,0,0,0,0,0,0,0.0,68.60728295875592,4289
0,0,0,0,0,0,0,0.0,68.6230961961236,4290
0,0,0,0,0,0,0,0.002660907056023786,68.63874584515483,4292
0,0,0,0,0,0,0,0.0037159346537135696,68.65438637799642,4294
0,0,0,0,0,0,0,0.0,68.67014593453433,4293
0,0,0,0,0,0,0,0.0,68.67014593453433,4293
0,0,0,0,0,0,0,0.001356157656742974,68.67014593453433,4294
0,0,0,0,0,0,0,0.005272844873305857,68.67014593453433,4295
0,0,0,0,0,0,0,1.3267556151397388e-05,68.70163989249085,4295
0,0,0,0,0,0,0,0.00264090509126804,68.70142262879862,4296
0,0,0,0,0,0,0,0.00027962068408000066,68.70142262879862,4296
0,0,0,0,0,0,0,0.002489986920706306,68.71706101479353,4297
0,0,0,0,0,0,0,0.002627479057535373,68.71706101479353,4297
1,0,0,0,0,0,1,0.0019390783738812967,68.71706101479353,4297
0,0,0,0,0,0,0,0.0,68.71706101479353,4296
0,0,0,0,0,0,0,0.005334538649596494,68.71706101479353,4299
0,0,0,0,0,0,0,0.002800385756535689,68.7328647797744,4299
0,0,0,0,0,0,0,0.0023649245957215056,68.7639758009053,4300
0,0,0,0,0,0,0,0.005407236563377437,68.7639758009053,4301
0,0,0,0,0,0,0,0.00019066741016673792,68.7639758009053,4300
0,0,0,0,0,0,0,0.00287908603235,68.77961403707926,4301
0,0,0,0,0,0,0,0.002677933002406935,68.79525921937477,4302
0,0,0,0,0,0,0,0.0023638803474692388,68.79525245565463,4303
0,0,0,0,0,0,0,0.002851999722633759,68.79525245565463,4302
0,0,0,0,0,0,0,0.0019643106770235444,68.81089383738015,4303
0,0,0,0,0,0,0,0.002630879188442567,68.81089081881804,4303
0,0,0,0,0,0,0,0.0,68.81089081881804,4302
0,0,0,0,0,0,0,0.0,68.81089081881804,4302
0,0,0,0,0,0,0,0.007536925620852206,68.81089081881804,4305
0,0,0,0,0,0,0,0.002751932537507036,68.81089081881804,4304
0,0,0,0,0,0,0,0.0,68.84229674375842,4304
0,0,0,0,0,0,0,0.0,68.84229674375842,4304
0,0,0,0,0,0,0,0.0,68.84229674375842,4304
0,0,0,0,0,0,0,0.0015626677781768986,68.84229674375842,4306
0,0,0,0,0,0,0,0.00556576526935712,68.85799505926809,4307
0,0,0,0,0,0,0,0.0007923397792288131,68.87364692370231,4307
0,0,0,0,0,0,0,0.0,68.88927157661921,4308
0,0,0,0,0,0,0,0.002811191935027788,68.88927157661921,4308
0,0,0,0,0,0,0,0.0,68.90490999272511,4308
0,0,0,0,0,0,0,0.0,68.90490999272511,4308
0,0,0,0,0,0,0,0.0,68.92504426213213,4309
0,0,0,0,0,0,0,0.0,68.92504426213213,4309
0,0,0,0,0,0,0,0.0,68.92504426213213,4309
0,0,0,0,0,0,0,0.0,68.92504426213213,4309
0,0,0,0,0,0,0,0.0,68.92504426213213,4309
0,0,0,0,0,0,0,0.0006167810841997234,68.92504426213213,4310
1,0,0,0,0,0,1,0.0026424023114023794,68.92504426213213,4310
0,0,0,0,0,0,0,0.0,68.92504426213213,4309
0,0,0,0,0,0,0,0.0,68.92504426213213,4309
0,0,0,0,0,0,0,0.0,68.92504426213213,4309
0,0,0,0,0,0,0,0.0027896141488831104,68.92504426213213,4310
0,0,0,0,0,0,0,4.4934416033225e-06,68.94069054235293,4310
0,0,0,0,0,0,0,0.0,68.94068259839867,4310
0,0,0,0,0,0,0,0.006983704800457104,68.95634970861124,4315
0,0,0,0,0,0,0,0.004015594881632154,68.97218202107189,4315
0,0,0,0,0,0,0,0.0008959893206483147,69.0190970067776,4316
0,0,0,0,0,0,0,0.0027847708590122405,69.01909678143284,4316
0,0,0,0,0,0,0,0.0026091830112447006,69.03473509817775,4317
0,0,0,0,0,0,0,0.00022717977681808424,69.03473509817775,4317
0,0,0,0,0,0,0,0.0,69.05037332338985,4317
0,0,0,0,0,0,0,0.0,69.05037332338985,4317
0,0,0,0,0,0,0,0.0,69.05037332338985,4317
0,0,0,0,0,0,0,0.0028504206549532403,69.05037332338985,4318
0,0,0,0,0,0,0,0.0,69.05037332338985,4317
0,0,0,0,0,0,0,0.0,69.05037332338985,4317
0,0,0,0,0,0,0,0.0,69.05037332338985,4317
0,0,0,0,0,0,0,0.002097437055693399,69.05037332338985,4318
1,0,0,0,0,0,1,0.0069194379185424475,69.05037332338985,4320
0,0,0,0,0,0,0,0.0,69.08164993586576,4319
0,0,0,0,0,0,0,0.0033202184113425783,69.08164993586576,4321
0,0,0,0,0,0,0,0.0027419142280892357,69.0973046223231,4321
0,0,0,0,0,0,0,0.0,69.1129266727009,4321
0,0,0,0,0,0,0,0.0,69.1129266727009,4321
0,0,0,0,0,0,0,0.0,69.1129266727009,4321
0,0,0,0,0,0,0,0.0,69.1129266727009,4321
0,0,0,0,0,0,0,0.002852562103896285,69.1129266727009,4322
0,0,0,0,0,0,0,1.254963390066858e-07,69.12856656241081,4322
0,0,0,0,0,0,0,0.00215374857107345,69.12856499522127,4323
0,0,0,0,0,0,0,3.712173519883014e-05,69.12856499522127,4323
1,0,0,0,0,0,1,0.0038799996761809713,69.1442033520231,4325
0,0,0,0,0,0,0,0.002636712278869644,69.1442033520231,4324
0,0,0,0,0,0,0,0.0,69.1442033520231,4323
0,0,0,0,0,0,0,0.0,69.1442033520231,4323
0,0,0,0,0,0,0,0.0014012091942596752,69.1442033520231,4324
0,0,0,0,0,0,0,0.002727450521070093,69.1442033520231,4324
0,0,0,0,0,0,0,0.002616237616241857,69.1442033520231,4324
0,0,0,0,0,0,0,1.5982370745252053e-07,69.15173898022366,4324
0,0,0,0,0,0,0,0.002803582947378214,69.15173898022366,4325
0,0,0,0,0,0,0,0.0024716371486576574,69.16746070937957,4326
0,0,0,0,0,0,0,0.0,69.16746070937957,4325
0,0,0,0,0,0,0,0.0021641911942123426,69.16746070937957,4326
0,0,0,0,0,0,0,2.7728573942017972e-05,69.18319549565652,4326
0,0,0,0,0,0,0,0.004590023068780881,69.18309905619371,4328
0,0,0,0,0,0,0,0.0027600176948281777,69.21438294224997,4329
0,0,0,0,0,0,0,4.7584392204093566e-07,69.23001585388346,4329
0,0,0,0,0,0,0,0.0,69.23001403100272,4329
0,0,0,0,0,0,0,0.0,69.23001403100272,4329
0,0,0,0,0,0,0,0.0,69.23001403100272,4329
