throughput_KLONGTEI,throughput_KASEMRAT,throughput_NARANONG,throughput_SUNLAKAKHON,throughput_RAMA4, throughput_ATTHAKAVI_RAMA4,throughput,mean_speed,jamlength_percent,Backlog
0,0,0,0,0,0,0,8.566167694248364,0.0,11
0,0,0,0,0,0,0,9.750456570092979,0.0,29
0,1,0,0,0,0,1,9.338028947159692,0.025973606121707477,54
0,0,0,0,0,0,0,9.669049426998589,0.06430796212722037,80
0,0,2,0,0,1,3,9.55501616194835,0.10722422464855884,101
1,1,1,0,0,0,3,9.415377350588392,0.15163411048471084,128
1,3,1,0,0,0,5,9.590469949552858,0.2054090926623168,155
1,5,3,10,2,1,22,10.067739984899866,0.140709394202958,177
2,4,0,4,0,1,11,9.32951790318696,0.32843150608724514,204
6,4,1,3,2,0,16,8.83629770098325,0.5008991638900888,238
5,1,1,5,5,1,18,8.579868061689034,0.6489479747507878,269
4,12,0,5,3,5,29,8.545291230810767,0.6861705461451082,293
6,13,0,4,3,0,26,7.839812849204119,0.9686369059897576,317
5,2,2,6,3,2,20,7.43045351069154,1.2963920465942176,337
9,3,0,3,4,2,21,6.794981894231771,1.643394679726387,369
6,4,7,1,2,1,21,6.213685123230943,2.123453775673492,394
3,1,1,1,0,3,9,5.674205526364768,2.594909512412646,421
4,12,1,16,1,2,36,5.299491490545216,2.9039603408539683,432
5,6,1,2,0,1,15,4.935801582381267,3.362329524294677,464
13,4,11,1,23,2,54,5.511946710011708,2.8890756511295104,487
9,5,10,0,26,2,52,6.008257274762277,2.7985233786193495,510
9,4,10,2,6,1,32,5.887992052224458,3.162886813482715,536
8,4,12,3,8,4,39,5.431229253144239,3.5417989535952916,555
12,18,7,1,7,9,54,5.145161966464597,3.694669197604973,574
8,7,7,14,6,16,58,5.206663456015527,3.8295741143660766,599
11,15,8,12,6,14,66,5.850888891473866,3.57746740431454,625
10,13,6,11,8,16,64,5.7351338028496,3.844850191917334,637
9,14,8,10,7,9,57,5.590268511699632,4.104744988028123,638
6,8,17,9,24,9,73,5.455024592840182,4.206169139142473,657
29,16,11,2,24,7,89,5.449572291470728,4.392332955469792,671
24,8,6,3,8,7,56,4.876686021041384,4.871392527024272,672
11,8,11,2,7,9,48,4.483024437122439,5.31885645367276,690
8,9,9,3,9,10,48,4.337100714761058,5.806148598869451,704
8,8,11,3,7,9,46,3.98976108466253,6.263096761860159,722
4,9,4,3,7,5,32,3.593058137845824,6.841265170825354,728
9,7,0,2,14,7,39,3.4979054800598486,6.925524376084572,755
10,6,2,3,9,7,37,3.1952629889538886,7.26611911128773,770
10,9,7,17,6,1,50,3.596833551722595,7.243582070659786,788
3,22,9,20,9,2,65,3.8776823578862305,6.975998212702021,810
23,21,8,13,2,2,69,3.7948487423291164,7.1997013689417795,815
6,13,6,0,13,8,46,3.9609708265396915,7.549130463727358,831
4,8,0,12,9,3,36,3.6668429234601128,7.821129987302027,850
4,5,10,11,0,3,33,3.533520607343399,8.0106928820696,870
3,5,10,9,1,2,30,3.035502967451285,8.66791114818457,874
2,5,10,8,1,5,31,2.783288125860351,8.93757988516152,881
7,10,10,2,23,7,59,3.079550420859657,8.757687972489261,911
12,10,11,16,27,5,81,3.5396437448284743,8.037998292549275,918
17,20,6,20,24,4,91,3.874324976655903,7.832130250804535,938
8,17,5,15,13,3,61,3.5965420218810857,8.463495059553567,945
4,15,5,3,26,10,63,3.5044846938493226,8.739091500422441,946
34,5,5,15,12,16,87,3.4302312795359695,8.850120890886316,943
19,13,5,11,7,15,70,3.4221626375212177,8.910721769003807,941
12,12,6,11,9,1,51,3.2521570526272208,9.08517422827595,955
11,15,5,5,10,8,54,2.9551725728371836,9.627552969113456,951
9,11,5,4,8,9,46,2.7248468188625954,10.20839337359844,969
6,15,6,3,12,7,49,2.67301750185308,10.432474195530974,983
4,9,8,4,5,9,39,2.8275479975229634,10.36857495566494,1007
4,7,11,4,9,9,44,2.805051738041395,10.546897424270771,1026
4,8,10,4,7,7,40,2.6341801611852027,11.054114499505848,1051
0,4,10,15,7,9,45,2.810654072867656,10.638776837609534,1076
9,4,14,13,9,9,58,2.8346906249859063,10.900237539733647,1104
7,0,12,7,5,7,38,2.781188145743586,10.98506457561632,1119
8,19,13,3,5,9,57,2.9112368994910813,10.824950968307194,1122
7,16,11,6,6,9,55,2.812686625568961,11.262683769595084,1143
3,18,14,3,7,6,51,2.762875021780286,11.31833243777663,1158
4,16,11,1,9,10,51,2.8323844356684855,11.871386805398188,1178
3,18,8,2,7,9,47,2.577600524905305,12.424798886327418,1190
1,12,10,10,3,11,47,2.3698723888350566,12.782832956713582,1201
0,3,10,7,2,9,31,2.0395401819976535,13.931986415167458,1220
7,6,10,2,6,9,40,1.9577664031170323,14.33743801125734,1242
0,2,11,0,17,9,39,1.9248661629744328,14.671437287719838,1262
10,18,10,1,22,3,64,2.2058220275393916,13.962340475656735,1277
14,16,11,1,22,3,67,2.3153882755667663,13.949484453512214,1286
16,18,10,16,20,4,84,2.338704085668012,13.735623804400774,1289
16,15,10,20,29,6,96,2.6337926926407693,13.232388085330859,1294
12,13,14,23,24,3,89,2.5345194294460844,13.565700408193607,1308
27,6,12,20,6,4,75,2.3459323525785973,13.530382775221357,1276
15,9,12,21,12,5,74,2.232606067182664,14.01501585623445,1279
12,6,6,19,9,3,55,2.0817245887912517,13.97611763221743,1263
15,8,6,19,7,5,60,1.8972167782557956,14.213704492255525,1249
12,9,5,5,7,7,45,1.9327812194912721,14.075502753472314,1271
7,16,7,8,8,4,50,1.988360228415092,14.41744655413367,1283
8,24,5,5,6,3,51,2.0852341995929593,14.370835509487943,1297
8,14,9,1,4,4,40,2.098339292544802,14.512730191981332,1298
6,10,6,7,8,6,43,2.2789228083571618,14.836196570691579,1343
5,12,6,12,6,3,44,2.3039384429041174,14.688821630192722,1365
2,16,9,11,9,2,49,2.244301627526542,14.84246340014404,1383
4,9,3,13,12,2,43,2.071747665179837,15.315456371849255,1386
2,9,14,9,15,7,56,1.9535518361032285,15.436598195135387,1387
0,17,11,3,16,8,55,2.126627499387541,15.660783380429123,1405
3,20,3,4,13,5,48,1.9764579515900393,16.747195799859703,1427
10,15,0,4,22,16,67,2.145485532244511,15.741996536617425,1447
12,12,0,2,11,18,55,2.263338483218281,15.357700778850196,1453
7,16,10,0,7,18,58,2.2691113946760426,15.546939544533735,1474
13,16,11,9,1,20,70,2.0456437385888804,15.795470640690029,1468
9,8,10,7,29,19,82,2.1136981888386095,15.483214319052722,1481
9,10,11,7,32,19,88,2.091999185887374,15.831057606555161,1487
6,12,10,7,13,15,63,1.9740246875307312,16.521966454210666,1506
8,20,9,5,8,13,63,1.915287575907214,16.431223847222938,1516
3,28,5,1,12,15,64,2.0334071827985563,16.913756526449866,1531
39,21,5,2,3,4,74,2.198109604379347,16.388288658692613,1542
21,14,5,3,17,11,71,2.200432592666882,15.958683707697443,1533
27,16,9,3,15,13,83,1.9959411321358924,16.720992568109295,1526
19,16,10,3,9,11,68,1.8677363271445437,17.03220546591463,1525
10,2,8,2,7,12,41,1.7807426205678356,17.84499406493198,1531
12,1,5,7,10,14,49,1.6796293508968458,18.482991720960772,1546
5,4,5,5,8,14,41,1.6177200394446798,18.388604046796765,1539
5,25,6,13,5,4,58,1.6625429674592922,17.888659814910184,1525
4,15,9,8,6,9,51,1.7203325246097858,17.802177101599472,1517
2,13,5,6,4,9,39,1.7330015043247051,17.761304057653845,1539
4,14,5,7,4,10,44,1.8392850266808694,17.448378921390166,1536
10,9,5,17,7,9,57,1.9654651796811924,17.0554845775032,1554
10,6,5,21,21,9,72,2.1318280127363938,16.79543029833005,1572
3,0,6,21,26,10,66,2.0518660069089023,17.516074525530495,1578
10,0,15,21,20,8,74,2.069300873887853,16.771243554968358,1561
7,0,11,20,19,8,65,2.02545374148903,17.38957369372589,1566
6,17,10,14,4,9,60,1.7590800133782316,17.83013746052879,1564
7,20,9,0,9,9,54,1.717388836693842,18.35761689130091,1581
10,13,6,0,6,9,44,1.7404394841482504,18.0926244452873,1593
4,13,6,0,7,8,38,1.6467337320092885,18.34884752043583,1620
29,16,5,0,8,3,61,1.7027481777621278,18.732310552869084,1630
17,17,5,11,8,4,62,1.8419424952070165,18.61857444148747,1639
13,9,7,15,18,4,66,1.8488428741998142,18.715376448193272,1645
11,8,6,9,21,3,58,1.7948463849337122,19.611620785025128,1669
14,9,5,3,8,1,40,1.8266224440151788,19.538628713213136,1685
13,16,5,6,9,5,54,1.8519193935595348,19.45967394692888,1692
9,31,11,4,10,3,68,1.8386460423298119,19.32063127768377,1727
8,28,10,3,5,5,59,1.9163111366330645,19.295121177318745,1742
14,23,10,2,4,17,70,1.9413557048036079,18.993574944675444,1727
0,18,10,3,8,20,59,1.8340751406239386,19.659144052822807,1748
19,21,11,7,11,18,87,1.957694860936813,19.417138914249602,1737
4,13,12,8,6,19,62,1.6800186260862244,20.1649991517934,1739
10,8,15,0,6,17,56,1.6483820993854705,20.429804796945998,1755
4,6,9,2,6,17,44,1.6781241162478193,20.5926613121081,1764
4,23,2,9,7,17,62,1.7410738020982528,20.208878346715796,1762
12,23,5,7,15,16,78,1.7862493495084582,20.662800090532908,1765
11,25,6,7,9,15,73,1.6310801653496574,20.472949497961633,1740
11,20,5,7,10,12,65,1.5633687163198051,20.505209631632315,1731
13,11,5,17,7,1,54,1.3961797699815082,21.19198941729253,1731
0,10,5,20,9,6,50,1.3659220361054338,21.058536078909313,1732
23,4,5,21,8,7,68,1.5765184380918644,20.601203822589603,1717
10,3,9,21,8,9,60,1.5642866314681372,20.45781095472538,1711
11,3,6,20,3,10,53,1.3170706900070677,21.40800054578046,1707
8,18,12,13,7,9,67,1.359511432243148,21.613793555269442,1696
16,22,7,8,17,9,79,1.6897820981057123,20.777807619237624,1708
8,18,6,9,23,10,74,1.83716925666892,20.60109838032458,1722
13,20,11,9,13,1,67,1.841079075418737,20.120530845798193,1732
16,13,15,4,7,4,59,1.6397893753200805,20.431698103651172,1720
9,5,15,2,14,1,46,1.6960096992834954,19.837610124706913,1723
0,6,15,6,15,6,48,1.7392198958929737,20.031953259605903,1717
15,9,15,3,18,7,67,1.770938218366389,19.852275483494473,1716
6,11,16,10,15,3,61,1.5949439470431246,20.258454889179713,1714
2,19,7,9,13,3,53,1.557350881763274,20.878309002154875,1727
7,17,5,6,30,3,68,1.5914974840618787,21.195829215349832,1759
15,18,4,2,23,3,65,1.662555284953255,21.21027694886213,1765
29,8,9,4,18,19,87,1.6871768943110494,20.794062911341854,1761
23,10,9,5,20,17,84,1.6794215723976074,20.557757100386507,1749
23,15,7,9,15,15,84,1.557356628282209,20.87363748390887,1728
18,8,5,8,12,14,65,1.6771679963396648,20.23400707744883,1732
3,10,5,12,16,18,64,1.8975551096802925,19.861969820807424,1753
20,9,5,11,14,17,76,1.921343417033903,19.676409221489067,1743
6,25,5,4,19,19,78,1.955535017047956,19.34605330335984,1737
4,16,10,0,13,17,60,1.8707101233250059,19.606048844239545,1730
7,21,7,1,8,11,55,1.7770768520816072,20.203792595429377,1754
8,20,8,2,5,14,57,1.7605716650550394,20.16515143952597,1745
8,12,6,0,14,13,53,1.6258401324816343,20.97217010921734,1747
6,4,3,15,7,2,37,1.5715867187419743,21.404498901284473,1772
2,1,5,16,11,7,42,1.4268886413478423,21.479689902301484,1770
1,3,7,10,11,8,40,1.4205820567119032,22.196702567260612,1785
0,1,6,7,6,9,29,1.3644740225559562,22.866364364311995,1778
0,18,9,7,3,10,47,1.5088437289846488,22.33499420269634,1809
6,20,5,7,20,9,67,1.6630816945631657,21.905263313869465,1818
4,18,8,8,24,8,70,1.7134163035058134,21.991034051798255,1832
11,16,10,3,26,10,76,1.8776473565160652,21.469646015399793,1856
7,17,6,17,20,9,76,1.8275357563301635,21.552330895697906,1859
6,10,10,20,2,10,58,1.6960136293798402,21.562898203838458,1866
6,4,10,22,9,10,61,1.6809682521242229,21.532804548805718,1856
11,0,10,19,8,7,55,1.6642119221944376,21.166215362119146,1864
9,7,10,21,5,5,57,1.6228076341948592,21.663078876462894,1873
11,21,10,21,6,6,75,1.6156423083596028,21.537659876573322,1855
35,24,10,18,5,3,95,1.7920859104662488,21.605483109599643,1839
14,23,8,13,16,5,79,1.77594414607644,21.27809927802822,1849
8,21,5,7,18,5,64,1.7645048355656692,21.59996199680071,1850
26,12,13,8,24,4,87,1.8471999742782534,21.320939103379466,1841
32,8,13,8,21,3,85,1.9686492495298402,19.759051831466714,1828
29,7,13,4,16,5,74,1.80684417426451,20.59410280822802,1822
16,6,10,5,6,3,46,1.6056157196614511,21.45904935329715,1836
3,6,7,4,13,6,39,1.5676461534092685,21.758611057888384,1835
2,22,10,5,8,3,50,1.569483546594764,21.57842876278766,1841
2,16,8,5,8,3,42,1.5561664432764892,21.922364445680252,1871
1,12,10,5,8,1,37,1.4335953850720244,22.756585008920023,1875
0,7,7,5,11,1,31,1.3291416474678512,23.345648018845285,1889
3,2,6,4,4,0,19,1.2042199790168384,24.347058152273824,1925
2,2,4,1,4,4,17,1.0753830974179646,25.304562632787885,1946
1,8,10,4,2,7,32,1.0772663136450202,25.60647898923162,1973
1,9,10,0,0,3,23,1.072337667593745,25.768825140438523,1990
2,10,13,7,14,5,51,1.2155323016076187,25.894423769240262,2006
5,22,9,8,16,5,65,1.1829020546638673,25.54471825887186,2001
9,18,5,7,18,4,61,1.3148489745255096,25.784597040682165,2031
7,13,6,8,15,17,66,1.3816268017286215,25.210341889904278,2039
8,14,5,5,9,19,60,1.348702226082794,25.129982923360163,2067
8,14,5,4,8,21,60,1.2887919235098633,25.752560973086975,2077
7,15,5,10,12,17,66,1.482478426222674,24.184667082674483,2100
6,8,9,11,8,17,59,1.4505426474770569,24.25757693293352,2100
11,12,13,1,5,19,61,1.4930044289457103,24.472111308847154,2111
15,9,10,2,13,18,67,1.6022799095189175,23.835808600132086,2125
12,27,10,3,7,12,71,1.6448585141292593,23.98252312405892,2119
15,26,18,2,19,17,97,1.737647183673492,23.492071972489136,2112
16,31,11,3,13,19,93,1.6947948009023381,24.039505504671617,2132
1,20,2,13,11,14,61,1.4445918223761176,25.060100750973817,2145
23,16,5,9,1,14,68,1.3523690461760691,25.94036170955889,2130
9,14,5,8,7,15,58,1.3388016987100881,26.019488467063322,2113
12,3,5,10,10,1,41,1.216244975968977,25.877145673409487,2125
13,1,8,3,4,8,37,1.216311820065403,26.146776529703452,2124
7,2,6,18,4,8,45,1.270832879988977,25.80928749530157,2114
11,19,5,19,7,9,70,1.3559157317257164,25.719109418391955,2106
7,21,5,22,5,10,70,1.4068180255656464,25.683456506820093,2111
7,19,13,20,5,7,71,1.3622369208245448,26.03325202507659,2087
7,17,8,20,15,9,76,1.4103944375923687,25.476766056532007,2075
0,12,6,22,8,9,57,1.4678484381297126,25.55888725398923,2084
8,10,8,14,8,9,57,1.390767330914997,25.736568809876555,2068
0,3,8,12,14,9,46,1.260300990755445,25.9775586121482,2066
3,6,7,11,11,9,47,1.105831742482517,26.87472236111715,2081
7,3,5,10,22,5,52,1.182434126019635,26.671976984135068,2084
8,17,7,4,24,5,65,1.246403130832846,26.38400362611631,2084
5,18,5,6,20,9,63,1.1929562362603996,26.876927685000993,2106
6,20,14,4,17,5,66,1.0459964418842325,27.16464921030379,2098
5,20,15,6,21,4,71,1.1375845990667788,26.99907450494237,2087
9,9,15,11,14,4,62,1.125142696686268,27.129073932064678,2096
0,8,15,15,3,6,47,1.066048136622597,27.471909851215116,2100
35,0,15,15,0,4,69,1.1618761927148653,27.294785990975832,2086
5,0,10,9,6,4,34,1.123358768161894,27.429544817063555,2084
5,1,10,2,0,3,21,1.1182530619126132,27.53218509400249,2089
7,21,8,9,0,1,46,1.19178713542052,27.24706201560801,2107
21,16,8,15,21,4,85,1.2267565737550485,26.877071382249955,2114
25,9,5,10,13,7,69,1.1665503884983135,27.267298314246442,2107
12,7,5,12,11,6,53,1.1683832306450697,27.360306934660056,2118
10,6,6,4,6,6,38,1.0744770066970444,27.35871821180508,2109
0,10,5,3,5,5,28,1.0922239772440698,27.40634779371976,2125
5,1,6,2,6,2,22,1.126914999302507,27.57235181678001,2137
12,0,5,0,13,6,36,1.1808866708633723,27.7041206306963,2163
8,1,5,0,10,4,28,1.0454898405115032,27.89057863969703,2189
5,10,6,0,4,5,30,0.9852873516225166,28.184677567483835,2213
8,11,7,0,19,3,48,1.0207031726534415,28.27549719306824,2231
8,11,6,8,21,3,57,1.0927210424691052,28.869869745300655,2253
11,6,5,7,17,6,52,1.0313972225198214,29.353934972690777,2271
9,8,5,3,8,18,51,1.0785897834458626,28.629000071642423,2268
8,10,6,1,7,3,35,1.1141694040903714,28.795789579155798,2284
11,6,5,1,13,4,40,1.0810794674271527,29.044377849910152,2304
7,2,14,0,8,17,48,1.0711808211314926,28.58714735087699,2310
22,2,13,1,4,2,44,1.072623960351754,28.572410289203813,2317
7,19,8,0,9,17,60,1.1578535607387985,28.170813350089176,2320
10,20,5,0,15,4,54,1.267245239454176,27.184048392138784,2331
10,17,6,15,13,8,69,1.2163793839297719,27.999088870270633,2327
13,18,5,23,12,16,87,1.3372402680760074,27.214740385739006,2307
13,10,5,22,13,3,66,1.2512687000383411,27.194916361668373,2300
12,7,5,21,7,17,69,1.2866062482592973,27.02397921132684,2290
14,2,5,22,12,3,58,1.1463212636910511,28.072989901156603,2303
10,1,6,14,10,17,58,1.1035131190977625,28.0429145585204,2294
6,2,12,5,5,3,33,0.9177818257408628,28.36225959439432,2293
27,14,8,2,4,17,72,1.0722964208064623,27.360928041633098,2291
13,11,6,1,6,3,40,1.0269693558209996,27.915570034512736,2293
11,13,6,1,5,6,42,1.0108984336165379,29.062703828147125,2304
6,13,5,1,8,4,37,0.9261172347329341,29.767659777880738,2310
7,15,5,1,14,4,46,0.9757722771108008,29.432207196199588,2309
11,10,7,7,20,5,60,1.0204954953018335,30.07226248986498,2325
13,0,4,5,20,5,47,0.9240355928104499,30.819161788001978,2341
9,2,6,5,11,16,49,0.8468442676110032,31.144252409388866,2333
8,2,5,0,5,5,25,0.7931699574598932,31.81853680865021,2352
0,0,5,0,4,16,25,0.7179365631126341,32.01269503477791,2357
5,1,5,0,8,3,22,0.7861742052997137,32.18009439297309,2370
4,11,6,0,10,11,42,0.8840094675524547,31.87506618002522,2383
11,10,11,0,5,4,41,0.9871358478655836,30.77516291056447,2401
7,8,5,0,7,13,40,1.0134328100472225,31.143720545387424,2423
14,2,6,2,8,4,36,0.9643357920856901,31.090028149906885,2432
14,1,5,0,14,3,37,0.9733430972729805,31.497270949224035,2440
11,2,7,0,13,1,34,0.8732463131194502,32.04613228812815,2428
10,7,5,0,10,0,32,0.8447894963763064,32.45721115878964,2437
3,1,8,0,14,0,26,0.751326099608106,33.22752565320439,2446
0,0,12,0,6,0,18,0.7658209753875309,33.74508942302001,2456
4,3,9,0,21,0,37,0.8442832961719645,32.54370474765772,2456
9,1,5,0,21,0,36,0.9176209016895214,32.68811132733413,2469
8,1,5,0,14,4,32,0.8249908365210726,32.876929849519755,2490
6,1,9,15,4,0,35,0.8484243182625719,32.79098837618513,2494
8,4,15,14,2,0,43,0.7242463095294659,32.78450551995861,2476
6,1,15,12,15,0,49,0.7276189023242234,33.20143715038873,2465
6,1,15,10,12,0,44,0.7476112582615999,33.34158488372604,2458
6,3,11,7,3,0,30,0.6542470566191451,33.58706541460645,2457
10,0,8,0,2,0,20,0.6645818161240736,33.922596850988256,2464
0,2,9,2,0,0,13,0.6584443247540813,34.50825696061387,2504
32,1,8,3,0,0,44,0.6203663611125162,34.98420460379967,2498
7,0,7,0,11,0,25,0.6723975101755144,34.808697102705125,2514
16,2,10,1,13,0,42,0.6654360606007904,35.16111145733079,2525
21,3,5,2,7,0,38,0.6603227022782037,35.162311395560636,2530
14,1,5,0,6,0,26,0.6333468525482352,35.79993342106266,2542
13,0,6,2,14,0,35,0.6560312254156232,35.34066611959471,2549
5,2,5,3,6,0,21,0.722620422508109,35.473095006990405,2562
2,3,5,0,2,0,12,0.6692734798792677,35.6385636413206,2589
2,1,5,0,0,0,8,0.6035204291469592,36.29916144891915,2600
0,1,7,0,0,0,8,0.5679915846681506,36.85007888654549,2611
0,2,5,0,3,0,10,0.5658672501719355,37.211758381872436,2631
8,2,5,0,0,0,15,0.5858989487102053,36.82985812786037,2640
3,2,6,0,0,0,11,0.5762762948461843,37.423106634314244,2653
1,1,5,0,0,0,7,0.5564060047169298,37.95447362854292,2678
0,4,0,0,0,0,4,0.5106691446106132,38.59640389128159,2694
2,0,6,0,1,0,9,0.4831585379274199,38.56988173082702,2713
1,0,11,0,0,0,12,0.48932313284420004,38.86321974808191,2739
0,1,10,0,3,0,14,0.4522860191251598,39.49072844444112,2752
0,0,14,0,3,0,17,0.4882260129369642,39.20988443067892,2767
2,2,12,0,9,0,25,0.5376902829803646,38.77373699655788,2777
3,2,11,0,1,0,17,0.4546312314599021,39.23958460631632,2799
1,1,10,0,0,0,12,0.4564742300081985,39.63174702791168,2823
5,1,11,0,0,0,17,0.4107281457914467,39.659562582228574,2825
4,2,10,11,9,0,36,0.5284979631390578,39.427165107657395,2833
2,1,12,13,9,0,37,0.4748782290006352,39.80939489559563,2851
1,2,7,3,13,0,26,0.4829807832826671,40.0659142210832,2880
0,1,8,2,5,0,16,0.486666544473917,39.97892414794251,2899
0,1,7,1,7,0,16,0.4555243485525896,40.6607242456813,2915
1,0,6,2,6,0,15,0.4276077163069342,41.103301360246284,2916
0,1,5,1,0,0,7,0.390211967376222,41.933350333250594,2937
8,3,6,1,0,0,18,0.41251455028381534,41.83219100993973,2947
9,3,3,0,0,0,15,0.40510707802398566,41.60159964189281,2956
0,2,12,1,0,0,15,0.38828020639256,41.96349081505691,2965
0,2,0,2,0,0,4,0.3837878543579112,42.27309409327954,2980
0,1,0,2,0,0,3,0.3691425976893915,42.55420939139396,2992
0,1,0,0,0,0,1,0.34158167492375596,43.19180699466186,3015
0,0,0,0,0,0,0,0.29144711657391725,43.744441362142624,3035
0,2,10,0,11,0,23,0.3724348232789427,43.57065378984997,3056
0,3,9,0,14,0,26,0.39004377698442666,43.70492419653798,3069
0,0,1,0,2,0,3,0.37742317353298194,43.995329864676236,3088
0,0,0,0,0,0,0,0.31860403698265505,44.28473726364994,3104
23,0,5,0,1,0,29,0.30977234170200035,44.279177781233166,3094
2,0,5,0,1,0,8,0.32298086804118903,43.6289848147655,3097
0,0,5,0,0,0,5,0.33000335845570417,43.9818311321025,3099
0,0,6,0,13,0,19,0.31899655646122954,44.22039836422953,3109
12,0,5,0,13,0,30,0.2924650131946777,44.74521864464884,3105
14,0,6,0,9,0,29,0.29183178796392956,44.98967443511261,3107
9,0,0,0,5,0,14,0.25677878168228496,45.6530495145107,3128
3,0,4,0,8,0,15,0.24703519487392667,45.54342357702214,3124
1,0,5,0,12,0,18,0.2835938679022367,45.46478113080297,3144
0,0,5,0,3,0,8,0.2775227841677046,45.48639834707285,3160
4,0,8,0,6,0,18,0.22615945439345744,45.86172596624852,3162
3,0,5,0,3,0,11,0.19502553152913762,46.177828608065525,3164
2,0,0,11,1,0,14,0.19615004761325877,46.220895051024456,3168
1,0,0,0,0,0,1,0.1709746368207486,46.63200255021285,3176
0,0,0,0,0,0,0,0.16609890750562958,46.892734263916694,3187
0,0,1,0,0,0,1,0.17074152312059854,46.99423219834176,3198
0,0,1,0,0,0,1,0.16314124904770566,47.26424127048966,3219
0,0,0,0,0,0,0,0.1655348981708292,47.802653488080225,3241
0,0,0,0,0,0,0,0.13401741642735268,48.27833884442943,3251
0,0,0,0,0,0,0,0.12911997923868263,48.49228673301556,3265
0,0,5,2,0,0,7,0.11061188219743165,48.750947899409006,3280
0,0,5,0,12,0,17,0.1391437711643244,48.73405709502077,3289
0,0,1,0,10,0,11,0.13046250447297827,49.00196218725881,3303
0,0,0,0,0,0,0,0.0987808333193798,49.23118009941527,3309
0,0,5,2,0,0,7,0.0793150394232841,49.202025861932846,3304
0,0,5,0,0,0,5,0.09280527332167003,49.21689323985987,3310
0,0,5,0,0,0,5,0.10082083563908556,49.34238728687031,3317
0,0,5,0,0,0,5,0.09751449012413516,49.580169298877486,3320
20,0,5,0,2,0,27,0.11176500029538199,49.530251603819174,3309
0,0,0,0,0,0,0,0.09121369539702717,49.72238333251527,3321
4,0,5,0,0,0,9,0.0937215448850037,49.512138243187266,3321
0,0,6,0,0,0,6,0.09530407204010624,49.590795903939565,3329
0,0,5,0,8,0,13,0.1292130258674659,49.44374724138223,3336
3,0,6,1,11,0,21,0.1251683088834647,49.45002455856904,3330
3,0,7,0,9,0,19,0.17773339220095838,49.1833609171897,3336
3,0,5,0,4,0,12,0.17098699181262192,48.9679912925446,3337
2,0,0,0,5,0,7,0.29142167748142533,48.52155149597405,3353
3,0,0,0,0,0,3,0.30062644190953314,48.64055902462159,3369
1,0,0,0,0,0,1,0.31501979538489955,48.273599423650154,3382
0,0,0,0,0,0,0,0.27316591903820103,49.01090134438896,3404
0,0,0,0,0,0,0,0.2291735421481015,49.91122712677571,3412
0,0,0,0,0,0,0,0.20036098382112913,50.0171449650597,3419
0,0,0,1,0,0,1,0.19940629894105552,50.230721045367325,3424
0,0,6,1,0,0,7,0.17219131423639458,50.98134894324561,3437
0,0,5,0,0,0,5,0.12043326027956036,51.77906474870435,3451
0,0,0,0,0,0,0,0.09038948976508579,52.87033703569782,3465
0,0,0,0,4,0,4,0.10253885226948291,53.3934042625349,3476
0,0,5,0,0,0,5,0.06323460915373891,55.70761098469104,3475
0,0,5,1,0,0,6,0.05953998394693466,53.743281762715114,3474
0,0,5,0,0,0,5,0.03143579199595928,55.39619932702294,3472
4,0,3,0,0,0,7,0.044012439339754766,55.19564562927472,3468
1,0,5,1,0,0,7,0.04974963659070389,56.38880746525393,3468
1,0,5,0,0,0,6,0.04724569019037978,56.60690229975463,3473
0,0,5,0,3,0,8,0.04580503778765014,56.52185551463834,3468
3,0,5,0,0,0,8,0.04879785433788885,56.388309501865805,3465
0,0,5,0,0,0,5,0.06675906233838208,56.3596212434245,3468
0,0,0,0,0,0,0,0.07096690541537143,56.35772949028257,3479
0,0,1,0,11,0,12,0.10700397188210725,56.15443837627674,3479
3,0,1,0,8,0,12,0.09572783960692542,56.01927550715451,3471
0,0,5,0,11,0,16,0.11903809271498561,55.79189383800686,3480
13,0,0,0,4,0,17,0.10379051002563679,56.51181255595259,3479
2,0,0,0,5,0,7,0.08183012547118894,56.63053820337194,3478
2,0,1,0,0,0,3,0.07541606369459264,56.33525926271953,3478
1,0,0,0,0,0,1,0.13594282333311858,53.057922903716104,3487
0,0,0,0,0,0,0,0.15948274553446568,51.892847663224366,3495
0,0,1,0,0,0,1,0.15666054251600148,52.48599029208978,3506
0,0,0,0,0,0,0,0.1491347885178,52.69154496128023,3515
0,0,0,0,0,0,0,0.10923858352914761,52.97144408962161,3522
0,0,5,0,0,0,5,0.05982044099789289,53.40671902804244,3524
0,0,5,0,0,0,5,0.0940423976294934,53.40956311079986,3522
0,0,1,0,0,0,1,0.08783303467566561,53.24893191973886,3524
0,0,5,0,2,0,7,0.10184226489910043,53.64886117047387,3525
0,0,6,2,0,0,8,0.09163258367523656,53.48160874063753,3520
0,0,5,1,0,0,6,0.10414218696966498,53.40703462176988,3522
0,0,6,0,0,0,6,0.09229560904381928,54.54497931476007,3525
0,0,5,1,0,0,6,0.08666555982557894,53.96389809512513,3522
0,0,0,0,0,0,0,0.0697438941671181,54.565556016812195,3530
0,0,1,0,0,0,1,0.04145698142130733,54.90927194515851,3531
2,0,0,1,2,0,5,0.022541649447059095,55.27522634088206,3533
0,0,0,0,1,0,1,0.009953001020100301,55.55925948069642,3532
3,0,0,0,0,0,3,0.013947918279073187,55.6024674535083,3533
0,0,0,0,2,0,2,0.02086418366513724,55.64945368833054,3538
3,0,0,0,8,0,11,0.04121234003501301,55.479165661584524,3536
2,0,2,0,12,0,16,0.07576944704202887,55.17982134773556,3534
2,0,4,0,7,0,13,0.12319287654851858,53.641110353781386,3535
2,0,2,0,7,0,11,0.13769417049336521,53.89163516198714,3542
5,0,0,0,7,0,12,0.13918529258450815,53.75826094930643,3551
2,0,0,0,0,0,2,0.14550744761407605,52.902177256567725,3558
1,0,5,0,0,0,6,0.1036716733520526,53.84458615613731,3560
0,0,6,0,0,0,6,0.06408686701491766,54.36021668735861,3563
0,0,5,0,0,0,5,0.04808917532741719,54.75436978433368,3566
0,0,0,0,0,0,0,0.03069378349618114,55.19554531020908,3571
0,0,5,0,0,0,5,0.03727119740486458,55.05390104187738,3567
0,0,7,0,0,0,7,0.03552038722213303,55.09898199210877,3566
1,0,5,0,0,0,6,0.05047575872988294,55.13881690888344,3570
0,0,6,0,0,0,6,0.047533169415189355,55.087191816595684,3571
0,0,5,0,2,0,7,0.03127031801496151,55.287372577615606,3569
0,0,0,0,0,0,0,0.01140750277284458,55.440082959002495,3574
0,0,0,0,0,0,0,0.02202442715881302,55.486852177750194,3581
0,0,0,0,0,0,0,0.012295018484655001,55.59672138743044,3582
2,0,2,0,0,0,4,0.023235902630129472,55.61297689306079,3586
0,0,0,0,0,0,0,0.023714237456186005,55.66110347850002,3588
1,0,0,0,0,0,1,0.02324716745698164,55.70988911675715,3592
0,0,0,0,0,0,0,0.01774773123803991,55.69005862990593,3592
0,0,0,1,0,0,1,0.0028149353512618956,55.78833699827505,3592
0,0,0,0,0,0,0,0.004081658447917315,55.84774732023093,3595
0,0,0,0,1,0,1,0.017439918279047194,55.86321959896682,3601
1,0,0,0,13,0,14,0.052720373507940795,55.57341448336913,3596
2,0,1,1,10,0,14,0.06401985834104129,55.543586174470086,3597
1,0,5,0,4,0,10,0.039454733569056634,55.590839383292135,3593
0,0,6,0,0,0,6,0.024967868143845204,55.64488964815194,3590
0,0,5,0,0,0,5,0.01756061326027887,55.685603036078,3587
0,0,0,0,0,0,0,0.008654903762151903,55.77429118899657,3589
0,0,0,0,0,0,0,0.018100079428971343,55.789917589056664,3594
0,0,0,0,0,0,0,0.017122649756843657,55.8315611131442,3597
0,0,0,0,0,0,0,0.010978532174117418,55.909800633452996,3600
0,0,0,0,0,0,0,0.013518964743540387,55.941278801201776,3602
0,0,0,0,0,0,0,0.01875293182293693,55.9725837012828,3606
0,0,0,0,0,0,0,0.00983153406817164,56.06681970556738,3610
0,0,0,0,0,0,0,0.015055029026405518,56.096917254036896,3616
0,0,0,0,0,0,0,0.023022554748921124,56.15955807051749,3620
0,0,0,0,3,0,3,0.019783069370392224,56.194160049116334,3621
0,0,0,0,1,0,1,0.012461523126802179,56.2833290692588,3625
0,0,0,0,0,0,0,0.009430657262610406,56.298994994610275,3625
0,0,0,0,0,0,0,0.0016138859836533899,56.32502345650232,3624
0,0,0,0,0,0,0,0.012701159057989641,56.325042352079485,3627
0,0,0,0,0,0,0,0.016095088840572012,56.35640753407105,3631
0,0,0,0,0,0,0,0.010312357538519699,56.39809388437945,3632
4,0,0,0,2,0,6,0.008634316052776387,56.384873042073814,3629
1,0,0,0,0,0,1,0.010346213270263834,56.42122268748791,3633
2,0,3,0,0,0,5,0.02025346615004894,56.39023811886569,3634
0,0,0,0,1,0,1,0.013225515538931875,56.45293892894533,3636
2,0,0,4,0,0,6,0.009470300305821917,56.48953445518895,3638
1,0,0,0,0,0,1,0.015258545214006635,56.58642628345541,3643
0,0,0,0,0,0,0,0.010299024022208348,56.596767262225065,3643
0,0,0,0,0,0,0,0.006534860526876252,56.62816872546228,3643
0,0,0,0,0,0,0,0.006558442470361523,56.6281884016866,3643
0,0,0,0,0,0,0,0.018329179870809835,56.63853933785078,3648
1,0,0,0,0,0,1,0.018934115114866888,56.669929377255045,3652
0,0,0,0,0,0,0,0.032292578558221756,56.69636915416137,3657
0,0,0,0,0,0,0,0.019787877777414427,56.73812323244617,3657
0,0,0,0,0,0,0,0.026072043772749347,56.745126334771136,3658
1,0,0,0,0,0,1,0.03356762454706863,56.760942924426864,3664
0,0,1,0,0,0,1,0.026165632151949177,56.83930583771346,3669
0,0,0,0,0,0,0,0.02662034719357883,56.92897176742124,3673
0,0,0,0,0,0,0,0.033829214073323496,56.95496065630552,3677
0,0,0,0,5,0,5,0.045478425627354796,56.9735866362474,3677
0,0,0,0,1,0,1,0.027271780522572054,57.049035681492015,3679
1,0,0,0,0,0,1,0.017147325077892104,57.10773919478826,3680
0,0,0,0,0,0,0,0.011679202197494718,57.14957156532151,3682
6,0,0,0,0,0,6,0.014165584146792061,57.124198300659216,3679
0,0,0,0,0,0,0,0.021922972934789318,57.121433165735176,3681
0,0,0,0,0,0,0,0.020508354055212796,57.17395679199076,3685
0,0,0,0,2,0,2,0.02855967144509738,57.195058609953286,3687
2,0,0,0,0,0,2,0.022428654659676982,57.24209778053345,3689
0,0,0,2,0,0,2,0.025172173676461313,57.26001554858953,3689
0,0,1,0,0,0,1,0.030273519846365338,57.275669935465906,3692
0,0,0,0,0,0,0,0.018323656704099484,57.364360793052974,3694
0,0,1,0,0,0,1,0.006546365531902547,57.41137942346117,3693
0,0,0,0,0,0,0,0.010967557379806033,57.44269333853047,3698
0,0,0,0,0,0,0,0.011734166857836641,57.45836918676268,3701
0,0,0,0,0,0,0,0.013276447841223197,57.48966021783541,3701
0,0,0,0,0,0,0,0.009808535805748598,57.53680891847054,3702
0,0,0,0,0,0,0,0.003292168244612106,57.56289368114021,3702
0,0,0,0,0,0,0,0.003241999593979441,57.57854742537175,3703
0,0,0,0,0,0,0,0.01657010112405667,57.578566465000506,3708
1,0,0,0,0,0,1,0.02552381899428684,57.594239196237865,3713
0,0,0,0,0,0,0,0.026138069242669235,57.64211376434857,3720
0,0,0,0,0,0,0,0.01612314130776837,57.72747356673007,3719
0,0,1,0,0,0,1,0.016918623816700805,57.75887259388937,3723
0,0,1,0,0,0,1,0.02116448475519903,57.77474106833716,3725
0,0,0,0,4,0,4,0.033922595064333295,57.780926409219795,3727
0,0,0,0,0,0,0,0.02221749677688428,57.82627871619087,3728
0,0,2,0,0,0,2,0.01194486787873852,57.873405078582465,3729
0,0,0,0,0,0,0,0.017893699926638085,57.936046161657146,3733
0,0,0,0,0,0,0,0.028051261063217207,57.962262038517956,3739
0,0,0,4,0,0,4,0.030272468316564816,58.016468282957426,3743
0,0,0,0,0,0,0,0.025025238307533424,58.07050323260419,3744
4,0,0,0,1,0,5,0.022338066031257715,58.08805723663916,3744
0,0,1,0,0,0,1,0.023588147281795147,58.12971004864545,3748
1,0,1,1,2,0,5,0.01364920755750767,58.150672666820604,3747
2,0,1,1,0,0,4,0.018291967992506326,58.166463872730596,3749
0,0,0,0,0,0,0,0.022214929660433976,58.2134412349734,3751
0,0,0,0,0,0,0,0.009738516820026352,58.2707766772401,3751
0,0,0,0,0,0,0,0.011941328113164196,58.27079823197982,3752
0,0,0,0,0,0,0,0.02097790314318985,58.27081598614667,3756
0,0,0,0,0,0,0,0.012821601234420832,58.33382730368958,3757
0,0,0,0,0,0,0,0.014270755345957634,58.380871293083565,3762
0,0,1,0,0,0,1,0.016164047987031235,58.406845324766145,3762
0,0,0,0,0,0,0,0.009612467951876069,58.454253380273464,3763
0,0,0,0,0,0,0,0.009710698942796995,58.46990948752894,3764
0,0,0,0,0,0,0,0.007373271769413266,58.50155541861413,3767
0,0,0,0,0,0,0,0.010650207663210173,58.51850259449704,3768
0,0,0,0,0,0,0,0.00893424292647052,58.54994673578712,3769
0,0,0,0,0,0,0,0.012979572593133358,58.557411616125215,3773
0,0,0,0,0,0,0,0.013390367139521837,58.62007527268917,3778
0,0,0,0,3,0,3,0.026914740648621267,58.638958062048246,3780
0,0,0,0,0,0,0,0.018013329214548204,58.6856304734631,3781
0,0,0,0,0,0,0,0.01210644566931371,58.75695732582329,3785
0,0,0,2,0,0,2,0.009623957777223784,58.769213529606844,3786
3,0,0,1,0,0,4,0.008429180748190384,58.76951901042077,3784
0,0,0,0,0,0,0,0.008244686358373315,58.81954849564158,3787
0,0,0,0,0,0,0,9.865701088703827e-07,58.874172948030164,3787
0,0,0,0,3,0,3,0.009398040982130065,58.84607551102602,3787
3,0,0,0,0,0,3,0.006034926959680946,58.84610287149548,3786
0,0,0,0,0,0,0,0.005532333613156787,58.877408345451265,3788
0,0,0,0,0,0,0,0.006507736983743926,58.89306043212317,3789
0,0,0,0,0,0,0,0.015163947174052849,58.90871981492782,3793
0,0,0,0,0,0,0,0.010521156881649044,58.94004678249173,3794
0,0,0,0,0,0,0,0.015421632149579426,58.95039548008122,3797
0,0,0,0,0,0,0,0.025695929604001858,58.981712083599234,3803
0,0,0,0,0,0,0,0.02113313647245936,59.0787651362992,3808
0,0,0,0,0,0,0,0.028331299696023837,59.1011443452666,3811
0,0,0,0,0,0,0,0.01564664417315399,59.18641037174399,3816
0,0,0,0,0,0,0,0.01977397859834481,59.27537506219204,3821
0,0,0,0,0,0,0,0.016170232797742382,59.306746303130986,3825
0,0,0,0,0,0,0,0.006907325102971842,59.38235777819063,3823
0,0,0,0,0,0,0,0.012773292610099813,59.391958441900286,3826
0,0,0,0,0,0,0,0.026703647637896955,59.329372278887185,3831
0,0,1,0,0,0,1,0.023319779924316844,59.41794293592464,3832
0,0,0,5,0,0,5,0.025957232248575095,59.388831263012165,3832
0,0,2,0,3,0,5,0.028017746903130837,59.405474681535004,3833
0,0,0,0,0,0,0,0.020496926208049954,59.50186521825901,3838
0,0,0,1,0,0,1,0.01169561943116922,59.5300397786941,3837
0,0,0,0,0,0,0,0.019850673027266473,59.57466460618765,3840
0,0,0,0,0,0,0,0.02365269173197166,59.550410530821416,3844
0,0,0,0,0,0,0,0.01802356569914853,59.62862118160659,3844
0,0,0,0,0,0,0,0.014572425252707489,59.63031197491988,3845
3,0,0,0,0,0,3,0.01571323163824521,59.671383763147766,3845
0,0,0,0,0,0,0,0.02295830391857796,59.656211663190085,3846
0,0,0,0,0,0,0,0.01459189998180666,59.67912526432598,3846
0,0,0,0,0,0,0,0.020227064626806568,59.72615162883571,3852
0,0,0,0,0,0,0,0.017405115542213207,59.75224871091251,3855
0,0,0,0,0,0,0,0.013989653608983448,59.87244716023948,3860
0,0,0,0,0,0,0,0.021348041605499322,59.904550107666644,3863
0,0,0,0,0,0,0,0.012120434568480538,59.94744325137284,3864
0,0,0,0,0,0,0,0.015223802923684596,60.014031468942754,3869
0,0,0,0,0,0,0,0.014537690864370971,60.01405310112564,3869
0,0,0,0,0,0,0,0.020309491373819096,60.07686664474449,3874
1,0,0,0,0,0,1,0.02124457244224469,60.07543034531975,3873
0,0,0,0,0,0,0,0.02131721462462845,60.1243405805922,3877
0,0,4,4,0,0,8,0.025749878308956097,60.05352648958687,3875
0,0,0,1,0,0,1,0.009455178145378919,60.17934098261348,3874
0,0,0,0,0,0,0,0.008756563184987371,60.221176224630035,3878
0,0,0,0,0,0,0,0.011240715376803857,60.23179265841094,3880
0,0,0,0,0,0,0,0.015718373834142454,60.284590872456185,3884
0,0,0,0,2,0,2,0.0262776179893359,60.27927701620527,3887
0,0,0,0,1,0,1,0.01143105724039012,60.36258056309032,3887
1,0,0,0,0,0,1,0.01275446966862037,60.40438820906179,3891
0,0,0,0,0,0,0,0.023043011486555593,60.373070241453874,3893
3,0,0,0,0,0,3,0.024695416745174188,60.38931508424633,3893
1,0,0,0,0,0,1,0.01951291054411353,60.45975732477771,3898
0,0,0,0,0,0,0,0.012482633520996444,60.5228421893736,3899
0,0,0,0,1,0,1,0.019146770459179695,60.56760694727919,3904
1,0,0,0,0,0,1,0.018977419203963213,60.59883671526279,3907
0,0,0,0,0,0,0,0.010839704887518058,60.661471109150256,3908
0,0,0,0,0,0,0,0.011452014949175693,60.661512875337266,3912
0,0,0,0,0,0,0,0.014098106844661016,60.74000123917003,3914
0,0,0,0,0,0,0,0.013341396571304499,60.70862953442904,3915
0,0,0,0,0,0,0,0.018200892681147534,60.77294363663054,3918
0,0,0,0,0,0,0,0.02381424793488408,60.79056433968469,3924
0,0,0,0,0,0,0,0.020432122781385353,61.03063872599478,3928
0,0,0,2,0,0,2,0.011452335045822942,60.89603203115137,3928
0,0,0,0,0,0,0,0.009464910833400146,61.0104744707262,3932
0,0,0,0,0,0,0,0.016635033930122556,61.00747454100095,3935
0,0,0,0,0,0,0,0.014237940554235029,61.00613098061339,3937
0,0,0,0,0,0,0,0.014606509438595929,61.077079487110566,3938
0,0,0,0,0,0,0,0.016524001257860965,61.06518981897498,3941
0,0,0,0,0,0,0,0.012314412309891148,61.11255910202275,3940
0,0,0,0,0,0,0,0.00893101668033928,61.16170115506853,3942
0,0,0,0,0,0,0,0.008184065282863005,61.199447046027764,3945
0,0,2,0,6,0,8,0.032152097041933766,61.12766636975337,3947
0,0,0,0,0,0,0,0.007146569894735716,61.26552715911985,3947
0,0,0,0,0,0,0,0.008907440478800533,61.26030306179736,3949
0,0,0,0,0,0,0,0.004647244125003163,61.338511567023765,3951
0,0,0,0,0,0,0,0.003689973392247878,61.3385284173462,3951
0,0,0,0,0,0,0,0.009945262011460268,61.33854867256001,3955
0,0,0,0,0,0,0,0.006579896685232001,61.4014891549292,3956
6,0,0,0,1,0,7,0.008781057227865412,61.331634328101245,3951
0,0,0,0,0,0,0,0.010419514656104583,61.36757001002343,3954
1,0,0,0,0,0,1,0.009741595556947478,61.35728057201002,3954
0,0,0,0,0,0,0,0.012617817183854869,61.40178243899489,3958
0,0,0,0,0,0,0,0.01126764462852652,61.46442556256155,3962
0,0,0,4,0,0,4,0.005831253069706111,61.53377200462152,3962
0,0,0,1,0,0,1,0.006035129366796409,61.54974301802873,3963
0,0,0,1,0,0,1,0.019807340545471695,61.50241460001973,3968
0,0,0,0,0,0,0,0.009911881025425874,61.596362473855166,3970
0,0,0,1,0,0,1,0.007507772172951719,61.646879733697965,3974
0,0,0,0,0,0,0,0.008253649380820125,61.672710974355056,3977
0,0,0,0,0,0,0,0.016959142901003418,61.740972209652426,3980
0,0,0,0,0,0,0,0.01141313023381403,61.73213933444166,3981
0,0,0,0,0,0,0,0.0030936340165320687,61.82767759539314,3983
0,0,0,0,0,0,0,0.008541580018571015,61.858843756526525,3987
0,0,0,0,0,0,0,0.011284199743587136,61.8748503505343,3990
0,0,0,0,0,0,0,0.002887247362226281,61.9317329312805,3990
1,0,0,0,0,0,1,0.01595755066285278,61.9321059181904,3995
0,0,0,0,2,0,2,0.014074130271202577,61.90589055628312,3994
0,0,0,0,0,0,0,0.007587025202612602,62.057319639471714,4001
0,0,0,0,0,0,0,0.0035017837487490216,62.088912795411375,4001
0,0,0,0,0,0,0,0.009505795971890513,62.12513868525618,4008
2,0,0,0,0,0,2,0.013876045234462576,62.16650249449273,4008
0,0,2,0,0,0,2,0.009731214016434444,62.16384703801886,4009
1,0,0,0,0,0,1,0.006485606159878501,62.24212481864549,4011
0,0,0,0,3,0,3,0.012615523160040984,62.260977581917146,4014
3,0,0,0,0,0,3,0.013121922736040436,62.2946717761477,4016
0,0,0,6,1,0,7,0.010509182157767664,62.27578244575509,4013
1,0,0,1,2,0,4,0.008423644151092154,62.29934553454079,4014
2,0,0,1,0,0,3,0.00300757114220668,62.29934553454079,4012
0,0,0,0,0,0,0,0.0030878981600498366,62.29934553454079,4012
0,0,0,0,0,0,0,0.002164331203868528,62.31498910095367,4013
0,0,0,0,0,0,0,0.004228812309241811,62.32532360098196,4015
0,0,0,0,0,0,0,0.009043436914252731,62.42371265377515,4020
0,0,0,0,0,0,0,0.004817529384728219,62.47065706258038,4021
0,0,0,0,0,0,0,0.0005026050057560866,62.517634785834005,4022
0,0,0,0,0,0,0,0.0,62.533288762644155,4022
0,0,0,0,0,0,0,0.0030515158926179616,62.533288762644155,4023
1,0,0,0,0,0,1,0.005868561900626599,62.54893072301689,4025
0,0,0,1,0,0,1,0.006995791210580287,62.54894194574394,4027
0,0,0,0,0,0,0,0.0,62.606250080121505,4027
0,0,0,0,0,0,0,0.0,62.606250080121505,4027
0,0,0,0,0,0,0,0.0030038344180290037,62.606250080121505,4028
0,0,0,1,1,0,2,0.005867656899501255,62.62042464003776,4029
0,0,0,0,0,0,0,0.0036271897915911592,62.63061237807677,4031
0,0,0,0,0,0,0,0.005998111336804074,62.67772355856115,4033
0,0,0,0,0,0,0,0.008094934383954895,62.70907311468526,4037
0,0,0,0,0,0,0,0.01176948334377916,62.7247336262638,4039
0,0,0,0,0,0,0,0.008685789922590975,62.77012024435678,4042
0,0,0,0,0,0,0,0.006860170574425094,62.79596311006501,4044
1,0,0,0,2,0,3,0.012721660641920212,62.82221846305817,4047
0,0,0,0,0,0,0,0.005067248375513474,62.88981021240181,4048
2,0,0,0,0,0,2,0.00788578420938195,62.86913684863462,4048
1,0,3,0,0,0,4,0.012111045456868934,62.8692804052803,4050
0,0,0,0,0,0,0,0.005286514373403067,62.89525912970022,4050
0,0,0,0,0,0,0,0.0050670617494838035,62.92122598154658,4052
0,0,0,0,0,0,0,0.0017705544387328477,62.95252442505492,4053
0,0,0,0,0,0,0,0.0007930571379993209,62.96817402769546,4053
0,0,0,0,0,0,0,0.0017073593021786275,62.97850852772375,4054
0,0,0,6,0,0,6,0.004013353868375476,62.94387668691784,4052
0,0,0,1,0,0,1,0.014173210752302233,62.95951507810191,4056
0,0,0,0,0,0,0,0.011119037773054154,62.985487813484745,4058
0,0,0,3,0,0,3,0.0,63.00857285384056,4054
0,0,0,0,0,0,0,0.0,63.00857285384056,4054
0,0,0,0,0,0,0,0.0027873356966129545,63.00857285384056,4055
0,0,0,0,0,0,0,0.00415880533186232,63.00857285384056,4056
0,0,0,0,0,0,0,0.001843039607987369,63.01555985187217,4057
0,0,0,0,0,0,0,0.003013033792611759,63.03867414214336,4058
0,0,0,0,4,0,4,0.011691672673486558,63.018750715353384,4058
0,0,0,0,0,0,0,0.002969476896730147,63.06409032994678,4059
0,0,0,0,0,0,0,0.0019805368630353244,63.07973989903107,4061
0,0,0,0,0,0,0,0.003619375701373739,63.0953827580039,4062
4,0,0,0,0,0,4,0.007626118591250513,63.0603776434388,4060
0,0,0,0,0,0,0,0.001198208603030541,63.09865677885196,4061
0,0,0,0,0,0,0,0.003262581753270281,63.09865677885196,4063
0,0,0,2,2,0,4,0.007562225417376119,63.105665412252286,4062
2,0,0,0,0,0,2,0.0,63.10566514876872,4060
0,0,0,2,0,0,2,0.0039981031180234446,63.10566514876872,4061
0,0,0,1,1,0,2,0.0,63.10566514876872,4059
1,0,0,0,0,0,1,0.0022257843362584627,63.10566514876872,4060
0,0,0,0,0,0,0,0.0019760369548062523,63.10566514876872,4060
0,0,0,0,0,0,0,1.0021048603516764e-06,63.1369453631627,4061
0,0,0,0,0,0,0,0.004930794151253953,63.13694169968357,4063
0,0,0,0,0,0,0,0.0028552946568066086,63.162946984919344,4065
0,0,0,0,0,0,0,0.0006245032828016762,63.20990187626816,4067
0,0,0,0,0,0,0,0.0006360267976193756,63.217009836417475,4068
0,0,0,0,0,0,0,0.005401396581606649,63.21688330489563,4069
0,0,0,0,0,0,0,0.0,63.23254385482341,4068
0,0,0,0,0,0,0,0.0016284353715686544,63.24848157058404,4070
1,0,0,0,0,0,1,0.0,63.26382198206867,4070
0,0,0,0,0,0,0,0.00975683124766927,63.26382198206867,4074
0,0,0,2,0,0,2,0.003136590640108685,63.27251431934507,4072
0,0,0,1,0,0,1,0.0012471597986967533,63.298511604723146,4073
0,0,0,1,2,0,3,0.011264891752081872,63.293486261209885,4075
0,0,0,0,0,0,0,3.974819909649689e-05,63.32985616249323,4074
0,0,0,0,0,0,0,0.0036580073657524158,63.32979356841731,4076
0,0,0,0,0,0,0,0.004947669443818397,63.36115585015923,4078
0,0,0,0,0,0,0,0.002841743878965315,63.38377555191633,4079
0,0,0,0,0,0,0,0.004520802729427541,63.38377555191633,4080
0,0,0,0,0,0,0,0.0028744079164964346,63.39411005194462,4080
2,0,0,0,1,0,3,0.007124715621135383,63.36310655185974,4079
0,0,0,0,0,0,0,0.009613605559586472,63.389275567274694,4082
1,0,0,0,1,0,2,0.005094948235671701,63.43268156765304,4084
2,0,0,0,0,0,2,0.006722962003616417,63.49528147485711,4088
0,0,0,0,0,0,0,0.004560430715095971,63.51090555234643,4089
0,0,0,0,0,0,0,0.005982525146353932,63.55251620979242,4091
0,0,0,0,0,0,0,0.005810520933056352,63.55251620979242,4091
0,0,0,3,0,0,3,0.0014606456473569692,63.53855321103479,4087
0,0,0,0,0,0,0,0.006698113662197185,63.53855321103479,4090
0,0,0,1,0,0,1,0.008737561857385641,63.55419810836385,4091
0,0,0,0,0,0,0,0.0029879886382296683,63.5801708710133,4091
0,0,0,0,0,0,0,0.001162328156454732,63.5801708710133,4091
0,0,0,0,0,0,0,0.0,63.59050537104159,4091
0,0,0,0,0,0,0,0.0054652318579931835,63.57486047371255,4093
0,0,0,0,0,0,0,0.0029493802461458573,63.6292959978309,4095
0,0,0,0,0,0,0,5.321548329859536e-07,63.63647329518775,4095
0,0,0,0,0,0,0,0.0,63.63647329518775,4095
0,0,0,0,0,0,0,0.002791649238156424,63.63647329518775,4096
0,0,0,0,3,0,3,0.00866923246637775,63.60835778571476,4095
0,0,0,0,0,0,0,0.0029176869112624696,63.64468400836791,4097
0,0,0,0,0,0,0,0.001805190953443558,63.686286623711126,4099
0,0,0,0,0,0,0,0.005785267696400455,63.69326811671889,4101
3,0,0,0,0,0,3,0.008653486883052366,63.68581534504146,4101
0,0,0,2,0,0,2,0.0031190163269027905,63.713770206326046,4100
0,0,0,0,0,0,0,0.0027652587751380918,63.71346318995516,4100
0,0,0,1,2,0,3,0.005926022855951109,63.703128689926864,4100
2,0,0,0,0,0,2,0.0063464444214590444,63.703128689926864,4102
0,0,0,0,0,0,0,0.005759223525163544,63.73440561390449,4102
0,0,0,0,0,0,0,0.005524379425034434,63.74138946775716,4106
0,0,0,0,0,0,0,0.00468450193764044,63.77964502173511,4106
0,0,0,0,0,0,0,0.001697763915945769,63.78997952176339,4106
0,0,0,0,0,0,0,0.001418909951121994,63.80031402179169,4107
0,0,0,0,0,0,0,0.0,63.81595234017389,4108
0,0,0,0,0,0,0,0.005158231832505444,63.81595234017389,4109
0,0,0,0,0,0,0,0.005227909624780286,63.815952113033866,4109
0,0,0,0,0,0,0,3.6337983999643607e-07,63.84193069511742,4109
0,0,0,0,0,0,0,0.0,63.8419249074504,4109
0,0,0,0,0,0,0,0.0029232888043475157,63.8419249074504,4110
0,0,0,0,0,0,0,0.008633675467284534,63.8419249074504,4112
0,0,0,6,0,0,6,0.0024089864967258554,63.825073926583656,4108
0,0,0,0,0,0,0,0.0,63.83252056073817,4108
0,0,0,0,0,0,0,0.0,63.83252056073817,4108
0,0,0,0,0,0,0,0.0,63.84817348938103,4109
0,0,0,0,4,0,4,0.011593789162636021,63.81261127318561,4109
0,0,0,0,0,0,0,0.0037683336685712483,63.8579510242966,4111
0,0,0,0,0,0,0,0.005480638542195555,63.8579510242966,4111
0,0,0,0,0,0,0,0.0016603560803115467,63.864932460453105,4111
0,0,0,0,0,0,0,0.004976214383147546,63.864932460453105,4113
0,0,0,0,0,0,0,0.0077868389408124695,63.87191466555118,4114
0,0,0,0,0,0,0,0.006195446217304109,63.882248411167936,4115
4,0,0,0,1,0,5,0.0056807412668732765,63.85795565014089,4111
0,0,0,0,1,0,1,0.002792201437425695,63.868290150169194,4112
3,0,0,0,0,0,3,0.0061027499223483,63.873594759666005,4113
0,0,0,0,0,0,0,0.0028234701011691453,63.87359402889985,4111
0,0,0,0,0,0,0,0.0012550294862707185,63.87359402889985,4111
0,0,0,5,0,0,5,0.0006531435457990027,63.8596311420568,4109
0,0,0,0,0,0,0,0.005768652852837658,63.8596311420568,4110
0,0,0,0,0,0,0,0.002796682058311101,63.8596311420568,4109
0,0,0,0,0,0,0,4.755001911135019e-06,63.869965642085084,4109
0,0,0,0,0,0,0,0.0006385597933555099,63.869965642085084,4110
0,0,0,0,0,0,0,0.0027865340868496167,63.876982615318994,4111
0,0,0,0,0,0,0,0.006530037085592942,63.8769470491162,4113
0,0,0,0,0,0,0,0.0037665425387303775,63.89429833647983,4114
0,0,0,0,0,0,0,0.002929916525082543,63.894262947833084,4113
0,0,0,0,0,0,0,0.005082356292556556,63.894262947833084,4114
0,0,0,0,0,0,0,0.004987817476970298,63.90459744786137,4115
0,0,0,0,0,0,0,0.0040349238431128046,63.92040776061292,4117
0,0,0,0,0,0,0,2.7706606368390122e-05,63.94642552387201,4117
0,0,0,0,3,0,3,0.008463161340334428,63.91826501968147,4117
0,0,0,0,0,0,0,0.000650576297802281,63.93893401973806,4117
0,0,0,0,0,0,0,0.0027106147394716854,63.94926851976636,4118
0,0,0,8,0,0,8,0.0,63.89899831137154,4112
3,0,0,0,0,0,3,0.0,63.86799481128665,4109
0,0,0,0,0,0,0,0.0,63.86799481128665,4109
0,0,0,0,0,0,0,0.00514400125472349,63.86799481128665,4111
0,0,0,0,0,0,0,0.001982613653716059,63.89558013916961,4113
0,0,0,0,0,0,0,0.0059628248432790545,63.911218344447256,4116
0,0,0,0,0,0,0,0.005653672225014806,63.911218344447256,4116
0,0,0,0,0,0,0,0.007742186467671374,63.92518145707029,4118
0,0,0,0,0,0,0,0.005325536628182271,63.94087442317722,4117
0,0,0,0,0,0,0,3.1389212879737126e-08,63.956512485821364,4116
1,0,0,0,0,0,1,0.004783071820599959,63.956512485821364,4118
0,0,0,0,0,0,0,0.008672171586599452,63.956512485821364,4119
0,0,0,0,0,0,0,0.005520067589150227,63.98248521286591,4120
0,0,0,0,0,0,0,0.003635763351167049,63.98248521286591,4121
0,0,0,0,0,0,0,0.002941302216643546,64.0031542129225,4121
0,0,0,0,0,0,0,0.0,64.0031542129225,4120
0,0,0,5,0,0,5,0.0,63.9788568243275,4117
0,0,0,0,0,0,0,0.0,63.9788568243275,4117
0,0,0,0,0,0,0,0.003970926956825987,63.9788568243275,4119
0,0,0,1,0,0,1,0.0059321283467492015,63.9788568243275,4119
0,0,0,0,0,0,0,0.0027302735890543436,64.00194192376097,4120
0,0,0,0,0,0,0,0.00034112016417685103,64.00194169926586,4121
0,0,0,0,4,0,4,0.011788912557627762,63.98080758863144,4121
0,0,0,0,0,0,0,0.003974148838051485,64.00147658868804,4122
1,0,0,0,0,0,1,0.004865370519915556,64.02614739329464,4123
0,0,0,0,0,0,0,0.0013930012453070666,64.02614739329464,4122
0,0,0,0,0,0,0,0.0,64.02614739329464,4121
0,0,0,0,0,0,0,0.005578505715156635,64.02614739329464,4123
0,0,0,0,0,0,0,0.003019578291724728,64.05755661509852,4124
4,0,0,0,0,0,4,0.006387112976105188,64.01221681043533,4122
0,0,0,0,1,0,1,0.010780981560155214,64.01929127182508,4125
1,0,0,0,1,0,2,0.008263154610845591,64.03507682210699,4124
1,0,0,5,0,0,6,0.0,64.02139963089134,4119
0,0,0,0,0,0,0,0.0,64.02139963089134,4119
0,0,0,0,0,0,0,0.0,64.02139963089134,4119
0,0,0,0,0,0,0,0.0,64.02139963089134,4119
0,0,0,0,0,0,0,0.0016978270446914784,64.02139963089134,4120
0,0,0,0,0,0,0,0.002804102205940981,64.03722104067204,4121
0,0,0,0,0,0,0,2.364511178906184e-06,64.0442054499859,4121
0,0,0,0,0,0,0,0.0,64.05987023599954,4122
0,0,0,0,0,0,0,0.0021943355084468015,64.07560537969601,4124
0,0,0,0,0,0,0,8.724555585768644e-07,64.0912478831515,4124
0,0,0,0,0,0,0,0.0,64.09124347298152,4124
0,0,0,0,0,0,0,0.0,64.09124347298152,4124
0,0,0,0,0,0,0,0.0,64.09124347298152,4124
0,0,0,0,0,0,0,0.0028874836639075445,64.10718401822012,4126
0,0,0,0,0,0,0,0.002990188092831875,64.10718401822012,4127
0,0,0,0,0,0,0,0.0014539371274578724,64.12983721191988,4128
0,0,0,2,0,0,2,0.002560523223571492,64.11587428453335,4127
0,0,0,0,0,0,0,0.003131886691387688,64.11587428453335,4128
0,0,0,0,0,0,0,0.005675012851888019,64.14184791757165,4130
0,0,0,1,0,0,1,0.003240080892169289,64.14184706618587,4129
0,0,0,1,0,0,1,0.0,64.15749825637994,4128
0,0,0,0,0,0,0,0.002808238261183744,64.15749825637994,4129
0,0,0,0,1,0,1,0.005744676492575057,64.14716375635163,4129
1,0,0,0,1,0,2,0.009055589232806357,64.13151256615757,4132
1,0,0,0,1,0,2,0.01155424687767718,64.15433912524897,4132
1,0,0,0,0,0,1,0.0029608372019313323,64.17719410030054,4131
0,0,0,0,0,0,0,0.004084042616847574,64.17693050819535,4132
0,0,0,0,0,0,0,0.002822203040296905,64.17693050819535,4132
0,0,0,0,0,0,0,0.0036115926124035236,64.19759928273285,4134
0,0,0,0,0,0,0,0.005634473679194876,64.19759928273285,4134
0,0,0,0,0,0,0,0.0027143430150189246,64.20504593547874,4134
0,0,0,0,0,0,0,0.0,64.20504593547874,4133
0,0,0,0,0,0,0,0.005397770978361729,64.20504593547874,4135
0,0,0,4,0,0,4,0.0051560815762454505,64.19852962377793,4135
0,0,0,0,0,0,0,0.004462109081011637,64.23017171498512,4136
0,0,0,1,0,0,1,0.0026398284156153506,64.2458999851526,4136
0,0,0,0,0,0,0,0.0028359828842815095,64.2562344851809,4137
0,0,0,0,0,0,0,0.0020352781085994074,64.26334461339404,4138
0,0,0,0,0,0,0,0.0,64.27890335622541,4139
0,0,0,0,0,0,0,0.0014385125491952913,64.28600926769639,4141
0,0,0,0,6,0,6,0.018391661806993947,64.25563805938965,4142
0,0,0,0,0,0,0,0.003073192938214966,64.29962669627004,4141
0,0,0,0,0,0,0,0.0028999268248229193,64.32589844380246,4142
0,0,0,0,0,0,0,0.001766978244813009,64.32589844380246,4142
0,0,0,0,0,0,0,0.0052961300792799025,64.33623294383075,4144
0,0,0,0,0,0,0,0.002717749548210263,64.34656744385903,4144
0,0,0,0,0,0,0,0.0052732441824687466,64.34656744385903,4145
6,0,0,0,2,0,8,0.010581706517945896,64.28201323968487,4141
0,0,0,0,1,0,1,0.008726468439353622,64.31286430607013,4143
3,0,0,6,0,0,9,0.005485218351066169,64.27320148876011,4137
0,0,0,0,1,0,1,0.005634969628454497,64.27320148876011,4137
1,0,0,0,0,0,1,0.0022464777701607912,64.27320148876011,4137
0,0,0,1,0,0,1,0.0,64.2835359887884,4136
0,0,0,0,0,0,0,0.002893395709677097,64.2835359887884,4137
0,0,0,0,0,0,0,0.004005617856999926,64.2835359887884,4138
0,0,0,0,0,0,0,0.0007965425080949552,64.2835359887884,4137
0,0,0,0,0,0,0,0.0027745570706738014,64.2835359887884,4137
0,0,0,0,0,0,0,0.0029311338678886627,64.2835359887884,4137
0,0,0,0,0,0,0,0.005779345759299283,64.2835359887884,4140
0,0,0,0,0,0,0,0.007833635753038708,64.30951838435148,4141
0,0,0,0,0,0,0,0.004497477143987367,64.33264006097899,4142
0,0,0,0,0,0,0,0.004374638765025857,64.33581409126542,4143
0,0,0,0,0,0,0,0.00041539225191090077,64.35889896988965,4144
0,0,0,0,0,0,0,0.014278011054974848,64.34322383639396,4148
0,0,0,0,0,0,0,0.01518740466581022,64.35888294124831,4149
0,0,0,1,7,0,8,0.01394718036553244,64.33907914866282,4145
0,0,0,1,0,0,1,0.0010427465134896182,64.41439746970653,4147
0,0,0,0,0,0,0,0.0038360149357128466,64.44055835379156,4150
0,0,0,1,0,0,1,0.007910672972105395,64.45631230993483,4152
7,0,0,0,0,0,7,0.005132811095101366,64.40362040065031,4147
0,0,0,0,0,0,0,0.0,64.42093385465691,4147
0,0,0,0,0,0,0,0.0013159531272121873,64.42093385465691,4149
0,0,0,0,2,0,2,0.008757982298375518,64.5378291409852,4151
2,0,0,0,0,0,2,0.0029329180424423765,64.5378291409852,4149
0,0,0,0,0,0,0,0.0,64.5378291409852,4148
0,0,0,0,0,0,0,0.0,64.5378291409852,4148
0,0,0,0,0,0,0,0.0,64.5378291409852,4148
0,0,0,0,0,0,0,0.002997387314209017,64.5378291409852,4149
0,0,0,0,0,0,0,1.4335825266120435e-05,64.5481636410135,4149
0,0,0,0,0,0,0,0.0,64.5481636410135,4149
1,0,0,0,0,0,1,0.0018405410174426355,64.5481636410135,4151
1,0,0,5,0,0,6,0.00545902851122127,64.52386613805744,4149
0,0,0,0,0,0,0,0.004473630240035905,64.53095766058651,4149
0,0,0,0,0,0,0,0.004787772820498034,64.46649094948057,4151
0,0,0,1,0,0,1,0.0,64.56223429512562,4150
0,0,0,0,0,0,0,0.005671768254593287,64.56223429512562,4152
0,0,0,0,0,0,0,0.0029321874074497234,64.579575253925,4153
0,0,0,0,0,0,0,0.0008858299829259308,64.50984181711983,4154
0,0,0,0,0,0,0,0.0,64.58988471446291,4154
0,0,0,0,0,0,0,0.002880199547547726,64.58988471446291,4155
0,0,0,0,3,0,3,0.008227335903392115,64.56921571440633,4156
0,0,0,0,0,0,0,1.0805783822534902e-05,64.619953241961,4156
0,0,0,0,0,0,0,0.0,64.61985923178422,4156
0,0,0,0,0,0,0,0.0,64.61985923178422,4156
0,0,0,0,0,0,0,0.0,64.61985923178422,4156
0,0,0,0,0,0,0,0.0,64.61985923178422,4156
0,0,0,0,0,0,0,0.0,64.61985923178422,4156
3,0,0,1,0,0,4,0.002448728316608846,64.57787252770024,4153
0,0,0,0,0,0,0,0.0029116464651124936,64.57787252770024,4153
1,0,0,0,0,0,1,0.0037200416192069746,64.59354790813983,4156
1,0,0,0,2,0,3,0.0128457525672499,64.59354790813983,4158
2,0,0,0,0,0,2,2.173743356548616e-05,64.63185742933923,4157
0,0,0,0,0,0,0,0.003498620230623484,64.6318057907209,4159
0,0,0,0,0,0,0,0.00127389194128574,64.6318057907209,4159
0,0,0,0,0,0,0,0.0029456207339087714,64.6491217134197,4160
0,0,0,0,0,0,0,0.005577380246342781,64.6491217134197,4162
0,0,0,0,0,0,0,0.00454475276261831,64.66476062585872,4162
0,0,0,0,0,0,0,0.0,64.6805554150934,4161
0,0,0,0,0,0,0,0.005336707269675021,64.6805554150934,4163
0,0,0,0,0,0,0,0.014109383417601571,64.6805554150934,4167
1,0,0,0,0,0,1,0.007545686042238024,64.7118322346183,4168
0,0,0,0,0,0,0,8.463934058974663e-05,64.75847373832256,4168
0,0,0,0,0,0,0,0.0,64.7659202975936,4168
0,0,0,6,0,0,6,0.002985847150774992,64.73128848565823,4165
0,0,0,0,0,0,0,0.002957663243661086,64.73128848565823,4165
0,0,0,0,4,0,4,0.011494319594279915,64.73457057646357,4167
0,0,0,0,0,0,0,0.0014195400926886477,64.77991023234563,4168
0,0,0,0,0,0,0,0.005807909544892707,64.7955858221105,4171
0,0,0,0,0,0,0,0.004545450346359941,64.7955858221105,4170
4,0,0,0,0,0,4,9.797474519551568e-08,64.7675626779637,4166
0,0,0,0,0,0,0,0.0,64.76756208044843,4166
0,0,0,0,0,0,0,0.0029340667799457134,64.76756208044843,4167
0,0,0,0,1,0,1,0.0026723806499619742,64.78238117856422,4168
1,0,0,0,0,0,1,0.0,64.78238117856422,4167
0,0,0,0,0,0,0,0.0024875169386081716,64.78238117856422,4168
0,0,0,0,0,0,0,0.0031977883456133878,64.78238117856422,4169
0,0,0,0,0,0,0,0.0029821940096357467,64.79801951994465,4169
0,0,0,0,0,0,0,0.005841141468633135,64.79801951994465,4170
0,0,0,0,0,0,0,0.0028662014067050655,64.80500117403884,4170
0,0,0,2,0,0,2,0.002985737498938678,64.80747579009802,4170
0,0,0,0,0,0,0,1.5768216813025295e-06,64.84078130412388,4173
0,0,0,0,0,0,0,0.003371801724122045,64.89445455786128,4175
0,0,0,0,0,0,0,0.0,64.92573378040544,4175
0,0,0,0,0,0,0,0.0,64.92573352366706,4175
0,0,0,0,0,0,0,0.0006286064440486256,64.87696738612972,4176
0,0,0,0,0,0,0,0.0,64.92573352366706,4176
0,0,0,0,0,0,0,0.0024459589707177707,64.94148630688433,4178
0,0,0,0,0,0,0,0.003015403596870677,64.94835349631056,4180
0,0,0,0,0,0,0,0.0,64.96399186205947,4179
0,0,0,0,0,0,0,0.0,64.96399186205947,4179
0,0,0,0,2,0,2,0.005853392268054332,64.94332286200289,4179
1,0,0,0,0,0,1,0.00686100579321018,64.9639915851899,4182
0,0,0,0,0,0,0,0.006292060579886364,64.9639915851899,4182
0,0,0,0,0,0,0,7.674580767732323e-06,64.99694672020756,4182
0,0,0,0,0,0,0,0.0,64.99694580314882,4182
0,0,0,2,0,0,2,0.0007547718574549527,64.94993972164235,4181
0,0,0,0,0,0,0,0.0,64.98298276392237,4181
2,0,0,0,1,0,3,0.005597589974911019,64.95197926383746,4180
