throughput_KLONGTEI,throughput_KASEMRAT,throughput_NARANONG,throughput_SUNLAKAKHON,throughput_RAMA4, throughput_ATTHAKAVI_RAMA4,throughput,mean_speed,jamlength_percent,Backlog
0,0,0,0,0,0,0,7.796983285317651,0.0,17
0,0,0,0,0,1,1,9.408112036513343,0.007485576416905071,35
0,0,0,0,0,0,0,9.735901262006415,0.03532087085456184,59
0,3,1,0,1,0,5,10.076009312830468,0.024986370826265005,79
2,3,0,1,0,0,6,9.76931108325662,0.06015514518442084,109
1,1,0,0,3,1,6,9.932351460839882,0.13125292910853978,133
2,6,1,5,1,0,15,9.936084313286134,0.16834035142918022,155
0,4,0,4,0,1,9,9.268328776105227,0.2714836475311842,174
2,10,1,4,2,3,22,9.584007590579754,0.2479483406971638,205
1,3,2,0,1,1,8,8.69358930514283,0.5087723803853025,230
3,9,2,17,5,3,39,9.300875112265903,0.4687852528112441,249
6,8,2,7,4,3,30,9.20942117277305,0.5433255166029604,277
6,8,3,6,10,6,39,9.214556247006636,0.5805046522960989,291
8,7,4,4,3,3,29,8.636824123076865,0.8067070687288139,322
2,10,2,6,9,4,33,8.444530045540885,1.0623969583646027,346
14,13,7,6,5,3,48,7.838454953093391,1.3258380140510682,367
7,9,3,4,11,8,42,7.330537278652368,1.5955486730291812,401
8,9,5,16,8,4,50,7.759405003796122,1.5518089852376278,403
7,6,4,8,12,7,44,7.492019696984118,1.8111273688644762,419
10,10,7,5,9,3,44,7.346604386194253,1.7512020092784648,430
11,13,4,3,16,13,60,7.079110459179459,2.016279184821594,454
11,15,18,0,6,3,53,6.713832429982576,2.2047178183193,444
11,9,6,13,19,9,67,6.659088849913459,2.358289757644995,468
5,11,14,6,6,6,48,6.22270016485671,2.513541385832295,483
21,13,4,6,12,0,56,6.391981305923414,2.570226656834834,490
8,7,10,15,5,12,57,5.812226492863407,2.8896417960373424,486
7,7,10,6,15,11,56,6.0246668933843175,2.9738651649851064,505
11,10,9,10,8,6,54,5.953269267187897,3.048072121740007,508
8,14,10,5,16,12,65,5.472455283077034,3.368399650097145,519
10,9,10,3,4,5,41,5.362351038682306,3.6154731929363217,541
5,7,7,4,9,12,44,5.150548456211354,4.0363134712831386,553
1,14,15,5,4,11,50,4.824535938502886,4.133930247539673,555
11,21,5,9,6,3,55,4.93290012688198,4.177473381518671,569
8,11,11,12,7,11,60,5.086501162978543,4.255084781371207,588
9,10,10,5,12,7,53,5.0214478610534234,4.568714333193551,603
7,13,8,2,6,9,45,4.675801881619284,4.925034279331631,614
6,9,12,12,9,5,53,4.860859142298053,4.921739547516812,632
9,9,9,12,3,6,48,4.343538368771862,5.2684682472445825,646
6,6,10,5,12,12,51,4.291449001041156,5.647250971583626,661
13,17,13,7,4,5,59,4.227378723042893,5.776541444332252,669
7,16,9,6,12,8,58,4.258414440475841,5.708910965373033,681
10,10,3,12,4,11,50,4.108137275827737,6.134440725136225,695
6,20,4,3,7,7,47,4.1312543469269505,6.259550415963712,713
4,14,2,9,5,8,42,3.7635435755041953,6.586709734477914,723
11,12,0,10,7,5,45,3.8900482150671594,6.829021272095312,736
0,16,1,11,12,14,54,4.011577601374177,6.737254480336275,760
8,15,0,14,5,10,52,3.9514440302043963,7.374922589346634,790
4,19,18,16,12,7,76,3.8996327607366674,7.493317004518996,788
32,12,5,11,5,6,71,3.7092799616448944,7.226039160670534,772
2,11,2,11,10,14,50,3.7328919170652823,7.212234786399862,786
12,14,1,15,6,5,53,3.822605536901477,7.384893153668495,808
12,14,0,13,7,0,46,3.4985838073281323,8.041238729688809,823
8,10,2,13,12,19,64,3.6849968181111015,8.09550004631844,851
7,9,1,5,10,5,37,3.6368035287380476,8.0438190184776,879
6,18,0,11,7,17,59,3.4249406521725305,8.316585421695107,886
7,13,10,13,2,9,54,3.230718117991411,8.75482563289238,880
1,24,1,13,4,8,51,3.321221120418483,8.842714671331839,902
5,12,4,1,5,11,38,2.932229352058565,9.51882501334698,904
0,25,1,8,14,7,55,2.862332847811762,9.564326042703119,908
5,17,0,4,7,9,42,2.8150655969088834,9.838320900842449,920
2,12,7,14,9,6,50,2.915502807329756,10.198756754625848,936
1,13,5,11,12,7,49,2.74287184606001,10.402877704543949,951
10,10,11,14,2,10,57,2.329832881036953,11.056409723485876,940
2,10,9,10,2,3,36,2.4389782745809963,11.194258980118866,974
2,5,6,10,17,4,44,2.4498876946893566,11.045428410724293,968
0,10,7,1,9,9,36,2.476110678106547,11.221558088934598,997
9,12,6,5,9,5,46,2.370973677680419,11.645006727864713,995
4,10,6,2,4,5,31,2.3162299627774527,10.95235454216497,1014
3,12,9,12,16,7,59,2.4364078094132706,10.861420208863107,1012
1,19,13,10,1,6,50,2.3781744601518096,11.284128652927457,1024
1,7,4,13,8,4,37,2.300723739961439,11.648557323231737,1036
0,13,8,11,2,9,43,2.3656237744847437,12.023237115320805,1057
4,5,8,11,6,7,41,2.4463259523974186,12.051723901668439,1082
2,16,13,14,3,5,53,2.5008894200230785,12.154100069361363,1093
4,16,2,11,15,3,51,2.360355768204042,12.171575319533234,1083
0,8,5,10,7,10,40,2.331322721772931,12.164075398407928,1085
5,13,6,16,7,3,50,1.9932869340616417,12.523723575935831,1080
2,13,4,5,7,9,40,1.9385079278809063,12.908585192060203,1084
7,7,15,10,7,4,50,2.1938112346855254,12.55318410246799,1106
6,13,5,5,10,8,47,2.244260446845812,12.809629973954307,1122
5,18,12,4,12,8,59,2.226222220988783,13.135814997503973,1123
6,6,5,9,13,6,45,2.190676998563626,13.242160775233733,1142
8,18,8,11,15,6,66,2.1411345724806545,13.221553035899287,1136
0,18,6,14,11,8,57,2.154102218993338,13.46883730527833,1148
1,14,13,6,8,7,49,2.0380414228789716,13.755112200785954,1151
6,18,4,7,8,6,49,2.151514530781015,13.565462317493406,1164
7,8,14,16,8,8,61,2.206977159807345,13.649018497720158,1168
0,19,13,3,1,11,47,2.159847818220749,13.463047512176333,1173
1,13,10,9,10,6,49,2.217102572085906,13.580166678170645,1176
2,11,10,12,4,8,47,2.152620925525883,13.49700610391771,1181
4,20,5,10,11,9,59,2.2290087692385336,13.494853255345388,1207
2,10,11,9,8,7,47,2.073655244387905,13.970486987424879,1208
11,19,7,17,11,6,71,2.012007027272662,14.00877605794655,1195
0,10,6,14,7,9,46,1.8664504163985567,14.227450288982626,1191
6,11,5,14,9,4,49,1.7583150705920274,14.193980533546691,1191
2,10,10,13,3,7,45,1.8520124238539886,14.645945737739293,1212
3,9,5,10,12,5,44,1.8358250778579925,14.518065388592118,1214
0,11,7,12,1,6,37,1.675429321642832,14.932503361177917,1209
4,8,11,3,5,3,34,1.589708378228328,14.952102502504571,1217
2,15,5,6,2,2,32,1.6336916639957342,15.155352061330964,1241
2,9,10,2,8,7,38,1.6734067049903842,15.218264473784341,1250
2,10,4,13,2,6,37,1.7401706243574444,15.325503707595484,1274
2,14,8,10,17,2,53,1.7748252488930543,15.475794393982055,1267
1,12,3,13,3,7,39,1.810279703579885,15.468133717473227,1293
3,11,7,9,10,8,48,1.8899091518683004,15.198639731000654,1296
4,15,6,11,4,7,47,1.7552577778467313,15.7744691234228,1294
5,16,9,14,6,6,56,1.655795167712817,15.893436706103556,1297
2,9,5,14,3,4,37,1.6924169998327139,16.21023886151305,1313
4,7,16,13,7,5,52,1.783064392364822,16.044677787466803,1306
2,16,6,13,7,6,50,1.8350010474637501,16.007434344055262,1309
8,6,5,11,6,7,43,1.6049547377782705,16.370812392710796,1312
2,19,6,18,5,5,55,1.5324144600037886,16.652913432074943,1322
0,15,5,13,5,3,41,1.5117778014884826,16.889396889706713,1327
5,6,6,0,4,5,26,1.5789661544482256,17.19816840011361,1356
12,4,5,9,9,3,42,1.620781319338617,17.172754745661805,1357
0,7,2,12,11,8,40,1.5668544249454897,17.275273696827988,1363
7,3,4,11,11,6,42,1.4504803915801228,17.348728428149006,1352
0,7,6,15,10,6,44,1.5399064948436603,17.321696984681456,1369
13,18,9,5,7,4,56,1.5161722556644264,17.45478100474138,1373
1,13,15,2,6,3,40,1.6142343787172766,17.005626356570396,1384
7,5,5,2,8,9,36,1.5003928704960419,17.306393005803702,1400
5,15,12,8,1,7,48,1.2660975169209507,17.602701593461205,1372
0,8,4,3,10,6,31,1.3570017282469904,17.809686936994407,1410
9,16,1,5,4,7,42,1.315006682067619,17.668766358096207,1406
1,9,15,2,17,4,48,1.3559494679419017,17.961461840104324,1406
0,14,3,2,5,4,28,1.3548515228540943,18.404584730058293,1437
1,13,3,6,9,5,37,1.2677110653870711,18.562316234727454,1449
9,18,12,6,5,2,52,1.3559589238881355,18.460892545723965,1453
4,11,4,5,8,4,36,1.395154710294396,18.404468990490784,1468
4,16,6,14,0,5,45,1.3627740711699712,18.519766031304226,1452
0,14,3,2,6,1,26,1.3490279337054978,18.75520427082454,1471
2,11,5,10,6,5,39,1.4010964676432696,18.63755417963465,1477
9,12,4,17,7,7,56,1.5380379856912298,18.398774498811694,1482
3,11,1,5,9,4,33,1.5236568606549523,19.081644349064863,1490
9,11,5,8,10,8,51,1.4632562762922856,18.855562016854112,1486
3,15,3,7,12,5,45,1.3889260355110646,19.144138402813553,1479
12,14,4,7,7,7,51,1.3319758278506222,18.889773698905348,1475
2,13,10,1,11,3,40,1.457500065991855,18.90596965723647,1498
10,6,7,18,5,7,53,1.4673481178539682,18.75304376765055,1492
1,14,10,12,8,2,47,1.5423044397953523,18.664252685052972,1500
9,8,2,17,7,3,46,1.4621672726556034,18.613459156028785,1502
2,8,7,13,9,6,45,1.5818269687127995,18.84206811417272,1514
11,9,6,10,6,5,47,1.4185123287653432,19.27295736350677,1518
2,11,4,5,2,7,31,1.374235275471311,19.82122778552117,1536
2,12,4,0,6,6,30,1.2393619745722317,20.451612175333494,1547
0,4,5,11,12,1,33,1.2077256763327848,20.65570342474608,1565
11,9,2,5,7,7,41,1.2129437489030195,20.683220613639044,1577
2,8,5,13,3,3,34,1.3604918308994514,20.45273372394378,1593
1,9,14,5,8,6,43,1.3911185137794344,20.09953818366121,1585
3,13,5,7,11,8,47,1.4224010058430854,19.871273961859114,1581
12,8,12,6,15,5,58,1.4100390750607408,19.673765948736914,1586
0,9,5,9,12,2,37,1.5423231401907977,19.370080377442413,1587
6,14,10,9,9,10,58,1.553959718661471,18.981072893773206,1584
4,13,5,13,5,3,43,1.4659041359845622,19.291503012421778,1587
5,17,11,4,6,7,50,1.4193250875746224,19.77025355640365,1582
1,14,12,9,2,4,42,1.4882353389555218,19.75152137450212,1593
3,11,3,10,15,7,49,1.4605390491880634,19.998768947667557,1590
0,17,12,8,2,1,40,1.4477307004342599,19.725989932741843,1603
2,9,4,10,8,9,42,1.328394423941394,20.14029981997783,1591
0,10,9,5,0,5,29,1.1550107227857702,20.865422580297338,1600
4,13,3,7,5,5,37,1.1940115032915983,21.375504509210277,1627
2,9,5,7,1,6,30,1.1211207752339352,21.63108288130958,1623
2,13,4,6,6,2,33,1.0161681620400753,22.044597426746588,1630
2,8,3,5,1,2,21,0.9859670962363557,22.18922773927939,1621
1,3,9,0,12,5,30,1.144577464303384,21.459779515600374,1627
0,8,4,12,0,6,30,1.0754135051352063,21.82669478259554,1646
0,6,7,13,6,6,38,1.0416410943651633,22.15505133781958,1648
3,14,6,9,0,4,36,1.0645814468067203,22.27426957479343,1667
1,11,3,7,11,5,38,1.0460072482329006,22.555637804446793,1674
0,8,7,11,0,1,27,0.9619538075626862,23.206505927414717,1681
0,9,3,11,7,8,38,1.0577633763659722,22.547283476547108,1694
3,10,4,13,2,6,38,1.1418123520380088,22.788739291878297,1714
3,8,14,5,6,6,42,1.1199767027665375,22.79379430844149,1712
2,8,4,3,0,2,19,1.1151470840687523,23.078495667410195,1727
1,18,1,12,6,5,43,1.1006912617352393,22.796962100336067,1728
2,10,4,7,0,4,27,1.1271293804592533,23.256684971417773,1741
1,10,1,2,8,2,24,0.957612771845772,23.51920764226822,1742
4,9,3,6,2,2,26,0.9962129606948446,23.57381042172442,1754
0,10,1,8,6,3,28,1.0228022178852074,23.679806469309835,1756
2,10,3,0,0,9,24,0.9992227569470766,23.69255200555562,1773
1,14,12,0,7,7,41,1.018554824975426,24.001585334851338,1766
2,11,4,3,0,12,32,1.0588638711257332,24.027951513471493,1787
0,10,3,8,11,6,38,0.9525292640539629,24.310950254269937,1781
0,11,3,9,0,8,31,0.8679775816761668,24.81539821857719,1791
2,9,8,6,9,6,40,0.9613371907233496,24.485049844934714,1782
4,5,1,6,0,6,22,0.8350332644750887,24.952459914415282,1803
2,5,5,5,7,7,31,0.8565964841972039,25.12607756565828,1801
3,14,3,6,5,7,38,0.9605645496957592,24.45367791904982,1820
1,6,3,4,12,4,30,0.9780207544510386,24.429105529941626,1811
0,9,1,6,7,0,23,1.089164138468711,24.548404750532434,1820
3,6,5,9,9,8,40,0.9553639524115051,24.500416422015725,1818
2,7,3,17,7,3,39,1.1101995416407389,24.125850218406875,1828
4,14,6,10,7,8,49,1.079758451976588,24.549716319661158,1842
1,3,5,17,0,8,34,1.0341963324464902,24.64606754213476,1852
0,10,5,4,9,7,35,1.098291952818606,24.40278329233543,1854
2,5,6,5,0,8,26,1.0522915280941565,25.049189050193256,1868
0,9,7,4,8,5,33,0.9635752488509925,25.38214673771552,1875
1,15,5,5,4,4,34,0.9353288738010294,25.325061098280365,1872
0,8,3,9,11,7,38,0.9675487483991927,25.019431820074114,1871
2,18,3,6,0,3,32,0.9652685612947373,25.22428022781594,1874
1,7,6,2,7,10,33,0.8997072410760667,25.408906844625278,1873
5,11,3,6,0,2,27,0.7887845905499756,26.028181771413312,1875
1,12,5,9,11,3,41,0.8490834078557261,25.773335252340885,1877
3,12,2,16,4,7,44,0.9698369472282058,25.56111334264741,1891
1,4,5,11,7,3,31,0.9048304576745787,25.867606736129634,1892
1,17,1,9,0,8,36,0.87157121185229,26.002462522892717,1894
2,7,5,16,10,5,45,0.9677417042900578,25.555214461591827,1887
0,9,12,7,5,7,40,0.9965338966667828,24.957090119607955,1891
3,20,6,14,5,1,49,1.1765237597818299,24.812982146851937,1899
1,4,1,16,11,11,44,1.0970646875215955,25.600682356003027,1899
1,9,6,11,6,7,40,1.11301826186177,25.267480325063683,1903
9,8,1,11,9,9,47,1.03178103686043,25.482319108586008,1901
1,4,5,7,13,6,36,0.9115393043375378,26.335338443257854,1897
8,9,0,13,2,4,36,0.8764215223259024,26.836586648099164,1909
2,8,5,8,7,5,35,0.9104067572320852,26.260701247530882,1907
0,15,14,7,1,0,37,0.859464106094044,26.177300366916906,1900
6,3,1,2,7,3,22,0.837614706121866,26.618970002226174,1923
4,10,5,12,3,8,42,0.9627913793737306,26.52547792853542,1948
0,8,17,10,5,7,47,0.9471186379374259,26.336788404634547,1937
3,9,13,13,3,6,47,1.100234050048794,26.139507572130437,1957
5,7,10,11,11,3,47,1.024283093213803,25.944357163837896,1951
3,7,9,12,2,5,38,1.089460035032093,25.690543169798225,1965
1,6,19,5,10,6,47,1.1101836729013692,25.759107787247817,1973
1,7,11,10,0,5,34,1.0649879405428362,25.9415001211406,1969
0,13,12,6,6,6,43,1.0213230220446563,25.898175452923414,1966
4,4,11,14,0,7,40,1.0553443945677052,26.178484756778676,1984
1,11,11,16,12,10,61,1.0648526786055306,26.28738366919577,1979
3,1,13,17,5,5,44,1.0898762100110866,26.04243966731599,1992
1,7,7,15,7,3,40,1.1783347059850098,26.2999246426399,2000
0,12,5,14,10,7,48,1.2329849648506745,25.877787172504572,2009
9,9,11,16,6,5,56,1.0218309966302248,25.889842658386396,1975
4,13,6,3,3,3,32,0.9357335124131945,26.477372096327432,1977
4,5,9,6,8,8,40,0.8405212819417296,26.81546738104504,1975
5,7,5,11,4,4,36,0.8942501699003008,27.06248804194952,1995
5,4,10,7,14,8,48,0.8525245499543856,27.05825282381564,1996
0,10,6,6,12,4,38,0.883419771165821,27.24422894077438,2014
4,12,5,17,11,8,57,0.9453870723976142,27.218100470087208,2024
7,5,7,14,12,4,49,0.8565020323751151,27.22325954841065,2010
5,9,5,12,8,5,44,0.8957327147615405,27.08121188247858,2013
0,4,5,4,5,3,21,0.8743420942070357,27.11697432970481,2032
11,8,6,9,5,6,45,0.8844502715631167,27.282003061162385,2036
2,2,3,10,5,4,26,0.8191738405032537,27.55809694091656,2044
2,11,15,11,0,7,46,0.976534614801617,27.265057408235528,2049
2,6,0,3,9,6,26,0.9649658002371049,27.570268377094603,2057
1,8,6,5,1,5,26,0.9433132221951671,27.793601204663975,2076
2,5,4,10,6,10,37,0.7795664904575759,28.388187533782414,2067
1,11,1,8,6,4,31,0.8133721958765483,28.813023848038572,2085
4,8,13,7,5,6,43,0.8220752480379293,28.817366213806906,2082
4,5,1,10,1,5,26,0.8049942597985696,29.219585817796965,2100
1,9,5,3,10,10,38,0.7229090121217251,29.116451967245332,2086
3,9,10,7,4,3,36,0.7540744463065688,29.033840081329895,2092
2,7,6,4,0,3,22,0.7152320253366508,29.05400690636371,2102
0,9,4,3,8,6,30,0.7222796406213513,29.115158998847953,2105
2,7,1,9,0,6,25,0.6925522689444373,29.275332335624473,2103
0,10,5,1,6,8,30,0.6933176066028233,29.53447372035294,2108
2,0,4,7,0,3,16,0.6377487174387828,30.00170203578736,2114
1,11,3,17,7,5,44,0.800091411994762,29.430625540039404,2117
2,3,0,10,0,5,20,0.7367404674015018,30.096725542113578,2137
0,6,4,6,8,4,28,0.7574011998021645,29.88636266395578,2132
3,10,4,7,0,3,27,0.7185990561583404,29.818924079580256,2132
2,1,2,1,7,2,15,0.6937863784401767,29.91657034899037,2143
1,7,4,7,0,7,26,0.6735060201939356,30.273732319684115,2153
1,5,12,18,10,5,51,0.7981643982528538,29.802376558897226,2146
0,7,6,5,0,3,21,0.6885341379210448,30.026388053997106,2158
3,9,3,0,9,6,30,0.7666362762497383,30.009451752559425,2166
4,3,11,0,0,5,23,0.6872464114280149,30.195321446169064,2170
1,8,2,6,10,6,33,0.7393005519683941,30.450094180453085,2187
4,6,9,15,2,2,38,0.8075626523772055,29.93290218317856,2180
3,5,2,5,12,7,34,0.8342678544751779,30.21596095040396,2196
2,8,12,6,0,4,32,0.7405256652082032,30.24402144995311,2193
7,1,4,6,7,7,32,0.7049941750982726,30.361764526004013,2192
2,6,8,17,0,4,37,0.8139432570939981,30.042276196803968,2192
0,5,4,6,14,9,38,0.7091571205381421,30.40488320716207,2184
0,10,0,15,1,4,30,0.7070689104946698,30.633696529629123,2194
1,3,16,2,10,6,38,0.8019037764909793,30.308066548650594,2196
2,5,7,13,0,5,32,0.8208379209964695,30.211780094660977,2204
1,4,9,7,9,3,33,0.8278905613875283,29.90937833143222,2196
1,8,12,8,1,0,30,0.8381374028179018,29.856759429175426,2185
5,2,8,17,7,8,47,0.8338445318680529,29.874746243905477,2197
2,8,13,13,7,6,49,0.911341028142514,29.394573627661995,2204
3,2,6,8,7,7,33,0.9085647825064281,29.554988936904614,2206
2,9,5,3,5,3,27,0.8270992615779954,30.08231388114116,2229
1,4,6,14,17,2,44,0.856766825280353,30.155483922931513,2238
1,7,5,6,13,3,35,0.8176819462160628,30.54406747930345,2251
13,9,14,9,20,6,71,0.8547254110126239,30.48444914810144,2241
0,4,5,7,11,3,30,0.7911479416539853,30.43799071686299,2252
0,9,7,0,9,8,33,0.7040960147154781,30.981463272328362,2254
11,15,6,2,8,5,47,0.7093196196556326,30.72024324687912,2252
2,3,5,16,5,9,40,0.6596022776234343,31.475335520539318,2243
2,12,5,2,2,2,25,0.7335877489539201,31.51162079450977,2270
2,1,1,12,7,2,25,0.6855026489755307,31.34841236108729,2256
2,6,6,6,0,9,29,0.6669769398352456,31.39102649488559,2260
3,8,5,13,16,5,50,0.652297913530675,31.654420586562356,2253
0,5,2,15,1,7,30,0.6359712785484235,31.99449483187066,2263
0,9,14,14,7,7,51,0.7482261984389525,31.708530695664532,2261
2,4,9,9,0,4,28,0.8243231831874812,31.359701381291575,2274
0,6,4,14,6,7,37,0.7350605778501211,31.52985918425642,2272
3,13,2,5,0,9,32,0.7015514383881652,32.006037448417636,2286
5,4,6,13,9,5,42,0.6943130308074948,31.741127430112005,2287
3,10,13,6,4,11,47,0.6941299414174631,32.031895459080246,2297
1,4,9,5,5,3,27,0.6024699514208979,32.333970602925675,2301
2,5,3,6,0,4,20,0.573371414980543,32.756935020491404,2299
0,9,16,13,5,9,52,0.5945813409554377,32.61679830339969,2291
2,6,2,9,14,7,40,0.6242373702850226,32.26553444120242,2302
1,12,10,10,0,2,35,0.622778360480302,32.46819026573596,2301
0,4,3,7,8,7,29,0.5552535202400752,32.44280294187815,2313
1,8,7,13,0,2,31,0.602755912632673,32.730372414143474,2325
3,5,1,10,5,5,29,0.6048526562933109,32.846364375387914,2333
1,8,8,8,4,8,37,0.7133934258817277,32.40653758954019,2340
2,3,4,7,16,5,37,0.6908200713793763,32.25262535542154,2325
0,7,6,0,6,4,23,0.5865455037768288,32.83386513357493,2337
5,9,5,11,7,4,41,0.636507412137457,32.83719072286095,2349
2,2,11,4,0,4,23,0.656139327257166,32.882551425560614,2361
1,8,2,11,14,5,41,0.7488156291386378,32.71294737267059,2357
1,11,5,6,0,7,30,0.676153745068678,33.058005573963634,2358
0,5,8,6,8,5,32,0.6394004319719186,32.75233693792635,2347
0,6,7,5,0,6,24,0.61902015804096,32.8611111631811,2354
3,8,6,5,13,7,42,0.5951300646006158,32.97581715481366,2348
1,5,5,16,0,5,32,0.6464252812238731,33.163905043293845,2359
3,11,1,12,11,4,42,0.6771267504168481,33.16948986617927,2366
3,5,9,7,0,8,32,0.6873503144639381,32.797609567193,2369
0,8,5,0,9,3,25,0.7190532380974011,32.990730050964416,2388
0,3,5,2,6,3,19,0.6816681762092239,33.11963786613197,2394
1,6,13,4,9,6,39,0.6685992191409359,33.44148337751867,2389
3,4,6,7,2,2,24,0.6752307572143956,33.45742596778465,2401
1,7,2,11,10,8,39,0.7621070397753883,33.42953013626132,2418
2,6,0,9,0,6,23,0.7218594856573043,33.62657161948989,2423
0,9,8,12,7,9,45,0.749977825777782,33.46308126676374,2433
3,9,1,9,0,4,26,0.6617085007783624,33.95419477234042,2422
0,5,5,7,6,7,30,0.5166374980119179,34.21391368450632,2408
2,7,3,8,0,4,24,0.5413623395345272,34.52362251806723,2420
1,7,3,11,7,3,32,0.4991539533790104,34.395811759311236,2419
2,11,2,7,0,4,26,0.49031818520897963,34.462447596179366,2413
1,1,5,2,5,3,17,0.47196856868574694,34.347930334783065,2418
5,9,2,5,4,6,31,0.5657496879894646,34.093925463994424,2427
2,2,15,18,6,3,46,0.5824371795005422,34.21336178794301,2412
0,7,4,7,4,6,28,0.6648389760751562,33.83019831155924,2423
3,5,9,5,13,5,40,0.6343684244808495,34.314335874917994,2422
0,3,3,7,0,2,15,0.5902662399705088,34.55783624383993,2418
0,9,6,7,7,9,38,0.5831700407095308,33.99503634984479,2411
0,1,13,6,0,7,27,0.5064504066611041,34.42355441667288,2411
0,13,2,5,8,6,34,0.5418769789443986,34.381008008738405,2410
0,0,14,4,5,6,29,0.49049359618598415,33.950471876664324,2399
0,15,5,6,5,1,32,0.5222473501453465,33.63154874384261,2390
0,2,5,4,14,3,28,0.4951084319044597,33.62846274508739,2386
0,6,3,5,12,1,27,0.5224335889280526,33.590524785341195,2381
0,0,1,6,10,3,20,0.4562942758526553,34.106856604693895,2383
1,3,0,3,10,3,20,0.48223804372098755,34.2222712252295,2377
0,0,5,7,13,5,30,0.5904099040482558,33.70804118905895,2380
0,7,8,5,12,9,41,0.5761645935702459,33.22816171011016,2367
0,2,7,5,7,6,27,0.5957951063063802,33.24014759552543,2361
0,0,0,2,7,2,11,0.5979459986131643,33.30604793410313,2366
0,11,6,5,7,4,33,0.6728242618811501,32.93541898469492,2361
1,0,2,3,7,4,17,0.698270474811582,32.7007312636209,2373
0,7,5,0,11,3,26,0.7007202858148228,32.83093444856064,2370
0,0,5,7,8,6,26,0.7034524111105863,32.54090572570548,2371
0,8,6,6,10,5,35,0.7114090205917782,32.320474922167286,2356
0,0,6,4,10,2,22,0.750016769551805,31.665640774377856,2355
0,10,5,5,5,6,31,0.7573785296010735,31.60615027283863,2354
0,7,5,2,8,5,27,0.743443955462733,31.934571351374416,2348
0,17,6,0,7,7,37,0.7671655593555953,31.88977710143207,2358
0,10,9,6,9,5,39,0.7565626393449344,32.08373079317578,2354
0,11,3,16,6,2,38,0.8006128843963555,32.27409848582104,2366
0,14,8,3,7,8,40,0.8051499254096581,32.239344062024465,2368
1,12,2,17,6,6,44,0.8127843705371107,32.17362204915137,2367
23,18,4,13,6,6,70,0.9442892808005856,30.985124545622007,2351
0,17,5,14,20,6,62,1.013949605305129,30.475357434571055,2346
2,9,5,8,1,7,32,0.9219573965434025,31.55458486545353,2359
0,15,12,13,20,8,68,0.9647056893107205,30.98213921540049,2344
1,22,6,4,7,6,46,0.9675096657325271,30.988012755638913,2366
0,16,11,8,7,3,45,1.0058726829276619,30.753566501598,2366
0,17,7,7,3,5,39,0.9487824759824899,31.88367456460497,2393
0,15,14,3,5,4,41,0.8733544482220853,32.02321887727893,2390
0,14,5,12,2,1,34,0.8281432038874996,32.43766362523815,2397
0,12,4,13,5,2,36,0.8182746383940889,31.96374743534844,2406
0,12,8,13,9,4,46,0.9269912961131985,31.6085992172552,2412
0,14,9,16,5,8,52,0.8500721950162833,31.83750861724696,2410
0,19,5,14,3,6,47,0.8640735121887784,32.08741646796,2423
0,11,18,15,0,3,47,0.9206630473019579,31.686868154334988,2414
0,19,2,18,4,0,43,0.9156946186633101,31.518696269272642,2415
0,16,14,14,1,12,57,0.8404463236268254,31.91958026767849,2417
1,21,1,18,4,9,54,0.9143080540307758,32.02650936654734,2434
0,15,13,15,1,7,51,0.9443599610859617,32.24138732247364,2436
0,20,1,7,0,9,37,0.9355861050535901,33.023772568259204,2476
0,14,7,13,0,7,41,0.8527342957251748,33.5568883639206,2494
0,21,7,8,8,1,45,0.7720572060309964,33.875198459081076,2492
0,17,2,11,0,6,36,0.7226317162654101,34.32572632747158,2498
0,13,12,5,0,3,33,0.6757274579662425,34.88590998038418,2518
0,16,0,19,5,7,47,0.6241049644960719,35.0371476559393,2531
0,16,11,10,10,2,49,0.60709234914395,35.753706468595645,2546
0,15,6,9,0,5,35,0.5931558856072322,35.90508719616326,2552
0,12,5,12,4,8,41,0.5589506450040057,35.940745766265174,2557
0,14,1,15,0,3,33,0.5245501497031883,36.05811109284803,2564
0,13,4,11,0,3,31,0.575987316288352,36.17658964190237,2572
0,12,9,9,0,6,36,0.5358631517655619,36.15803768162008,2565
0,12,1,5,0,4,22,0.5837981356503779,36.351058685021634,2583
0,10,2,12,0,2,26,0.49268283779153993,36.50433124736168,2564
0,9,7,6,0,2,24,0.5052826726534374,36.6257120656748,2579
0,11,8,10,0,3,32,0.4344554141914842,36.99762341915665,2570
0,8,0,6,0,3,17,0.5036764760242519,37.08631069442507,2590
0,7,6,10,0,8,31,0.4510290125915596,37.146255208407865,2589
0,7,0,16,11,4,38,0.4819701208129644,37.187787257973866,2590
0,7,1,14,0,6,28,0.5039146031719024,37.27091201096281,2599
0,6,0,10,0,5,21,0.541217678650384,37.412546293885235,2604
0,7,1,16,0,4,28,0.5345355108763851,37.34120132381762,2608
0,2,3,10,0,1,16,0.5340360775331866,37.26512497250733,2621
0,7,5,1,0,7,20,0.482991192108353,37.38541228297752,2622
0,14,11,15,0,2,42,0.5424666420672233,37.327598368977974,2635
0,7,0,13,2,5,27,0.5446177637248506,37.6752216220026,2649
0,12,12,1,0,1,26,0.5320671552293447,38.12656264163803,2658
0,6,2,15,0,2,25,0.508604186698352,38.023222746921455,2660
0,3,1,6,0,0,10,0.5823684586858975,37.93625080793476,2677
1,6,2,16,0,7,32,0.4970380480878615,38.14956219481365,2671
0,3,1,14,0,5,23,0.5091366708582727,38.257531836821435,2684
0,6,8,9,0,7,30,0.5129941375840555,38.06959829210331,2687
0,5,4,11,0,6,26,0.4849430030824124,38.44287444045744,2687
23,5,0,0,0,6,34,0.4661418811828681,38.1932063493547,2675
24,4,2,13,5,4,52,0.5041555877951396,38.15414353938337,2665
0,6,4,0,5,1,16,0.46294631517472734,38.2874107143676,2671
2,2,1,9,7,7,28,0.4747903179769661,38.40249124253477,2687
19,7,10,1,6,6,49,0.5516802589462413,37.580098520434916,2669
1,16,0,11,9,8,45,0.612149601287664,37.34503781148984,2669
24,6,8,0,14,3,55,0.643388932328703,36.81674309727673,2655
0,11,5,13,6,8,43,0.7083912625502738,37.052206064866006,2662
0,5,1,8,17,5,36,0.7089195117644436,36.788472000314954,2677
0,6,6,15,14,0,41,0.7277635080907932,36.96252678532877,2685
25,6,4,11,23,5,74,0.7859014115048901,36.3061494991073,2665
0,10,14,14,10,4,52,0.8662383564142758,36.54041120442989,2670
21,6,1,13,17,6,64,0.8204204022604286,36.42534636092312,2654
0,9,9,0,10,3,31,0.7759246069486829,36.885592682212014,2673
0,2,3,7,13,10,35,0.6960772564496162,37.21557247640663,2684
0,10,9,5,12,7,43,0.6684215723445531,37.04231319789736,2693
0,6,9,0,14,3,32,0.5862420077636076,37.23954959730114,2705
0,12,15,5,15,9,56,0.6690448435046387,36.79812362118258,2704
0,6,5,12,13,5,41,0.7058684908432936,36.83381341584108,2722
0,8,6,12,11,5,42,0.694184022497362,37.2469641774039,2714
0,3,17,13,10,3,46,0.7639307771893207,37.00159586592708,2703
0,10,3,7,0,1,21,0.8244889963868367,35.96663083116305,2709
0,10,7,15,0,11,43,0.6860545992769527,36.34571110275612,2689
0,9,5,17,11,4,46,0.7156950758637202,36.795395883332034,2695
0,14,6,6,0,0,26,0.6531035203223121,36.634648121001725,2705
0,10,6,15,11,9,51,0.689157681996614,37.06135361370438,2710
21,1,13,2,3,5,45,0.684168487858727,37.143858617900946,2711
2,6,7,15,23,7,60,0.7807606470520251,36.198043828153715,2711
1,3,13,12,12,5,46,0.7429711575528487,36.61579547048808,2701
0,16,6,15,15,5,57,0.7470664565148134,36.426132065075144,2698
0,18,9,0,8,9,44,0.7696764681259242,36.06566704333751,2698
0,8,6,13,9,5,41,0.8353395718543356,36.13434859265494,2701
0,10,7,7,3,1,28,0.8057128833230893,36.37183400536137,2708
0,9,6,15,7,2,39,0.7811537406385582,36.21177729512464,2710
0,6,12,14,10,0,42,0.7957757104356192,36.5252966041187,2715
0,6,5,13,6,0,30,0.7812922860437949,36.33364442246559,2727
0,6,7,13,2,4,32,0.7123530386510274,37.08062264447399,2751
1,10,8,18,4,0,41,0.702440739914973,36.70859599936661,2734
0,7,10,18,0,0,35,0.6771049380390075,36.62077116599432,2755
0,14,10,2,11,0,37,0.7346652629012629,36.942555590524485,2764
5,11,8,9,0,0,33,0.7631551160419399,37.36523418783083,2781
20,7,10,4,8,0,49,0.8207708711941107,37.092225062275794,2781
0,15,4,11,5,0,35,0.6854037500261085,37.77916060691901,2781
0,13,11,18,1,0,43,0.6192857601772547,38.23415708680255,2783
0,12,7,7,0,0,26,0.5820071800343803,38.085456445026395,2778
0,10,10,17,10,2,49,0.549743717741209,38.25033415061115,2765
0,2,6,14,15,1,38,0.5120475152492939,38.56883028521844,2789
0,6,5,7,13,0,31,0.5350836560087996,39.1441942263129,2797
0,8,13,17,6,0,44,0.5485534995158251,38.98893794129763,2784
0,2,4,14,7,0,27,0.5574825121547771,39.50916864854001,2802
0,10,5,7,2,3,27,0.47430212246563963,40.07125496323724,2813
0,7,14,7,0,0,28,0.4203055971210223,40.11855533632615,2798
0,16,0,0,0,3,19,0.42794486515677094,40.35207219600592,2818
0,3,14,6,0,6,29,0.3885495697070305,40.625374978281585,2828
22,7,0,0,0,5,34,0.39922589319017393,40.573423392073956,2825
0,3,12,16,4,10,45,0.3876969814575654,40.598749019505654,2816
20,4,1,5,12,1,43,0.3698013844321888,40.15535080625211,2797
1,0,10,13,12,0,36,0.35929447124008723,40.60665756770644,2789
0,1,1,15,4,0,21,0.4232450144502112,40.43706030361033,2804
0,5,11,1,7,0,24,0.40695303032417784,40.743097380909205,2811
0,0,3,10,2,0,15,0.4011188663889775,40.68865607986192,2829
24,6,8,2,13,0,53,0.4423203803213229,40.09579633984225,2814
0,0,5,3,10,0,18,0.5093345590429903,40.0310390903306,2820
0,4,1,13,14,0,32,0.49193879760381387,40.27742961111153,2826
1,0,8,6,17,3,35,0.4724347485683799,40.59924613170871,2831
0,1,4,0,14,0,19,0.5323620610765304,40.23943048604365,2838
0,3,9,8,15,0,35,0.5355796133841949,40.34781927002425,2850
0,5,3,12,14,2,36,0.5522189675870642,40.41790693575946,2849
0,2,5,4,6,0,17,0.5242629261052225,40.19796744514222,2853
0,5,13,13,6,1,38,0.5223238843437686,40.079011389009594,2850
0,1,3,5,5,0,14,0.6214657453607745,38.910945746791676,2858
0,1,8,1,11,0,21,0.5994223098539513,39.31361344907031,2855
0,1,1,4,5,0,11,0.589512401582655,39.54170770621763,2875
0,7,7,0,0,0,14,0.5601444184992665,39.85272494004338,2885
1,2,12,12,5,0,32,0.5789740675347005,39.98931039935185,2890
23,13,2,6,0,1,45,0.5685259176784265,39.51337063220154,2878
6,8,11,2,12,0,39,0.5520555985084068,38.9984745938493,2867
0,13,5,12,12,0,42,0.5910179953592215,39.10218779203812,2874
2,11,8,2,13,1,37,0.6359368617168953,38.876043799726695,2893
0,15,1,7,14,0,37,0.6559227109518191,38.69883752836097,2894
0,7,4,10,5,1,27,0.5817808254168212,38.70568341432709,2895
0,12,5,13,12,0,42,0.560797623877195,39.02633012780392,2883
0,7,9,7,1,0,24,0.5875940390673317,38.98251032440157,2884
0,12,6,7,2,0,27,0.5450713324577785,39.42627280024006,2892
0,9,5,6,6,0,26,0.48410692071821304,39.78599367577812,2900
0,7,5,1,5,4,22,0.5244591479254106,39.88133604328,2921
0,7,5,4,4,0,20,0.41683539772422007,40.97245797295336,2936
0,11,2,5,6,2,26,0.4633110722354544,41.0897415405175,2946
0,1,13,6,2,0,22,0.4135579553768073,41.6963320044072,2967
0,6,1,11,1,0,19,0.42636137039461564,41.72329536474595,2984
0,9,0,2,6,0,17,0.3982338495500415,42.51184641414713,2997
0,5,12,6,3,0,26,0.4084197697640563,43.29246448375184,3008
0,9,9,1,0,0,19,0.4456949229821834,43.60844918565136,3026
0,8,4,10,0,1,23,0.39676834724235266,43.80669449718295,3049
0,13,9,0,6,0,28,0.4617695434965523,44.138956836257286,3064
0,9,0,11,10,0,30,0.452267156608607,44.39656251921865,3080
0,12,0,3,0,0,15,0.4128425528352475,44.59979770820738,3088
0,9,0,10,2,0,21,0.385750792232206,44.5631270411178,3104
0,7,16,7,0,0,30,0.39392101041848604,44.5250894953936,3110
0,1,0,7,0,0,8,0.38843108630872303,45.027358115601785,3125
0,6,10,15,0,0,31,0.4214560357130809,45.00579166094411,3131
0,7,2,5,0,0,14,0.4216078897288048,45.712835596358396,3155
0,3,3,14,0,0,20,0.3963661564220341,46.211448565850844,3173
0,0,0,3,0,0,3,0.40172001662481066,46.40604278762572,3190
0,0,6,11,0,0,17,0.3213020030909591,46.71667640017019,3185
0,0,1,5,0,0,6,0.24802696716303277,47.13724676198006,3218
0,0,16,9,0,0,25,0.23759008422231495,47.28168496300091,3207
0,0,0,9,6,0,15,0.25431610832679075,47.030099636534544,3214
2,0,5,0,0,0,7,0.29600222769703866,46.80892989329921,3231
8,0,3,8,6,0,25,0.3345738283609197,46.53982486539621,3236
14,0,2,14,0,0,30,0.3930156223699497,46.310123345709464,3248
15,1,3,3,5,0,27,0.3588659785106464,46.33377138960308,3249
29,0,15,2,15,0,61,0.4222747562853925,45.48922551861999,3224
13,2,7,2,20,0,44,0.4572704392725006,45.39457789667999,3224
12,9,0,11,8,0,40,0.4779102650805457,45.419560909587545,3250
8,6,0,5,8,1,28,0.4425142833112806,45.696505350522514,3267
11,0,12,2,3,3,31,0.49051156409219376,45.68353117664682,3296
9,6,6,5,3,1,30,0.4107789572163155,46.225852034933595,3307
6,0,3,7,0,8,24,0.4295303710017349,46.53140961814878,3323
3,1,2,13,20,0,39,0.43705027233697313,46.97594599039936,3345
3,8,7,1,8,6,33,0.43303772410086494,47.59716193532587,3370
4,1,2,10,0,0,17,0.42628547548838835,48.20944419227312,3388
6,8,1,1,5,0,21,0.39125162697350024,48.675260799423924,3402
5,0,10,9,0,5,29,0.3448954218239112,48.93832657233971,3416
0,13,4,2,6,0,25,0.36490699375500746,49.39786111518394,3427
1,3,9,0,0,9,22,0.3199760870924973,49.45954908866658,3427
0,1,17,5,17,17,57,0.35251245429601896,49.30091106805949,3429
5,1,9,8,10,2,35,0.335375423251243,49.23140015508497,3429
2,0,5,0,17,0,24,0.34913226294117855,49.33415849013391,3438
1,1,1,0,7,0,10,0.29673794010596416,50.140487650421726,3453
0,1,8,2,17,0,28,0.3037046309434122,49.86842783849133,3463
0,2,1,5,0,0,8,0.23961584954857898,50.54485497305217,3472
0,0,5,2,10,0,17,0.24250239437892407,50.84755411155389,3486
0,0,5,6,3,0,14,0.20868244012395218,51.60371785844609,3503
0,1,5,16,0,0,22,0.2010787000914917,51.825670814371996,3516
0,1,3,7,0,0,11,0.17400376728626246,52.53522351700158,3528
0,0,4,5,10,0,19,0.18018657233852137,52.42890021403139,3529
0,0,1,2,0,0,3,0.14499142892167532,53.11278091153701,3543
0,12,0,5,5,1,23,0.17151996348136903,52.937836618452636,3541
1,0,12,2,0,6,21,0.15605005624665616,53.120435744107986,3547
0,2,1,0,0,13,16,0.16476743108666078,53.225672437344,3552
0,3,7,5,4,2,21,0.11625125714943879,53.09514407996543,3554
0,0,0,14,0,5,19,0.1170679601885427,53.20339456827188,3562
0,10,0,12,0,9,31,0.1551921274392146,53.55923861555686,3571
0,2,0,4,0,7,13,0.16461190726116354,53.5821715107773,3575
0,0,0,0,0,10,10,0.1819050527934054,53.46507160792379,3577
0,2,2,5,0,10,19,0.19805831261521606,53.18307249108395,3572
0,2,1,6,0,2,11,0.19773554574474156,53.35260997420015,3571
0,0,8,6,0,7,21,0.19917794072806408,53.481425607755156,3574
0,7,6,1,0,6,20,0.16936537616788425,53.47426652773764,3574
0,11,5,4,0,7,27,0.15124809765039757,53.5071092358735,3576
0,7,5,1,0,6,19,0.14436373216806844,53.59942375059874,3573
0,3,6,5,0,8,22,0.10602936155538162,53.712146901763695,3575
0,8,0,9,0,4,21,0.1042661233673801,53.91335158651215,3576
0,2,0,5,0,7,14,0.08477600701217616,53.73875666139248,3579
0,2,0,6,8,3,19,0.06682975265336683,54.29132716270128,3576
0,6,0,6,0,3,15,0.07049829199113529,54.05554298349566,3576
22,7,0,6,0,2,37,0.10143480490890333,53.818096117786915,3560
0,0,6,5,0,5,16,0.12659524450368007,53.22569761943176,3557
1,1,0,4,19,5,30,0.1408582603146405,53.38045479492144,3555
24,2,1,6,3,1,37,0.1314914665850685,53.01236406095791,3544
0,0,0,9,13,1,23,0.1328900735579608,52.733283334658914,3533
22,0,0,5,12,0,39,0.1668300760824438,52.16130618102833,3522
0,1,4,2,19,1,27,0.16102287733140686,51.887169972529406,3516
25,0,1,5,10,0,41,0.21412636086583858,51.20661656372382,3505
5,5,5,6,12,0,33,0.2037409244608197,51.13285030975247,3488
0,8,6,1,9,2,26,0.26821679540041243,50.69331616267075,3497
0,1,3,5,13,4,26,0.27971904691939226,50.66587078491302,3500
0,1,2,4,6,4,17,0.290136530319472,50.74226438812561,3513
0,5,3,5,12,1,26,0.27102243023241046,50.019027168187186,3503
0,4,5,8,8,6,31,0.29566383514372463,49.62898262812304,3481
0,5,2,5,7,3,22,0.33471688273884154,49.68455594980285,3490
0,13,4,6,5,6,34,0.3306220595006257,49.281086471045136,3471
0,11,5,6,4,3,29,0.37564139065471036,49.45450653651283,3474
0,8,3,7,1,3,22,0.3379182959149969,49.226320694965196,3459
0,13,1,5,0,0,19,0.33926066396656684,49.28346998479018,3457
0,10,1,8,1,5,25,0.40942945250100843,48.67777287157429,3462
0,10,0,7,0,8,25,0.4704981936961427,48.1520823882638,3471
0,14,1,8,4,14,41,0.46364717067389916,48.28900292794195,3458
0,18,1,12,0,3,34,0.4746105709203409,47.40361677090986,3450
0,17,0,3,5,8,33,0.45485581776939876,47.57036067862822,3453
0,11,3,13,0,0,27,0.4347152801161926,47.583782559701895,3448
0,6,2,11,0,0,19,0.4029260843499702,47.804184205231095,3439
12,7,0,6,0,3,28,0.3922898496649679,47.56780090116553,3446
0,5,1,11,8,0,25,0.3825248559898649,47.854409060533676,3434
0,7,5,11,12,0,35,0.4153240899263601,47.58489624375369,3434
0,12,5,7,3,0,27,0.4036226761127213,47.675756016799525,3430
0,13,1,11,2,0,27,0.42616112280700985,48.12208550372866,3449
0,11,1,4,3,0,19,0.4208234621443953,48.801405593050305,3462
0,7,1,1,5,0,14,0.3587008535037511,49.3991758885612,3473
0,10,0,18,0,0,28,0.2923897583103129,50.21786509579303,3484
0,6,4,9,0,6,25,0.26207806321599364,50.778141356972775,3505
0,6,0,7,1,3,17,0.21416390976107957,51.942764935731816,3530
0,2,1,1,0,0,4,0.12149912570986168,52.65006475268727,3539
0,0,0,1,0,1,2,0.10095079424478096,53.47907167704625,3553
0,3,1,6,0,0,10,0.11260880689435167,53.84485733993077,3566
3,4,0,2,0,0,9,0.13642403634042924,54.054535214197486,3571
0,7,11,2,0,0,20,0.1351096357077662,53.91659100315586,3571
0,2,5,4,0,0,11,0.13237811726566123,54.130202995942916,3576
0,5,0,9,5,0,19,0.11837111062619178,54.22587694168485,3580
0,5,0,6,0,0,11,0.06917593316209592,54.42910291394178,3568
0,0,0,1,0,0,1,0.07927552348255375,54.50376443112447,3574
0,1,12,5,0,0,18,0.09306039570343409,54.3831920640209,3577
0,0,2,3,0,0,5,0.0738487513368303,54.44247029997479,3573
0,1,0,5,0,0,6,0.09243192902285059,54.215435855199885,3579
0,0,0,1,0,0,1,0.07061439759342557,54.603362348138305,3594
1,2,0,1,0,0,4,0.06892814305528946,54.70749070287385,3599
0,0,0,15,0,0,15,0.054051088835223964,55.00855507869902,3605
0,0,3,6,0,0,9,0.08608652958600349,54.70257366890486,3609
0,0,0,6,0,0,6,0.06556532675463768,55.073780725242166,3620
0,0,0,8,7,0,15,0.06232260199027296,55.19514212652043,3608
0,0,0,1,0,0,1,0.06269358784244103,55.213046633197685,3612
0,0,5,11,0,2,18,0.05382941619422586,55.27485876435126,3603
0,11,0,0,0,0,11,0.07681273315838673,55.000208254770584,3602
0,0,1,8,0,1,10,0.06895308651264398,54.447934338166405,3597
0,0,0,3,0,0,3,0.08257162289981086,54.69438457771514,3602
0,0,0,18,0,0,18,0.10914603561161193,54.35950052387634,3601
0,0,4,11,0,4,19,0.1393960163474483,54.072385849257664,3599
0,0,0,12,0,0,12,0.12687841165669575,54.336079977976965,3593
0,0,0,2,0,0,2,0.10377031329353888,54.53639898101742,3597
0,0,0,0,0,0,0,0.08299722905942195,54.75323517967119,3609
0,0,0,12,1,0,13,0.053628992071361174,54.77376295439779,3609
0,12,0,3,0,0,15,0.07719615083955443,54.692020637519335,3605
0,0,0,13,0,1,14,0.09633892204317077,54.23054310883681,3601
1,0,0,0,0,4,5,0.08825745893642721,54.617108303471056,3607
0,0,0,18,0,0,18,0.09080661182472655,54.65477584205998,3607
0,0,13,13,0,6,32,0.11934807752919703,54.042538695943364,3595
1,11,1,5,0,0,18,0.17074264476207054,54.12438565500253,3606
0,0,0,1,0,2,3,0.12832821646289033,54.391059282123315,3614
0,0,1,5,0,4,10,0.13236126330577533,54.60129063834422,3627
0,0,0,8,0,7,15,0.05857579137691427,55.0859500745261,3630
0,2,13,7,0,0,22,0.07196795138035608,54.95349482073475,3618
0,0,0,1,0,0,1,0.09049569764310252,54.8403222824238,3625
0,0,2,5,7,1,15,0.10047324825465492,54.44217918537177,3617
0,0,1,0,0,0,1,0.07257654556518485,54.9331350879567,3624
0,7,2,5,0,0,14,0.08520947323552365,54.83675382737422,3623
0,0,2,2,0,3,7,0.08652719962728385,54.607183191323145,3617
0,0,0,5,0,11,16,0.1262893846419044,54.212961887496256,3616
0,1,1,5,0,3,10,0.08054491923019065,54.655617856198305,3611
0,1,0,6,0,1,8,0.08276498369949413,54.402907131153306,3612
0,1,0,1,0,0,2,0.06551134155599223,54.58302308692163,3610
0,6,0,6,0,0,12,0.08432979375187498,54.45591910610923,3610
0,1,2,1,0,0,4,0.062231317385103756,55.040419494500945,3622
0,2,0,6,0,0,8,0.07597063300060378,54.93020507328076,3622
0,5,2,5,0,0,12,0.07667604551195549,54.93086737735036,3619
0,0,0,7,0,0,7,0.07216245225851772,54.71318826379387,3612
0,5,0,1,0,1,7,0.10870053379498638,54.55534549038745,3618
0,8,1,5,0,1,15,0.14007909137784455,54.16040311168812,3624
0,3,2,6,0,6,17,0.125575637212394,54.36091125974712,3618
0,7,0,6,0,0,13,0.10940664348906605,54.64380810424593,3622
0,1,0,10,0,14,25,0.13379406743701483,54.03884224248762,3614
0,7,1,7,0,7,22,0.12671659326529588,54.053349821494365,3607
0,8,1,5,0,2,16,0.14945508420896794,53.916182086756784,3611
0,6,0,7,0,6,19,0.16730107068787622,53.531404765451896,3604
0,0,3,6,0,2,11,0.10818120134698109,53.94619268305561,3596
0,1,2,14,0,8,25,0.15105928542894972,53.58318487649656,3602
0,5,1,13,0,1,20,0.13625256897240795,54.093526033873474,3600
0,6,1,6,0,0,13,0.14211905001948025,54.07030019031446,3593
0,7,0,3,0,4,14,0.1518647257388853,53.94396015309421,3600
0,1,0,6,0,4,11,0.14144495491024492,54.082421054208446,3601
0,6,1,2,0,0,9,0.1302803661879957,53.944396542558486,3606
1,7,0,14,0,10,32,0.1583978256751614,53.616222289910446,3602
0,1,10,10,0,4,25,0.1538866460419171,53.815577581733386,3596
0,6,1,6,0,4,17,0.15724859198719648,53.799202674302606,3594
0,0,0,11,0,9,20,0.13035451999238176,53.659537570005455,3589
0,7,0,5,2,1,15,0.17642413185399355,53.3007553125945,3582
0,0,10,6,0,3,19,0.11099977322220174,53.343023379963505,3572
0,2,5,4,0,4,15,0.11227587377775472,53.817855690230296,3576
0,5,0,5,0,1,11,0.09571867130164394,53.99207791939323,3585
0,0,0,6,0,0,6,0.06537613468986456,54.37520977383512,3590
0,4,1,2,0,0,7,0.07300971483888719,54.340995188225534,3593
0,7,0,6,0,0,13,0.07424277970549412,54.041606282669946,3584
0,5,0,6,0,5,16,0.10815632124954642,53.71721986366567,3578
0,1,0,5,0,6,12,0.0921163903870021,53.72278495035448,3573
0,1,0,3,0,2,6,0.07966164052303032,53.92952314567234,3576
0,5,0,16,0,3,24,0.12048551550390309,53.81828865522356,3578
0,0,1,7,0,0,8,0.12202764597962733,53.66302062495186,3577
0,0,0,6,0,4,10,0.11378832443528085,54.03557360931033,3578
0,5,0,2,0,2,9,0.13154622433422727,53.954169388273016,3584
0,7,0,10,0,0,17,0.14171127907708247,53.78905766516168,3589
0,0,9,6,6,4,25,0.13672479108780525,53.59358842574546,3586
0,8,4,12,0,6,30,0.19558673913804725,53.42764968914236,3592
0,1,1,11,0,3,16,0.18928851431952998,53.616202689073795,3591
0,3,0,16,0,5,24,0.21411831878635795,53.337108714356006,3588
0,6,2,9,0,5,22,0.24049882538597597,53.062963630431355,3587
0,9,0,5,0,2,16,0.23012064375452526,53.30476081333695,3588
0,0,11,1,0,5,17,0.18781211103050974,53.489161956178876,3593
0,6,4,4,0,5,19,0.19717395226554918,53.38975839430424,3605
0,1,9,5,0,5,20,0.14668050982747646,53.459761097629446,3602
0,8,6,9,0,6,29,0.15216736226891173,53.52789107226125,3595
0,0,1,6,11,4,22,0.1377897422712746,53.34265187861878,3583
0,9,0,7,0,8,24,0.15490197035593076,53.25905879006421,3579
0,4,1,6,0,7,18,0.15232040327180632,53.052800829645726,3576
0,11,0,5,0,4,20,0.16642623775475554,52.876053477161555,3570
0,1,1,6,0,6,14,0.2031399342174879,52.65827898645206,3573
0,11,0,7,0,7,25,0.19921952545774305,52.541424743862706,3561
0,4,0,8,0,6,18,0.20547221886299014,52.50370164785517,3561
0,12,1,9,0,6,28,0.21775397304721794,52.38488495171499,3559
0,4,0,4,0,7,15,0.19795803844095208,52.36847239752947,3551
1,11,2,6,0,5,25,0.23203303623505914,52.09168546894889,3547
0,3,0,1,1,5,10,0.2171587195249501,52.06298696886757,3540
0,3,2,8,0,6,19,0.23674653377434327,52.01681171591975,3539
0,10,1,5,0,10,26,0.21436534568085433,52.214969100373985,3552
0,4,4,1,0,5,14,0.19258051062987766,52.020583095121346,3549
0,0,0,0,0,5,5,0.19680125365703377,52.422096379503884,3562
0,5,0,0,0,5,10,0.15398840888005474,52.57369207297909,3559
0,0,0,8,0,1,9,0.1484184915690269,52.72288105344681,3562
0,4,0,2,0,3,9,0.15192129262627957,52.759490128956884,3568
0,0,1,1,0,0,2,0.14320829054163356,52.79665142225111,3577
0,8,1,6,0,2,17,0.18621800075282469,52.5203943369674,3579
1,2,0,2,0,4,9,0.20788978745017644,52.54385893747142,3586
0,8,0,1,0,0,9,0.17200735900882913,53.053889930920185,3594
0,0,0,6,0,7,13,0.16203082995041704,52.92065835684958,3590
0,7,0,7,0,7,21,0.17497943283725623,53.064839199918474,3585
0,4,0,8,0,5,17,0.14138013379627976,53.04832301035038,3579
0,1,0,4,0,3,8,0.1195824919555767,53.52455239338131,3585
0,6,0,12,0,0,18,0.1015048600870888,53.70732964785112,3584
0,5,0,2,0,1,8,0.1186709054995196,53.7864783782654,3585
0,0,0,5,0,3,8,0.11838538054747767,53.95223292460621,3592
0,0,6,0,0,3,9,0.07992275960197984,54.184219007998884,3593
0,1,0,3,0,0,4,0.07368685939113712,54.38936052933379,3599
0,0,0,6,0,0,6,0.05655084704845998,54.5268990800343,3601
0,0,0,1,0,0,1,0.049555669721434534,54.70609614153898,3604
0,1,1,0,0,0,2,0.05288288819858564,54.94128577456909,3609
0,5,5,3,4,0,17,0.0801344804565673,54.5398291376436,3604
0,0,5,1,2,0,8,0.07727111151865691,54.5678631309027,3602
0,6,4,0,5,1,16,0.08743664486747917,54.65321350518479,3605
0,7,1,2,4,0,14,0.0927053113549377,54.662711668066336,3599
0,0,4,1,1,7,13,0.08788333641914632,54.62176978872205,3594
0,3,10,1,0,6,20,0.12272855749346882,54.159605654253554,3589
0,5,0,1,0,5,11,0.1241689733045811,53.98352371753997,3590
0,10,5,13,1,1,30,0.15848445628886315,53.35624330514628,3589
0,0,1,0,0,5,6,0.15156344269589103,53.17044902450089,3582
0,1,0,5,0,5,11,0.17644025308409056,53.27838192088799,3582
0,0,2,6,0,6,14,0.16925117720006824,53.472946374539454,3580
0,10,8,8,0,4,30,0.16686954874685336,52.68014010624186,3558
0,7,1,5,0,0,13,0.1919859848031986,52.370858541084374,3555
0,7,10,0,2,3,22,0.21894304260732889,51.84130353777321,3537
0,1,5,1,0,4,11,0.2272281135304966,51.91724719154054,3549
1,0,5,9,5,6,26,0.25341452863723246,52.171621078927956,3565
0,0,2,1,4,10,17,0.17449838458702271,52.27815287650978,3565
0,1,10,8,5,5,29,0.22966173740900123,51.83392426735484,3561
0,0,5,3,0,2,10,0.2552527120725514,51.78710604205689,3561
0,3,9,1,6,5,24,0.2595756270651594,51.65574870778946,3562
0,0,5,0,4,9,18,0.25618305706866806,51.40750955381123,3548
0,8,2,1,0,0,11,0.2460525704979986,51.63206524257985,3551
0,6,0,3,0,0,9,0.20051164439042343,52.07142015709606,3558
0,0,0,0,2,5,7,0.1908325438815479,52.238665935988564,3568
1,4,7,1,0,5,18,0.1620603263279871,52.435436913687425,3555
0,0,4,0,0,3,7,0.1659171667384809,51.988154844962544,3558
0,5,5,6,0,0,16,0.16401135356354582,51.97772207246897,3541
0,0,10,0,4,2,16,0.17282011543699113,51.97098349925073,3545
0,2,5,0,3,0,10,0.20514413983141494,52.29061859305512,3555
0,5,10,1,4,0,20,0.16984943811351771,52.4609736289737,3549
0,0,6,1,0,0,7,0.1912598043086423,52.589931633711295,3551
0,5,5,0,2,3,15,0.1847269340815599,52.67587416377098,3552
0,0,5,2,5,2,14,0.17052429530158295,52.81429993526657,3555
0,2,10,1,4,0,17,0.15059590358612754,52.95451718541299,3557
0,0,1,3,3,0,7,0.14120610348170967,53.39586075601815,3571
0,1,10,1,5,2,19,0.15282123999220476,53.20197189085435,3555
0,0,11,0,0,4,15,0.15929891720140796,52.98795898104072,3549
0,0,11,0,4,0,15,0.2021954988261692,52.58858127585426,3545
0,0,5,1,2,4,12,0.21076516593591027,52.43674414069385,3545
0,0,5,2,3,2,12,0.20685902263856676,52.30734893772425,3540
0,0,3,1,0,0,4,0.18774705891750662,52.35153850010211,3538
0,0,5,5,0,2,12,0.18100300534890695,52.43450668649027,3539
0,0,0,0,1,1,2,0.15926919307734802,52.46850099843497,3540
0,0,1,3,0,0,4,0.1375391266881413,52.796085502511716,3547
0,0,1,1,0,3,5,0.10467430591446006,53.13324334779226,3553
0,0,5,0,0,0,5,0.11483566384270327,53.232312426822126,3565
0,0,1,1,0,0,2,0.1031792155848208,53.65042849940328,3576
0,7,1,2,0,0,10,0.09405578871231997,53.613728728663126,3590
0,1,4,0,0,0,5,0.09349715392609786,53.97502980535912,3597
0,9,6,5,0,3,23,0.1466967136171731,53.93794073526671,3595
0,0,0,3,0,3,6,0.11646670301162881,54.024484377365276,3603
0,10,0,2,2,0,14,0.11692230313630787,54.28994019840462,3597
0,0,1,1,0,0,2,0.10289693326696886,54.35990959083334,3601
0,6,0,3,0,5,14,0.12606106706124265,54.008527715497976,3599
0,7,1,4,0,9,21,0.1450221056528936,53.552154250352324,3591
0,4,1,1,0,9,15,0.15229194652773484,53.348975610674124,3588
0,0,2,0,0,11,13,0.11625237877508052,53.447089803528264,3591
0,9,0,1,0,3,13,0.12388877247254254,53.60980556731334,3596
10,0,0,18,0,1,29,0.13460129488320774,53.27079632740875,3580
0,0,1,0,0,8,9,0.16918614965546874,53.08894421024164,3575
0,3,5,2,1,7,18,0.127219062071518,53.15597369336706,3576
0,1,5,1,0,0,7,0.1021981870208673,53.42532130486157,3577
0,4,10,2,0,0,16,0.1332300838424732,53.134881358906405,3571
0,0,4,0,0,0,4,0.13248423986532032,53.14842284743477,3578
1,3,2,16,3,0,25,0.1312048395562146,53.289798442470435,3572
0,9,5,17,0,0,31,0.1826551781865078,52.50726464449551,3554
0,0,5,4,1,0,10,0.18579576624141855,52.47897146974455,3556
0,10,5,7,0,1,23,0.2133416851860948,52.15497703369388,3543
0,0,6,17,0,5,28,0.2479123549751781,52.08756909635845,3545
0,1,4,6,0,3,14,0.2583271252357353,51.84514357996529,3550
0,0,5,1,0,2,8,0.1908402896923365,52.97911007197066,3563
0,1,2,3,0,0,6,0.17281330779764587,53.32572216953165,3569
0,0,8,0,0,1,9,0.17006691722894882,53.26572741593152,3585
0,7,13,0,1,0,21,0.15403569697464192,53.421485787040204,3591
0,1,6,0,2,0,9,0.14221120364861864,53.542896827491674,3587
2,0,11,7,3,6,29,0.14911938918815096,53.372470045781796,3573
0,0,4,4,0,1,9,0.10160563461509768,53.44029881459068,3573
0,0,1,5,3,0,9,0.08684567142924657,53.58358063796947,3564
0,0,6,3,3,0,12,0.08614317960853331,53.6666672054052,3567
0,1,0,1,0,1,3,0.11001821894715602,53.20740553315479,3561
0,6,5,1,0,4,16,0.1558607999146648,52.78967775880016,3557
0,1,1,1,0,6,9,0.1519192418301637,52.923261935593494,3567
0,0,5,0,0,9,14,0.15770634905686,52.78088195959087,3566
0,8,0,16,0,0,24,0.20469412226735617,52.520797042590225,3570
0,9,5,8,0,0,22,0.2136541949691955,52.294882800341945,3563
0,1,5,5,0,1,12,0.22879875735238475,51.98348031947848,3554
1,0,5,3,0,0,9,0.21135883633029964,52.44446584331446,3557
0,5,5,6,0,0,16,0.19033256071172058,52.61228185664519,3561
0,6,6,1,0,2,15,0.1923881966650484,52.41355142028173,3570
0,0,5,0,1,7,13,0.2125903107125621,52.26289353367635,3566
0,1,5,2,0,2,10,0.17830434864798422,52.80733996460822,3567
1,6,5,8,0,3,23,0.15483304140779391,52.91754218913862,3559
0,8,15,1,0,2,26,0.1787544409510783,52.728675431884966,3557
0,0,6,1,1,6,14,0.1744787783494051,52.89429025432472,3560
0,0,3,6,2,3,14,0.17724205175505775,53.07920264610641,3559
0,5,0,10,0,3,18,0.15300884205695786,52.909217120640754,3550
0,0,5,3,0,0,8,0.1310629561935169,53.05231098361109,3546
0,5,0,2,0,5,12,0.13997823390548614,52.94243776062418,3548
0,6,0,0,1,3,10,0.14549256971820923,52.788531909214925,3550
0,0,1,5,0,4,10,0.15646881367777737,52.793885045976964,3546
0,0,1,3,0,4,8,0.11799999617718147,53.18090401811788,3550
0,7,0,2,0,1,10,0.10687572090496972,53.307519745731426,3547
0,0,0,10,0,0,10,0.08940015634055692,53.108477860371934,3538
1,0,1,11,0,7,20,0.09790619076897628,53.08097229704701,3544
1,7,0,5,0,5,18,0.08901744585821686,53.020189449726104,3546
0,0,0,2,1,0,3,0.0785473001326761,53.234612699143725,3541
0,7,5,0,0,5,17,0.09463826894483122,53.38154981474516,3542
0,1,0,2,1,0,4,0.0868267749325746,53.42917584376252,3548
0,0,0,1,0,2,3,0.06760314393532424,53.94980170983765,3550
0,0,1,6,0,1,8,0.069839868154034,53.70156615653835,3542
0,0,0,1,0,0,1,0.07140556635612554,53.835049079920324,3543
1,2,5,1,0,0,9,0.07373478481081946,53.755739569159914,3543
0,0,0,2,1,0,3,0.049525861476610616,53.93102116903963,3542
0,1,1,1,1,0,4,0.04227936746967296,54.20524098030929,3546
0,0,5,0,0,0,5,0.028608935966888,54.05672546430598,3540
0,0,1,18,0,0,19,0.09334034019135717,53.96919806663874,3542
0,0,3,19,0,0,22,0.15373674722603067,53.47045932295958,3540
0,0,0,2,0,0,2,0.15306514230011195,53.425593819981934,3543
0,0,0,14,0,0,14,0.17642205960495,53.40038096165566,3541
0,0,0,2,0,0,2,0.1747342648756747,53.51123322482431,3554
0,0,1,1,0,0,2,0.09700079764001948,53.945540899475645,3569
0,0,1,2,0,0,3,0.07883257797334015,54.32558228000664,3579
0,0,0,2,0,0,2,0.042192454296808124,54.53184621650213,3586
1,0,13,1,0,0,15,0.0633537697865731,54.43958716669774,3589
0,0,0,0,0,0,0,0.04998284279181021,54.73198126317413,3605
0,0,0,2,3,0,5,0.018118834047169824,55.02440974731602,3605
0,0,15,0,0,0,15,0.040439779968976526,54.80254323759843,3598
0,0,12,3,1,0,16,0.03445122462971006,54.7645417315112,3587
0,0,1,0,3,0,4,0.031281268333416476,54.79051395033659,3590
0,0,0,0,3,0,3,0.028132118617401485,54.83742869607569,3590
0,0,0,0,0,0,0,0.014884173775941133,54.91210615946626,3591
0,0,0,1,0,0,1,0.0031674265916797396,54.96785966710771,3590
0,0,0,0,0,0,0,0.010328796856856153,54.96776747011118,3593
0,0,0,1,0,0,1,0.0031956012788833693,55.00658022729645,3593
0,0,0,2,0,0,2,0.00659269274033928,55.006580003151505,3596
0,0,0,1,0,0,1,0.008146853261738137,55.07327092467049,3599
0,0,0,0,0,0,0,0.010665609522262509,55.10449313548737,3602
0,0,0,0,0,0,0,0.013828082021432004,55.135786728891986,3607
0,0,0,2,0,0,2,0.020844899150517807,55.15828999466959,3610
0,0,3,1,0,0,4,0.02561532392327377,55.14636391534475,3609
0,0,0,1,0,0,1,0.01605028722926414,55.20023842516544,3610
0,0,0,2,0,0,2,0.014796131329815429,55.24026314377553,3611
0,0,1,0,0,0,1,0.02166065369586858,55.25583170998891,3614
0,0,1,1,0,0,2,0.019807004920923906,55.279387950829836,3616
0,0,0,2,0,0,2,0.013562041544969226,55.31681188125336,3618
0,0,0,3,0,0,3,0.019860699727539084,55.30274661587924,3617
0,0,0,1,0,0,1,0.008596879194034124,55.34094778407482,3617
0,0,0,2,0,0,2,0.012099916358456062,55.33402338291568,3617
0,0,1,0,0,0,1,0.02031752849639406,55.372194351482314,3622
0,0,0,1,0,0,1,0.009829308334647235,55.41921581028148,3623
0,0,0,1,0,0,1,0.013015495316462764,55.47476811271508,3628
0,0,0,1,0,2,3,0.013744186647776813,55.53201794469955,3630
0,0,0,0,0,0,0,0.013921143582268898,55.57916119937709,3634
0,0,0,1,0,0,1,0.0030579014979747175,55.64339321212761,3634
0,0,0,1,0,0,1,0.003890052572708664,55.636410567993174,3634
0,0,0,0,0,0,0,0.006655995977381131,55.64674506802147,3636
0,0,0,1,0,0,1,0.005548497793313988,55.662383288990206,3638
0,0,0,2,0,0,2,0.0,55.678021494568604,3635
0,0,0,0,0,0,0,0.007243449787368936,55.709298499081136,3642
0,0,0,1,0,0,1,0.011895909909689013,55.75621348561313,3644
0,0,3,1,0,1,5,0.01859825494889961,55.79856267614286,3650
0,0,0,2,0,0,2,0.012363214748180508,55.83029276163755,3650
1,0,0,1,0,1,3,0.027314164243822228,55.85385023063084,3655
0,0,1,1,0,0,2,0.02094236352662958,55.86950610367911,3655
0,0,0,0,1,0,1,0.019223042232670823,55.92161176646695,3659
0,0,0,0,0,0,0,0.010229840295140426,55.99274667981046,3661
0,0,1,0,0,0,1,0.017597463728036822,55.99805052298684,3663
0,0,1,3,0,0,4,0.01796570196182542,55.97870129674338,3663
0,0,0,1,0,0,1,0.01853583311121101,56.02402338637286,3667
0,0,2,5,0,0,7,0.022905349002944265,55.999643471502914,3666
0,0,0,3,0,2,5,0.025919416116185885,56.03127792810096,3670
0,0,0,2,0,0,2,0.014573664422303621,56.10973673564062,3668
0,0,0,0,0,0,0,0.013480498266693869,56.14788594903565,3671
0,0,0,2,0,0,2,0.006307037383278349,56.15668437002727,3669
0,0,0,1,0,0,1,0.01277842109037378,56.17921475172781,3673
0,0,0,1,0,2,3,0.02114689413384226,56.210963707994146,3678
0,0,0,4,0,0,4,0.012608636224489505,56.245389337305994,3678
0,0,0,1,0,0,1,0.006549362968061647,56.29730026442344,3679
0,0,1,0,0,0,1,0.009473966247277029,56.29778765364313,3679
0,0,1,0,0,0,1,0.016410418538759134,56.29778734293829,3682
0,0,0,0,1,0,1,0.02652420996526793,56.29778734293829,3687
0,0,1,0,0,0,1,0.022852852536715023,56.36928801380301,3689
1,0,1,0,0,0,2,0.019233532236325526,56.3678021963109,3689
0,0,0,3,0,0,3,0.02034499732802694,56.39209742425049,3692
0,0,1,1,1,0,3,0.019103957849181688,56.43901384274729,3693
0,0,0,1,0,0,1,0.009437048402511701,56.45465065654581,3690
1,0,0,1,0,0,2,0.01368084574644745,56.47028910155566,3693
0,0,0,0,0,0,0,0.003113118257661436,56.508584437592894,3692
0,0,0,2,0,0,2,0.01235011612699814,56.50156572615159,3697
0,0,0,0,1,0,1,0.011159591998048156,56.534430377156426,3699
0,0,1,3,0,0,4,0.00872060948723054,56.53284210088492,3695
0,0,0,0,1,1,2,0.011609457608352377,56.56447326519052,3699
0,0,0,2,0,0,2,0.010761131708374585,56.611484693334646,3701
0,0,1,0,0,0,1,0.004725670267659403,56.63401504863373,3702
0,0,1,2,0,0,3,0.015392855115448268,56.62712314504343,3705
0,0,0,0,0,0,0,0.027335698806576762,56.65854399520868,3710
0,0,0,0,0,0,0,0.02077802879685544,56.72831195416374,3712
0,0,1,0,0,0,1,0.016225800284749608,56.743716691177625,3714
0,0,0,2,0,0,2,0.011993155022842514,56.78547133412391,3716
0,0,0,4,0,0,4,0.006678227128588389,56.83224272605499,3714
0,0,2,1,0,0,3,0.014154900762365577,56.80618041186375,3715
0,0,0,1,0,0,1,0.012321394142351439,56.84804323878861,3718
0,0,0,1,0,0,1,0.015463248641007642,56.88174141818158,3721
0,0,0,2,0,0,2,0.012751691636728821,56.881751625580755,3719
0,0,0,1,0,0,1,0.014842965398215953,56.88471973102721,3720
1,0,3,1,0,0,5,0.019088110266407395,56.88011394251539,3722
0,0,0,1,0,0,1,0.018352314814186248,56.9167708978226,3724
0,0,0,0,0,0,0,0.01730783190441418,56.923662811215664,3724
0,0,0,1,1,0,2,0.019729543458223288,56.94886414518211,3726
0,0,0,1,0,0,1,0.015474630560295103,56.970578156269255,3727
0,0,0,6,0,0,6,0.008848297020965387,56.97967194497248,3724
0,0,0,0,0,0,0,0.009842706719030297,57.043104736452634,3731
0,0,0,0,0,0,0,0.011713215378076748,57.08043237012322,3735
0,0,0,2,1,0,3,0.01249257358741454,57.10472730697498,3735
0,0,0,0,0,3,3,0.0146696383289876,57.17488628951667,3742
0,0,0,1,0,0,1,0.00635613851106213,57.232404452261875,3741
0,0,1,3,0,0,4,0.008662477501450662,57.23779064307401,3741
0,0,0,1,0,0,1,0.01678317107158113,57.26208558511843,3746
0,0,0,2,0,0,2,0.015952400803142433,57.277808304900326,3747
0,0,0,1,0,0,1,0.008902669125431173,57.43253315442212,3750
