throughput_KLONGTEI,throughput_KASEMRAT,throughput_NARANONG,throughput_SUNLAKAKHON,throughput_RAMA4, throughput_ATTHAKAVI_RAMA4,throughput,mean_speed,jamlength_percent,Backlog
0,0,0,0,0,0,0,8.696046663373663,0.0,12
0,0,0,0,0,0,0,9.83233657687533,0.0,31
0,0,0,0,0,0,0,9.235689762412827,0.031003500084890494,57
0,0,0,0,0,0,0,9.49017145600712,0.07687652865871443,83
0,0,3,0,1,2,6,9.41207302706092,0.13822831960867632,105
1,1,1,0,0,0,3,9.288824867309263,0.1708394174798393,134
2,3,1,0,0,0,6,9.442318922586637,0.24183772026676917,160
0,7,1,10,2,0,20,10.222098343136851,0.17807236215367722,179
3,5,3,4,0,0,15,9.702404958718914,0.22932179650995593,211
6,7,1,3,2,1,20,9.259015173525404,0.3558408961276686,246
5,4,1,3,6,3,22,8.934136386451089,0.4759142632873837,271
3,2,1,6,3,4,19,8.554194377778726,0.7105605688737039,303
2,14,2,3,3,1,25,7.97373626316741,0.9472875997614565,322
16,2,2,5,2,4,31,7.688038199635797,1.2006298955552794,343
7,4,0,4,8,7,30,7.138564878158061,1.549533338216979,368
8,6,0,0,7,5,26,6.343357602990944,1.9546022769514415,375
7,12,7,1,8,5,40,6.272028905533651,2.150189553734195,388
3,4,1,1,6,3,18,5.851668644215597,2.571129143766084,424
10,5,1,1,3,7,27,5.312196495300534,2.9613783697783878,444
7,8,1,17,10,4,47,5.332810016699313,2.9541575719814825,458
8,6,3,4,7,2,30,5.265814706492349,3.2452747296427806,493
7,7,13,3,4,0,34,5.169869222079853,3.4338731826345956,522
9,4,11,1,9,5,39,5.0802221427870515,3.7715695859796714,540
12,7,10,3,9,3,44,4.715203197396067,4.177783286827153,556
8,7,10,13,6,8,52,4.736700512656467,4.344068144363954,568
6,8,12,13,3,5,47,5.01309047552636,4.063318815837796,585
4,10,5,12,4,5,40,5.082360864186347,4.435075956587728,626
6,6,7,10,22,4,55,5.2474553691166745,4.156003815710005,626
15,4,9,7,28,5,68,5.579147016745366,3.9230407735981325,639
11,20,8,3,22,7,71,5.641244068812082,3.7898907878443437,663
9,11,8,2,12,5,47,5.282926052075351,4.235303732402115,689
11,5,11,2,19,11,59,5.119686784020183,4.548108082015228,703
11,10,12,4,11,12,60,4.96834341580631,4.961656260396715,725
8,7,10,2,8,14,49,4.467421114165052,5.506865817141855,740
11,6,11,4,6,15,53,4.177451916616714,6.175901462350932,751
30,7,7,3,10,15,72,4.1020212256583894,6.378155696043325,755
14,7,15,3,11,15,65,3.7287938280412067,6.559165520787226,741
10,11,4,16,6,8,55,3.75290596133514,6.886114974573461,753
7,8,1,20,1,5,42,3.744797153118102,7.166150421690816,796
3,6,0,9,12,6,36,3.6620400122728993,7.329750852156011,806
7,7,12,1,4,7,38,3.5703015539356593,7.389596107624031,817
3,9,9,14,4,3,42,3.333238363526353,7.703952878174994,849
20,7,4,12,6,5,54,3.125853510604808,8.438131850114841,870
9,0,3,6,12,4,34,2.805510376115746,9.185116250320705,887
5,0,10,0,4,6,25,2.6470915082897766,9.751091252548488,905
5,3,10,5,0,6,29,2.521703087557662,10.143912266485543,932
3,26,11,5,2,7,54,2.821943918025493,9.341795867168164,940
1,24,10,0,7,3,45,3.065995424473943,8.837607313930452,945
1,22,10,2,12,5,52,3.2203060719138077,9.000587649915074,948
0,22,12,17,8,13,72,3.212226053805992,8.894376911210921,937
1,17,11,20,8,11,68,3.170588400210782,8.720445225938626,924
2,13,11,22,7,7,62,3.236631247144066,8.946266907108551,927
3,17,10,13,3,9,55,3.126923534763884,8.979465324964744,939
1,20,11,5,6,9,52,2.985634043596321,8.941310694907122,942
1,20,10,5,4,9,49,2.977732150642316,9.438137664804449,971
12,19,13,7,19,9,79,3.15756059411725,8.885163053047886,965
9,18,15,4,27,7,80,3.6007891421333817,8.394585230347936,977
16,18,11,4,22,10,81,3.6308368028354545,8.355783823400474,998
17,15,10,15,14,8,79,3.7614292546702903,8.275160913815313,1029
20,21,4,13,13,8,79,3.826154800383759,8.470354736964904,1031
16,16,4,12,14,3,65,3.6186302107478188,8.682115323778751,1050
13,19,3,10,10,3,58,3.4678054591562075,9.278702633316522,1069
10,21,2,14,10,3,60,3.244078523836795,10.186534981543497,1091
10,13,10,11,6,3,53,3.162066111938533,10.460827712719471,1115
11,4,9,11,5,3,43,3.0147426151085552,11.141630634923093,1135
13,13,5,18,6,5,60,2.784427990093325,11.472644106196343,1160
9,12,3,19,7,4,54,2.560119202586993,12.481210219807885,1182
10,9,1,16,13,3,52,2.39511845555577,12.995282721947374,1205
10,3,9,1,10,5,38,2.3962592537643475,13.04930761142643,1228
7,3,5,2,12,0,29,2.1601612258467404,13.676976284214415,1240
25,3,5,13,12,4,62,2.0675978404836153,13.811381470458135,1236
15,1,5,10,16,3,50,2.063299263331563,14.038879921437067,1244
21,1,6,4,20,4,56,1.8974767612291195,14.24818268640713,1231
16,1,5,1,17,2,42,1.8066407729124239,14.766713146546387,1243
12,1,5,18,18,7,61,2.017903404975425,14.357320909679967,1250
13,2,5,21,21,6,68,2.0243785374984684,14.234306692942763,1235
18,1,9,20,7,3,58,1.8272475466913964,14.351093967473055,1213
6,1,6,5,6,7,31,1.7052342959747246,14.686409473038625,1223
4,17,5,1,7,1,35,1.7123393055605938,14.895298159642172,1227
3,24,5,12,5,6,55,1.9819472599799568,14.353899000090522,1231
6,20,6,8,6,9,55,2.1366552276295563,14.083638258662761,1243
3,14,9,13,10,3,52,2.321695128176014,14.135895290737583,1255
3,17,11,13,5,15,64,2.575897366636925,12.854821702160088,1251
2,22,13,3,5,3,48,2.4920002189572825,13.230695159497918,1270
10,20,14,5,5,4,58,2.500309805889558,13.825143651798912,1305
5,14,12,1,4,6,42,2.4844180727685803,13.783181309771747,1319
6,4,13,4,4,4,35,2.257187800965486,14.926122896012798,1347
9,1,9,5,6,1,31,2.0977735602462064,15.313079425284426,1363
7,2,8,3,6,4,30,1.985190138755219,15.809814590660194,1378
2,1,6,4,5,9,27,2.010342126150155,16.178730716231843,1407
6,0,12,5,8,6,37,2.0327851214856993,16.231867343471787,1424
8,3,10,1,10,6,38,1.9014889832594586,16.85825477411135,1452
9,3,12,11,6,8,49,1.8877370016236712,16.82307758112779,1461
2,1,11,12,6,3,35,1.9562682763891899,17.329294134768382,1483
2,2,7,4,12,2,29,1.8448318794487077,18.142013724643945,1514
2,1,7,1,14,5,30,1.7160917744176916,18.69508840242802,1527
1,4,7,1,16,2,31,1.5090515486576737,18.99291633935688,1526
5,0,7,1,11,16,40,1.4449374677656035,18.818803571412737,1532
2,2,14,1,8,3,30,1.399891364999535,19.49701597429328,1558
1,19,11,4,7,13,55,1.4450142701740998,18.74067090806641,1566
1,21,11,0,5,5,43,1.6457685271427436,18.595345295118598,1579
8,21,11,0,22,7,69,1.8168396160666525,18.397429403119325,1585
4,22,10,0,24,11,71,1.783168622941362,18.169085488357414,1589
13,21,5,0,15,4,58,1.865808313247312,18.298043622877458,1617
15,22,4,0,5,12,58,1.8096041031606056,18.11776805310369,1627
12,21,5,0,6,8,52,1.7573980062791092,18.926003023230194,1664
11,23,5,0,7,16,62,1.5220109662605663,19.649324934034354,1674
9,5,6,0,10,7,37,1.3398604572779287,20.930322888089943,1712
10,0,5,0,4,15,34,1.1862850637213598,21.478861459523504,1729
10,0,15,0,0,4,29,1.1670584134007191,21.91205614602225,1750
13,1,15,0,6,13,48,1.1505428755508984,21.920472494259705,1768
2,1,15,0,11,3,32,1.1704925463119482,22.93018484509358,1800
14,0,7,16,8,17,62,1.286701425148097,22.935612168438688,1833
15,0,4,15,9,6,49,1.352680038580135,23.341818997373526,1843
13,0,11,16,23,10,73,1.5257307466249266,22.28839985712842,1837
16,16,10,14,26,0,82,1.5957415332958456,21.432340536911507,1820
4,23,5,15,20,0,67,1.5063434429789027,21.669262284372184,1808
13,23,6,13,8,1,64,1.308901674736658,22.536529324339494,1803
10,18,5,12,4,15,64,1.3160550041192485,22.356458098737143,1791
6,0,5,13,0,4,28,1.2116977527305204,22.68693655775418,1795
6,1,5,13,2,14,41,1.1572501123867678,22.718048700795457,1796
3,0,5,11,1,4,24,1.079336041216356,23.36126332697033,1798
25,2,5,9,9,15,65,1.1705538078725084,22.688604171417197,1791
27,3,6,1,3,4,44,1.1481403648013104,23.234549467093366,1789
7,2,5,1,5,14,34,1.1374023584608879,23.23910200162142,1803
0,4,4,3,9,2,22,1.1332024593805519,23.704900654435317,1831
3,2,6,0,18,9,38,1.1306640720360182,24.119299069695526,1844
7,13,0,0,17,3,40,1.193028658645235,24.168245456217115,1867
14,18,6,0,7,4,49,1.185888988705386,23.91259276234659,1868
15,21,5,9,10,1,61,1.172298915044088,23.9658070559269,1852
12,24,6,1,2,13,58,1.158586326332757,22.907028656354967,1844
13,2,5,0,2,5,27,1.0413995834818446,23.500792501417585,1860
5,0,4,0,2,17,28,1.159319870779188,23.550919972144943,1880
0,1,5,0,2,4,12,0.9585917928261041,24.918939118691853,1919
3,3,6,0,2,15,29,1.0095018005771896,24.958594152665174,1938
3,0,5,0,6,3,17,0.9451138096027498,25.418420671307796,1944
3,0,15,0,7,6,31,0.8969890466166033,25.22354839862842,1933
7,15,15,0,18,1,56,1.0082913821370145,25.23168830537846,1937
9,14,2,0,18,0,43,1.0924384342651374,25.00887773562836,1945
3,9,0,0,8,4,24,1.0465528224867455,25.64381661519585,1981
12,12,10,0,2,11,47,1.0535644327350453,25.314251404907782,1987
13,0,5,0,3,5,26,1.0384319073025332,25.835302478288245,2012
6,3,6,0,1,13,29,0.9313033389269076,26.289886551889143,2028
6,1,1,0,0,5,13,0.9047604164285028,27.20574341788538,2058
5,3,2,0,1,6,17,0.8131916845466014,28.137297179157727,2076
5,2,0,0,4,3,14,0.7201933602620468,28.999044918829107,2090
3,15,0,9,2,1,30,0.7369252247600365,28.97891876104745,2101
2,8,1,0,4,0,15,0.652965986090982,29.39462785368238,2110
2,11,0,0,5,5,23,0.5411634198567717,29.9672254882544,2111
3,11,6,0,13,0,33,0.5318605599615343,30.199099579048646,2116
1,2,5,0,9,10,27,0.5892295003122235,30.030932066271582,2132
0,2,5,0,9,2,18,0.5219368264872203,30.315083977741242,2143
0,1,8,0,10,13,32,0.5749264844895154,29.99320553980764,2143
0,1,8,0,0,2,11,0.561082144359424,30.30040194126029,2160
0,12,5,0,1,6,24,0.5798773057171757,29.94713783579593,2162
0,3,5,0,5,0,13,0.5599029001068326,30.70937007794528,2172
0,2,1,0,11,5,19,0.5663414979332073,31.060035753952196,2188
0,2,5,0,15,0,22,0.5688552560478842,30.990798578128274,2189
0,2,7,0,9,1,19,0.5517431331123467,31.078064834480386,2200
0,0,9,0,7,0,16,0.541609110925492,31.233081311961456,2217
6,1,11,0,18,2,38,0.6310335841405048,30.930677935094195,2224
4,1,4,0,13,0,22,0.5623783765234396,31.345882273260678,2249
10,3,0,0,10,2,25,0.5200105910817405,32.08039942717403,2276
9,1,1,0,0,0,11,0.5315972701172856,32.1866870322133,2299
9,1,0,0,0,2,12,0.5104756468363438,32.271592714858755,2318
10,3,9,0,6,0,28,0.5787206668534932,32.32892955132785,2332
7,0,6,0,0,2,15,0.6013450565629067,32.03228882048526,2349
5,1,3,0,2,0,11,0.5621445789278697,32.375822842649384,2367
8,2,1,0,0,0,11,0.5559601153289256,33.20300092108724,2401
2,2,6,0,0,0,10,0.5622442420082574,32.94911692909091,2412
2,2,10,0,0,0,14,0.5923328127387918,33.47625404762119,2435
2,2,5,0,0,0,9,0.6121118406704185,33.959786906200456,2456
0,1,1,0,0,0,2,0.5364013937811438,34.35291827265109,2473
2,2,7,0,0,0,11,0.5077381801309631,35.011548425387495,2491
6,2,5,0,0,0,13,0.42877039929169125,35.451116178762106,2498
7,2,3,0,0,0,12,0.30443373342238605,36.0929370360555,2508
0,1,0,0,1,0,2,0.2792994156422191,36.437796876389726,2517
2,0,0,0,4,0,6,0.2517634062793921,36.62091012238597,2536
0,0,6,0,0,0,6,0.2553526044862396,37.199821269433976,2556
0,0,10,0,0,0,10,0.3079502106098281,37.354142784703676,2572
0,0,11,0,0,0,11,0.38895962255509126,37.070833250116095,2593
0,0,10,0,0,0,10,0.35976093759101774,37.77273510476571,2615
0,0,2,0,0,0,2,0.3333054030082079,38.23855655325878,2638
0,0,0,0,0,0,0,0.3635524764431994,38.0520239708587,2656
0,0,0,0,0,0,0,0.30606204300321377,38.37575331039125,2671
0,0,1,0,1,0,2,0.2620974431133959,38.97647716347952,2680
0,0,0,0,0,0,0,0.21731713613658296,39.46575090055405,2704
0,0,0,0,0,0,0,0.2605312839128865,39.583261505698914,2717
0,0,0,0,0,0,0,0.22090487364263306,40.187789871882785,2742
0,0,0,0,0,0,0,0.2205720637228383,40.51718328917639,2754
0,0,11,0,0,0,11,0.2362696833913928,40.95254104343203,2761
0,0,5,0,0,0,5,0.2250020353940183,41.06947974155576,2787
0,0,2,0,0,0,2,0.25763837060063544,41.42360930276564,2810
0,0,0,0,0,0,0,0.242558292780266,41.942317372498714,2831
0,0,4,0,0,0,4,0.20548507244617162,42.2065084930544,2855
1,0,1,0,0,0,2,0.18573864559218292,42.552390145670174,2864
0,0,9,0,0,0,9,0.21098795194943887,42.6975750073377,2877
0,0,1,0,0,0,1,0.1708677353816836,42.953017729057805,2886
0,0,0,0,0,0,0,0.1743694658309529,43.44138394394985,2900
0,0,1,0,0,0,1,0.18217282928795653,43.23907770889182,2914
0,0,0,0,0,0,0,0.14395333062492796,43.640465189202956,2919
0,0,5,0,0,0,5,0.15605011863788412,43.44253215778408,2927
0,0,5,0,0,0,5,0.18278021712991893,43.17348129015739,2929
0,0,5,0,0,0,5,0.14728632801632688,43.59942661189415,2935
0,0,5,0,0,0,5,0.12761652119108657,43.972555681977354,2949
0,0,4,0,7,0,11,0.132886982426268,43.97003111060786,2951
0,0,0,0,0,0,0,0.15933674732456096,43.88321057003499,2962
0,0,0,0,0,0,0,0.15994858662034422,44.265564442820086,2974
0,0,0,0,0,0,0,0.1673737358902136,44.315616233216524,2986
0,0,0,0,0,0,0,0.1665898628920901,44.53536967363525,2999
0,0,0,0,0,0,0,0.1634477518074789,44.67148344787028,3014
0,0,0,0,0,0,0,0.1413836152991053,45.08915814540857,3025
0,0,0,0,0,0,0,0.1395053036139618,45.4128277645893,3037
0,0,2,0,0,0,2,0.10829403533080036,45.6506039853767,3040
0,0,0,0,0,0,0,0.09939416211336938,45.78235576007998,3047
0,0,0,0,0,0,0,0.1128132948853904,45.88682246101263,3053
0,0,0,0,0,0,0,0.08114074917867135,46.12513008649495,3058
0,0,5,0,0,0,5,0.10573865979411542,46.06208304275447,3063
0,0,2,0,0,0,2,0.09276201889089718,46.26030124213281,3067
0,0,1,0,0,0,1,0.11124594345893887,46.302135700474686,3074
0,0,0,0,0,0,0,0.0841987169808233,46.464067629378626,3074
0,0,1,0,0,0,1,0.10081616493713934,46.47797779583884,3082
0,0,5,0,16,0,21,0.1430620817794787,45.900410769315975,3079
0,0,5,0,0,0,5,0.13236406131701156,46.104770709547516,3089
16,0,5,0,0,0,21,0.1410566107191664,45.895980776164116,3077
0,0,5,0,0,0,5,0.13402970459047706,46.23950382835704,3090
0,0,1,0,0,0,1,0.1209364882225403,46.33342565071796,3098
0,0,1,0,0,0,1,0.13020830876813472,46.715646405680545,3109
0,0,0,0,0,0,0,0.11416137517691229,46.55215598033775,3115
0,0,0,0,0,0,0,0.12374796908395197,46.69949829005611,3126
0,0,0,0,0,0,0,0.13055531314524163,46.709038997097885,3134
0,0,0,0,0,0,0,0.08647748046807587,47.354916890242535,3142
0,0,0,0,0,0,0,0.07883300534624622,47.36071430739183,3157
0,0,0,0,0,0,0,0.09834687055232282,47.349423948788505,3165
0,0,1,0,0,0,1,0.07927818779212538,47.930548710564956,3176
0,0,0,0,0,0,0,0.0814030221608153,47.979388550958774,3192
0,0,0,0,0,0,0,0.08056995535623565,48.30324222619783,3201
0,0,1,0,0,0,1,0.06717866297189141,48.64318441068766,3209
0,0,5,0,0,0,5,0.0904676646607557,48.48011435052099,3218
0,0,5,0,7,0,12,0.10899947927233274,48.5417804311819,3221
7,0,2,0,1,0,10,0.0767334011854081,48.74469335711197,3216
1,0,0,0,0,0,1,0.0740867660159606,48.7946518287066,3223
0,0,0,0,0,0,0,0.04511191303497954,49.16182740915032,3231
0,0,5,0,0,0,5,0.0551933373426721,48.757088178043794,3232
0,0,5,0,0,0,5,0.06913750043851011,48.644548392956644,3230
0,0,5,0,0,0,5,0.07914810467143228,48.51164692762062,3228
0,0,5,0,0,0,5,0.07660077412324896,48.60318682077317,3232
0,0,2,0,0,0,2,0.08399066326310708,48.64090533519376,3237
0,0,1,0,0,0,1,0.08310617746372619,48.71239912223267,3247
0,0,0,0,0,0,0,0.08533185064374192,48.839762998265755,3252
0,0,0,0,0,0,0,0.09205837857245841,48.76643469642354,3253
0,0,0,0,0,0,0,0.08149401832350284,48.920379652597795,3259
0,0,0,0,0,0,0,0.0831463530348974,48.94778654674197,3260
0,0,0,0,0,0,0,0.08224471712068519,49.213158254589125,3271
0,0,0,0,0,0,0,0.055951008192482575,49.56486608478508,3279
1,0,0,0,0,0,1,0.055174519779539105,50.037810108441064,3290
0,0,0,0,0,0,0,0.06103762855652457,50.141203129485916,3297
0,0,1,0,0,0,1,0.06385438756079789,50.20407697027964,3303
0,0,0,1,0,0,1,0.044505811807801485,50.274054598693965,3303
0,0,5,0,0,0,5,0.04928177537302395,50.264712740128,3305
0,0,3,0,0,0,3,0.04617801772375862,50.354239836817875,3308
0,0,0,0,0,0,0,0.04847846649186903,50.432527944679016,3312
0,0,0,0,0,0,0,0.040135628810003106,50.48479022390784,3315
0,0,0,0,0,0,0,0.062313993811075656,50.484491377450766,3321
0,0,5,0,9,0,14,0.09187012116290903,50.31287506799349,3322
0,0,6,0,0,0,6,0.08274856692881356,50.256622029604046,3320
9,0,5,0,0,0,14,0.09495829017101083,50.179033360949816,3317
0,0,5,0,0,0,5,0.09393432115318527,50.149865469856294,3316
0,0,5,0,0,0,5,0.09132718963354389,50.170793659234725,3320
0,0,1,0,0,0,1,0.09093319356636562,50.19109451184236,3321
0,0,1,0,0,0,1,0.08751708860293103,50.22389197643014,3324
0,0,0,0,0,0,0,0.0767921186828663,50.22337711106575,3324
0,0,0,0,0,0,0,0.07190991325627956,50.31451324016461,3327
0,0,0,0,0,0,0,0.0706014764860662,50.175448194171786,3332
0,0,0,0,0,0,0,0.04858019679939776,50.458047033827015,3339
0,0,0,0,0,0,0,0.030979150912068158,50.74981199736022,3346
0,0,0,0,0,0,0,0.03896412721558152,50.84641161226182,3352
0,0,0,0,0,0,0,0.04234405951008786,50.85530029898466,3354
0,0,0,0,0,0,0,0.04474305358427984,50.89648468035235,3358
1,0,0,0,0,0,1,0.05061781777439123,50.927324157879944,3362
0,0,5,0,0,0,5,0.0415211570829562,50.864921463598364,3356
0,0,2,0,4,0,6,0.043835173171662564,50.93073528289734,3358
5,0,1,0,2,0,8,0.02905867006517709,50.95671938265236,3358
1,0,0,0,0,0,1,0.0356832701400005,50.98802479656364,3360
0,0,1,0,1,0,2,0.04937822423936819,50.99168660129282,3366
1,0,6,0,0,0,7,0.04732654012895156,50.94730651919356,3367
0,0,5,0,0,0,5,0.04358480780202423,50.835635052913545,3364
0,0,6,0,0,0,6,0.05928318970577579,50.82843938332581,3363
0,0,5,0,0,0,5,0.0624280783430228,50.72160961406552,3363
1,0,3,0,0,0,4,0.08731496348194305,50.68222579614996,3370
0,0,0,0,0,0,0,0.08409535816499798,50.754437345946265,3373
0,0,0,0,0,0,0,0.08066045369172449,50.73404198800679,3378
0,0,0,0,0,0,0,0.07789079230083677,50.92719938231023,3386
0,0,0,0,0,0,0,0.04758183651646752,51.20139593939614,3392
0,0,1,0,0,0,1,0.0413681926209337,51.36952748225928,3394
1,0,0,0,0,0,1,0.047713413318939815,51.80394104488045,3402
0,0,0,0,0,0,0,0.04202495794134772,51.94502070928924,3410
0,0,0,0,0,0,0,0.050979668417796414,52.054674452783175,3417
0,0,0,0,0,0,0,0.036510457208759554,52.112078503557974,3418
0,0,0,0,0,0,0,0.0387700289263524,52.169483322066995,3423
0,0,0,0,0,0,0,0.041372697832626815,52.21662488069308,3426
0,0,5,0,0,0,5,0.03508801901350109,52.23520319762579,3428
0,0,3,0,0,0,3,0.0336342512782644,52.28219290129569,3429
0,0,1,0,0,0,1,0.029811587258366634,52.37091371805417,3434
0,0,1,0,0,0,1,0.02590170371263682,52.45638060594491,3440
0,0,1,0,0,0,1,0.023458788913540907,52.5505372060109,3445
0,0,5,0,7,0,12,0.05992050197545445,52.370124130170105,3442
0,0,6,0,0,0,6,0.059186909444586565,52.30294317916936,3443
7,0,5,0,0,0,12,0.07706772418445737,52.15165667813219,3439
0,0,5,0,1,0,6,0.060472098674846646,52.096883440745785,3434
0,0,4,0,0,0,4,0.0698219924400818,52.143334216089954,3439
0,0,0,0,0,0,0,0.06150444061502479,51.944037785071124,3447
0,0,0,0,0,0,0,0.03173571898360613,52.22519104140914,3448
0,0,0,0,0,0,0,0.018463403301054553,53.05573717835347,3451
0,0,0,0,0,0,0,0.01713838995810509,53.11294333644672,3454
0,0,0,0,0,0,0,0.028177829590096067,53.11296349305441,3459
0,0,1,0,0,0,1,0.027438088014769844,53.144525035812066,3460
0,0,0,0,0,0,0,0.03544838912232335,53.206903323922354,3466
0,0,0,0,0,0,0,0.03218073121606067,53.23820406753851,3469
0,0,1,0,0,0,1,0.03651088097170972,53.26947672108169,3474
0,0,0,0,0,0,0,0.02414015367210938,53.368051655905106,3477
0,0,0,0,0,0,0,0.012009729576133664,53.47245733860223,3477
1,0,5,0,0,0,6,0.023048862518885504,53.40487307233544,3477
1,0,1,0,2,0,4,0.027652687139952073,53.431132199915346,3478
2,0,0,0,0,0,2,0.01827898680722788,53.4467706416292,3476
0,0,0,0,0,0,0,0.019269924522995644,53.472742480996,3480
1,0,0,0,0,0,1,0.022166457632749943,53.53532182647838,3484
0,0,4,0,0,0,4,0.05073472017327701,53.36444577941149,3486
0,0,8,0,0,0,8,0.047581950527791246,53.276354847627104,3485
0,0,5,0,0,0,5,0.06869535395677251,53.26557208230683,3488
0,0,6,0,0,0,6,0.06765789523368794,52.63673445239164,3493
0,0,3,0,0,0,3,0.039314902469874145,52.839029976302314,3492
0,0,0,0,0,0,0,0.029262519192636654,53.03881612624729,3498
1,0,1,0,0,0,2,0.03455193636012879,53.06425559083098,3505
0,0,0,0,0,0,0,0.04281894577325245,53.17724451042628,3508
0,0,1,0,0,0,1,0.046081258735930504,53.17995461131171,3513
0,0,0,0,0,0,0,0.035057850467896556,53.23811214665485,3512
0,0,0,0,0,0,0,0.04164961484984664,53.30513298818598,3517
0,0,0,0,0,0,0,0.03680466086997633,53.37645488322362,3524
0,0,0,0,0,0,0,0.04157892892325369,53.43439169514104,3528
0,0,0,0,0,0,0,0.02978060001346111,53.53150843922759,3532
0,0,0,0,0,0,0,0.03540238525517214,53.60214587790739,3537
0,0,1,0,0,0,1,0.03997976631281566,53.63795352043182,3540
0,0,5,0,0,0,5,0.03588315748481905,53.60953524137251,3538
0,0,0,0,0,0,0,0.029218388814134626,53.646402236881094,3538
0,0,2,0,0,0,2,0.020158138991449442,53.71906784490037,3538
0,0,2,0,0,0,2,0.022558008809380775,53.67745675774047,3539
0,0,0,0,0,0,0,0.0221656842611838,53.73480117528668,3541
0,0,5,0,4,0,9,0.04396804856020359,53.58546944181136,3541
0,0,5,0,0,0,5,0.03261695245397337,53.66718376668038,3544
5,0,4,0,0,0,9,0.028260389517556602,53.71460825995859,3540
0,0,0,0,0,0,0,0.02591519441309954,53.743785796098685,3545
0,0,5,0,0,0,5,0.04930612272659067,53.79394949073828,3552
1,0,0,0,0,0,1,0.04279952370430463,53.86380054381657,3555
0,0,0,0,0,0,0,0.03274040509557298,53.97401390985052,3557
0,0,0,0,0,0,0,0.031883476553963355,53.98685973128725,3560
0,0,0,0,0,0,0,0.02194360510126743,54.09634530613078,3560
0,0,0,1,0,0,1,0.027363802484381132,54.08705029485818,3565
0,0,0,0,0,0,0,0.012859796246110975,54.15933028922646,3564
0,0,0,0,0,0,0,0.03234101662853263,54.2065157270809,3570
0,0,0,0,0,0,0,0.027143460967540205,54.22754013134162,3576
0,0,0,0,0,0,0,0.023445586281676273,54.373963688336715,3580
0,0,0,0,0,0,0,0.030392078846834255,54.347496867430216,3584
0,0,0,0,0,0,0,0.024997959287455088,54.42754900821787,3585
0,0,5,0,0,0,5,0.027636513818001147,54.32865810547493,3583
0,0,4,0,2,0,6,0.025605289364179544,54.39661262065512,3582
2,0,1,0,0,0,3,0.03356481622819456,54.41256321039206,3584
0,0,1,0,1,0,2,0.01828713827484947,54.487873437820305,3586
1,0,1,0,1,0,3,0.019745094164290173,54.532588237648326,3588
1,0,0,0,0,0,1,0.012066165269256267,54.579312270629295,3591
0,0,0,0,0,0,0,0.011307023447214248,54.636453402108216,3594
0,0,0,0,0,0,0,0.01749630387475707,54.6366277335092,3596
0,0,2,0,0,0,2,0.011097513021366133,54.71635446879269,3598
0,0,0,0,0,0,0,0.0204114784178504,54.73059027136689,3604
0,0,0,0,0,0,0,0.003263771107589761,54.84443041618186,3604
1,0,0,0,0,0,1,0.008644001305823015,54.87406494493859,3610
0,0,0,0,0,0,0,0.01417573736021901,54.89054356955146,3613
0,0,0,0,0,0,0,0.014569695322472664,55.02036836669918,3617
0,0,0,0,0,0,0,0.01420464109916738,54.97335599787247,3617
0,0,0,0,0,0,0,0.015618605707718832,55.06721665371709,3622
0,0,0,0,0,0,0,0.01576430075034056,55.09985264808991,3623
0,0,1,0,0,0,1,0.020068021932040072,55.1303160321794,3629
0,0,1,0,0,0,1,0.010128805157621075,55.23432918473228,3631
0,0,0,0,0,0,0,0.01871699877121974,55.2392722425767,3636
0,0,1,0,0,0,1,0.01446406046667933,55.31873645725967,3638
0,0,3,0,0,0,3,0.01839082935826686,55.32836111829248,3642
0,0,0,0,0,0,0,0.017606297455373756,55.45649462154007,3647
0,0,0,0,0,0,0,0.01650277589067735,55.45359470442387,3649
0,0,2,0,0,0,2,0.004440269182597742,55.510884589672905,3648
0,0,0,0,0,0,0,0.009279712452031045,55.5473663834017,3652
0,0,0,0,3,0,3,0.01329353846699083,55.56616565713376,3652
0,0,0,0,0,0,0,0.005244449079413629,55.60117152396283,3654
3,0,0,0,0,0,3,0.014690544043122403,55.56616633179235,3655
0,0,0,0,0,0,0,0.009555900025017064,55.63905750257176,3658
0,0,3,0,0,0,3,0.01770863306031767,55.66535460346799,3660
0,0,0,0,0,0,0,0.013341430746323345,55.724385824732416,3665
0,0,0,0,0,0,0,0.017102432025771275,55.71194192100169,3670
0,0,0,0,0,0,0,0.010249097850618378,55.8267451571724,3671
0,0,2,0,0,0,2,0.019467111242820155,55.826717154975064,3676
0,0,0,0,0,0,0,0.0051498391320791495,55.92161386873445,3675
0,0,0,0,0,0,0,0.01003364948046462,55.94825843137846,3680
0,0,0,0,0,0,0,0.015216795275244723,56.02535335048701,3686
0,0,1,0,0,0,1,0.007071252786357405,56.079694116471074,3688
0,0,0,0,0,0,0,0.011252606464807217,56.14516246273587,3693
0,0,1,0,0,0,1,0.006143661959365131,56.18394757024745,3694
0,0,0,0,0,0,0,0.0031889507428174146,56.18391165117288,3694
0,0,5,0,0,0,5,0.009663611043513836,56.09538565240155,3691
0,0,2,0,5,0,7,0.022487718732332726,56.0687722009147,3690
5,0,0,0,0,0,5,0.0,56.100048694116396,3684
0,0,0,0,0,0,0,0.0032289877263740655,56.100048694116396,3685
0,0,0,0,0,0,0,0.00024147557124678078,56.110383194144696,3686
0,0,0,0,0,0,0,0.005731447111799555,56.110383194144696,3687
0,0,0,0,0,0,0,0.007851316896797543,56.110383194144696,3688
0,0,0,0,0,0,0,0.0097413299906011,56.110383194144696,3688
0,0,1,0,0,0,1,0.006221628129827821,56.110383194144696,3687
0,0,1,0,0,0,1,0.007162822831630173,56.11568690661952,3688
0,0,0,0,0,0,0,0.013425913520925373,56.147014336066206,3691
0,0,1,0,0,0,1,0.012274869276336354,56.16260597361844,3692
0,0,0,0,0,0,0,0.008366000989172435,56.18868002848588,3693
0,0,0,0,0,0,0,0.00948770345243238,56.19890888330312,3695
0,0,2,0,0,0,2,0.01642603769487852,56.19890888330312,3697
0,0,0,0,0,0,0,0.01267927245132647,56.245877445431,3698
0,0,0,0,0,0,0,0.009691113014700442,56.26146200724699,3698
0,0,1,0,0,0,1,0.011414307576503574,56.27179650727529,3700
0,0,0,0,0,0,0,0.010457251449505038,56.27179650727529,3700
0,0,0,0,0,0,0,0.014441263271735132,56.28743478367409,3703
0,0,0,0,0,0,0,0.011870013117301443,56.29776928370238,3704
0,0,5,0,0,0,5,0.007067857659543351,56.30743922216,3702
0,0,0,0,0,0,0,0.00965213990193052,56.317619197072325,3703
0,0,1,0,0,0,1,0.0077185473485640145,56.317619197072325,3703
0,0,1,0,0,0,1,0.00582779456326399,56.350611563629705,3704
0,0,0,0,0,0,0,0.012970480882429256,56.350611563629705,3706
0,0,0,0,4,0,4,0.02162117637008282,56.322495952701146,3706
0,0,0,0,0,0,0,0.0065085996002071395,56.38594204333036,3708
4,0,0,0,0,0,4,0.014626382695595155,56.338415743958144,3705
0,0,0,0,0,0,0,0.018308384317592633,56.354054893633034,3707
0,0,3,0,0,0,3,0.029590726708902632,56.321260596384064,3709
0,0,0,0,0,0,0,0.026445028220551895,56.38360696819837,3712
0,0,0,0,0,0,0,0.024103290496442564,56.39917318312483,3713
0,0,0,0,0,0,0,0.029066345297978823,56.39917318312483,3713
0,0,0,0,0,0,0,0.021416219923618425,56.456435028431855,3716
0,0,0,0,0,0,0,0.018403076632314306,56.523781978200795,3719
0,0,1,0,0,0,1,0.012717329376624517,56.583785343244735,3722
0,0,1,0,0,0,1,0.011113244329726369,56.61562326733482,3722
0,0,0,0,0,0,0,0.0029003303441621957,56.65434631379763,3723
0,0,0,0,0,0,0,0.003002696734989136,56.68031923147581,3724
0,0,0,0,0,0,0,0.006533357197372674,56.69595744370901,3726
0,0,0,0,0,0,0,0.006439781960410793,56.71159587986019,3727
0,0,5,0,0,0,5,0.01225525394174113,56.58648969193569,3725
0,0,4,0,7,0,11,0.03031790165906877,56.538450313367605,3721
7,0,0,0,0,0,7,0.012936288256186887,56.538450313367605,3715
0,0,3,0,0,0,3,0.006263345135227713,56.57008194885774,3715
0,0,0,0,0,0,0,0.015243383136071178,56.57009037076202,3719
0,0,0,0,0,0,0,0.0189993584924246,56.59606891823464,3721
0,0,0,0,0,0,0,0.0178735170399991,56.61170116026147,3723
0,0,0,0,0,0,0,0.016714152704902337,56.637674030564135,3724
0,0,1,0,0,0,1,0.023210772435519826,56.637674030564135,3726
0,0,2,0,0,0,2,0.03126950260961045,56.6271662093434,3728
0,0,1,0,0,0,1,0.018552960673337393,56.7049826308486,3729
0,0,0,0,0,0,0,0.021092929641782412,56.73095539224711,3731
1,0,0,0,0,0,1,0.021448414911831668,56.762233893686755,3734
0,0,0,0,0,0,0,0.021293133771630158,56.78632985281912,3737
0,0,0,0,0,0,0,0.01906815006062054,56.864717000878166,3739
1,0,0,0,0,0,1,0.021354187610040203,56.90654512611256,3743
0,0,0,0,0,0,0,0.013137865880389982,56.92218344367991,3741
0,0,0,0,0,0,0,0.013493760722678029,56.93791580584485,3743
1,0,0,0,0,0,1,0.015128358995161597,56.969240706164655,3745
0,0,0,0,0,0,0,0.010536342856351332,57.01623442328855,3747
0,0,0,0,0,0,0,0.01594350082302971,57.06341389937935,3751
0,0,5,0,0,0,5,0.019751284524022396,56.95924952493655,3747
0,0,3,0,0,0,3,0.017843401589556482,56.95924952493655,3746
0,0,1,0,0,0,1,0.0116583049260624,57.006431427947795,3747
0,0,0,0,0,0,0,0.008857268910927817,57.037916438882114,3748
0,0,0,0,0,0,0,0.006439651090913641,57.076677213978165,3749
0,0,1,0,3,0,4,0.009463992838330286,57.058858548998366,3750
0,0,0,0,0,0,0,0.003383940192943096,57.102115931461796,3751
3,0,0,0,0,0,3,0.009071452258576949,57.08144693140519,3750
0,0,1,0,0,0,1,0.00980820238674404,57.08144693140519,3752
1,0,2,0,0,0,3,0.019769722327644047,57.07553272435171,3755
0,0,0,0,0,0,0,0.012499993856504415,57.11714389068631,3755
0,0,1,0,0,0,1,0.012785575781930555,57.14852626133461,3756
0,0,0,0,0,0,0,0.019277281748710517,57.16406112464307,3760
0,0,0,0,0,0,0,0.018095398514945793,57.19003388221716,3761
0,0,1,0,0,0,1,0.010335769911366338,57.22135227229046,3761
0,0,0,0,0,0,0,0.009474445331760417,57.24490300421736,3762
0,0,0,0,0,0,0,0.015740777872525067,57.260603909887955,3765
0,0,1,0,0,0,1,0.015765968469639794,57.28369803852957,3767
0,0,0,0,0,0,0,0.01744950895351469,57.31496527055712,3770
0,0,0,0,0,0,0,0.021569025604746092,57.31496527055712,3771
0,0,0,0,0,0,0,0.01772157924561629,57.33061186085395,3771
0,0,5,0,0,0,5,0.01786738918963991,57.270693951930134,3768
0,0,1,0,3,0,4,0.029828636185415335,57.248537314629125,3769
3,0,1,0,0,0,4,0.031376032257433836,57.26877428044512,3771
0,0,3,0,0,0,3,0.024908639616357305,57.28441496858695,3770
0,0,0,0,0,0,0,0.028762696441613566,57.29474714959382,3772
0,0,1,0,0,0,1,0.024076492706981662,57.29474714959382,3772
0,0,0,0,0,0,0,0.018586169530239297,57.37309014404313,3775
0,0,0,0,0,0,0,0.015609523513735317,57.388728610417715,3776
0,0,1,0,0,0,1,0.011993660265349173,57.435796664117,3777
0,0,1,0,0,0,1,0.00996342138076547,57.47237700376463,3778
0,0,0,0,0,0,0,0.012718699157777581,57.503899809515794,3780
0,0,0,0,0,0,0,0.01520717763350582,57.519577499398565,3782
0,0,1,0,0,0,1,0.01881514423427241,57.519577499398565,3783
0,0,2,0,0,0,2,0.020277086151856864,57.50924304012461,3784
0,0,0,0,0,0,0,0.019131889938957723,57.566808088697265,3787
0,0,0,0,0,0,0,0.015969863081909234,57.59814023612842,3788
0,0,0,0,0,0,0,0.016309766499147477,57.629443296290496,3790
0,0,0,0,0,0,0,0.01887389198401427,57.62944306707029,3790
0,0,1,0,0,0,1,0.02298914316939266,57.62944306707029,3793
0,0,0,0,0,0,0,0.021000344996386693,57.70233480841126,3797
0,0,0,0,0,0,0,0.021038455617309097,57.7386422147274,3800
0,0,5,0,0,0,5,0.02422902159379728,57.6657555034987,3797
0,0,2,0,0,0,2,0.016399815290654974,57.68884447477703,3795
0,0,0,0,0,0,0,0.015770761372049018,57.71482262881456,3796
0,0,0,0,0,0,0,0.014667986250283727,57.73047789877901,3797
0,0,0,0,0,0,0,0.01452196808643704,57.7408123988073,3798
0,0,0,0,4,0,4,0.03127216069261064,57.73364355294952,3801
0,0,0,0,0,0,0,0.015670650100224708,57.77897873513859,3801
4,0,0,0,1,0,5,0.025095961091807114,57.74927718412897,3800
0,0,0,0,0,0,0,0.013228616371420344,57.79254686946821,3801
0,0,1,0,0,0,1,0.012490157788412573,57.82386189382467,3802
0,0,0,0,0,0,0,0.01289605302063114,57.84981188515709,3805
0,0,0,0,0,0,0,0.00617263102813376,57.89305019538484,3804
0,0,0,0,0,0,0,0.01485175980606789,57.89305019538484,3808
0,0,1,0,0,0,1,0.012571283988923569,57.945371910094615,3809
0,0,0,0,0,0,0,0.01751284817040257,57.945371910094615,3811
0,0,0,0,0,0,0,0.015264201472291291,57.955706410122914,3811
1,0,0,0,0,0,1,0.0049194165572654805,57.971364476616706,3810
0,0,0,0,0,0,0,0.009478116135031436,57.987002716905764,3812
0,0,0,0,0,0,0,0.0016129617313951044,58.02046511289345,3813
1,0,0,0,0,0,1,0.005641233707474028,58.04598142814361,3815
0,0,0,0,0,0,0,0.007221162940636881,58.04598142814361,3816
1,0,5,0,0,0,6,0.011941195529639357,57.90765293234864,3812
0,0,4,0,3,0,7,0.01585365749975498,57.88987188580727,3808
4,0,0,0,0,0,4,0.00943688403427082,57.88987188580727,3805
0,0,0,0,0,0,0,0.010686802823977685,57.88987188580727,3806
0,0,0,0,0,0,0,0.009874448844251678,57.92114956614415,3808
1,0,0,0,0,0,1,0.012633948953976109,57.947122400327636,3810
0,0,0,0,0,0,0,0.006249796441370114,57.962784475497116,3809
0,0,0,0,0,0,0,0.006011627320691533,57.97843412025979,3810
0,0,0,0,0,0,0,0.006195581458042085,57.97843412025979,3810
0,0,0,0,0,0,0,0.006325802965605451,57.97843412025979,3810
0,0,0,0,0,0,0,0.008370507019390978,57.97843412025979,3812
0,0,0,0,0,0,0,0.01032215467648795,57.99407255687102,3813
0,0,0,0,0,0,0,0.012730544581923374,58.00440682411019,3814
0,0,2,0,0,0,2,0.014842160205590347,58.01001997814529,3819
0,0,0,0,0,0,0,0.019179702674193177,58.088246024474955,3822
0,0,0,0,0,0,0,0.017640107429989876,58.103884125162935,3822
0,0,2,0,0,0,2,0.01408001910026168,58.11421862519123,3824
0,0,0,0,0,0,0,0.0100430509884542,58.187195270807884,3826
0,0,0,0,0,0,0,0.006571380612060772,58.21316769795991,3827
1,0,0,0,0,0,1,0.009584042383492765,58.22061424394124,3828
0,0,0,0,0,0,0,0.007709351379842423,58.262933161981515,3832
0,0,5,0,0,0,5,0.005553192535838821,58.21930610307445,3829
0,0,1,0,0,0,1,0.007084119921955381,58.21930610307445,3829
0,0,0,0,0,0,0,0.013135555581358892,58.21930610307445,3831
0,0,1,0,0,0,1,0.013369545764512478,58.21930610307445,3832
0,0,0,0,0,0,0,0.015523283754559566,58.23940198895472,3833
0,0,0,0,5,0,5,0.026025150254257178,58.240422073617815,3836
0,0,0,0,0,0,0,0.018089152675638546,58.33141681514147,3839
5,0,0,0,0,0,5,0.023379949222355367,58.271740694519806,3837
0,0,0,0,1,0,1,0.02331706231616112,58.29032527610974,3837
0,0,0,0,0,0,0,0.01598106428609756,58.326654058809126,3840
1,0,0,0,0,0,1,0.0238731951393427,58.33698855883742,3841
0,0,0,0,0,0,0,0.017375179543040013,58.36826558837276,3841
0,0,0,0,0,0,0,0.014972389438443893,58.41523262119023,3845
1,0,2,0,0,0,3,0.017799587061253896,58.43627361868659,3846
0,0,1,0,0,0,1,0.016624102141094957,58.46767918423902,3847
0,0,0,0,0,0,0,0.012537545235843862,58.483374152976964,3848
0,0,0,0,0,0,0,0.007996542637270551,58.51679347567321,3849
0,0,0,0,0,0,0,0.009103474896868665,58.54276628832113,3850
0,0,0,0,0,0,0,0.006726176632453526,58.54276628832113,3851
0,0,0,0,0,0,0,0.009278034267629466,58.57618577076671,3853
0,0,0,0,0,0,0,0.013037507066245875,58.57618577076671,3855
1,0,5,0,0,0,6,0.021787726496037097,58.46168662929552,3852
0,0,3,0,6,0,9,0.030041403982343142,58.45028305486549,3851
6,0,0,0,0,0,6,0.020554440224582655,58.48197761384566,3849
0,0,0,0,0,0,0,0.024463986772453858,58.49764293764781,3851
0,0,0,0,0,0,0,0.01821985885695761,58.528916440390006,3851
0,0,0,0,0,0,0,0.015918436551421482,58.56021306469295,3853
0,0,0,0,0,0,0,0.015011887628867853,58.6121907454477,3856
0,0,0,0,0,0,0,0.0177730713100063,58.6121907454477,3858
0,0,0,0,0,0,0,0.017249959984494,58.622525245476,3858
0,0,0,0,0,0,0,0.01202568066596265,58.65380749112473,3858
0,0,0,0,0,0,0,0.0093691013666474,58.685078366250075,3860
0,0,0,0,0,0,0,0.012432949966124008,58.71646580477523,3862
0,0,0,0,0,0,0,0.009104121455143218,58.72388254707304,3863
0,0,2,0,0,0,2,0.00048028489148795744,58.739760021935425,3862
2,0,0,0,0,0,2,0.011231642641982209,58.755398447336745,3866
0,0,1,0,0,0,1,0.010541369218132717,58.76573294736505,3867
0,0,0,0,0,0,0,0.006270168650628508,58.80445625777199,3867
0,0,0,0,0,0,0,0.001389757466913141,58.820102245615274,3867
0,0,0,0,0,0,0,0.009003112161097667,58.83574069149889,3870
0,0,0,0,0,0,0,0.012954540631554975,58.851379302870605,3873
0,0,0,0,0,0,0,0.014682939122633321,58.8617135029311,3875
1,0,5,0,0,0,6,0.011066964575825794,58.82755662773409,3872
0,0,0,0,0,0,0,0.007833784500913878,58.87205550832412,3873
0,0,0,0,0,0,0,0.014624073592994,58.87205550832412,3875
0,0,0,0,0,0,0,0.02040715099493965,58.87205550832412,3878
0,0,0,0,0,0,0,0.015960059417373638,58.91366661999139,3879
0,0,0,0,7,0,7,0.03270603821944517,58.87596710019296,3880
0,0,0,0,0,0,0,0.0087685407034869,58.97729200108075,3879
7,0,0,0,0,0,7,0.00878124450939945,58.92291987222505,3875
0,0,0,0,0,0,0,0.008811642078776416,58.95427085956425,3876
0,0,0,0,0,0,0,0.015393454278072045,58.980261629074796,3881
0,0,0,0,0,0,0,0.013095400152305743,59.01150592113051,3882
0,0,0,0,0,0,0,0.009240166840535009,59.05842705553191,3883
0,0,0,0,0,0,0,0.00365386998828915,59.074065410650846,3883
0,0,0,0,0,0,0,0.00622368339713383,59.10538515331583,3885
0,0,0,0,0,0,0,0.0035648132160669348,59.121061287147995,3886
0,0,0,0,0,0,0,0.011639761387972023,59.12102328839558,3889
0,0,0,0,0,0,0,0.011450638205160901,59.1366615810986,3890
0,0,0,0,0,0,0,0.009112632446640536,59.16288522272901,3890
0,0,0,0,0,0,0,0.01226630073620676,59.162634289368334,3891
0,0,0,0,0,0,0,0.02006485336242457,59.162634289368334,3895
0,0,0,0,0,0,0,0.024877126049135636,59.162634289368334,3896
1,0,0,0,0,0,1,0.021366952854697866,59.20137871886248,3898
0,0,0,0,3,0,3,0.028192426971135106,59.20453724448286,3899
3,0,0,0,0,0,3,0.018594281047475476,59.25147661648694,3899
0,0,0,0,0,0,0,0.007278041660688721,59.28278196077877,3897
0,0,0,0,0,0,0,0.006765157834819256,59.29839103942581,3899
0,0,0,0,0,0,0,0.008439946704215015,59.345305968908804,3901
0,0,0,0,0,0,0,0.004309996136517945,59.37127871417388,3902
0,0,0,0,0,0,0,0.008317417334743457,59.386917044304035,3904
0,0,0,0,0,0,0,0.012732348986615223,59.38691675439324,3906
0,0,5,0,0,0,5,0.016800584630074767,59.24619912737459,3901
0,0,5,0,0,0,5,0.007408396864248223,59.267165597950594,3896
0,0,2,0,0,0,2,0.004466257557520385,59.28282514721934,3896
0,0,0,0,0,0,0,0.009019599117079665,59.29846370268125,3898
0,0,0,0,0,0,0,0.004983907529709253,59.29846340442946,3897
0,0,0,0,0,0,0,0.009122072961042825,59.29846340442946,3898
0,0,0,0,0,0,0,0.008695168357510772,59.308797904457755,3899
0,0,0,0,0,0,0,0.005918293546493041,59.32445495608298,3899
0,0,0,0,0,0,0,0.009537329503615653,59.32445495608298,3901
0,0,0,0,0,0,0,0.006359368454300818,59.35573168043027,3902
0,0,0,0,0,0,0,0.01509163063067461,59.36606618045857,3905
0,0,0,0,0,0,0,0.018584712249796048,59.39750486764163,3909
0,0,0,0,0,0,0,0.015860401752047466,59.41314332138522,3909
0,0,0,0,0,0,0,0.009226647152070017,59.45186895613773,3909
0,0,0,0,0,0,0,0.010401878677723235,59.46750652865434,3912
0,0,0,0,0,0,0,0.012040064652619527,59.51442491169581,3914
0,0,0,0,0,0,0,0.009130067861012134,59.54570531532318,3915
0,0,0,0,3,0,3,0.016266416652352393,59.533227948066326,3916
0,0,0,0,1,0,1,0.00596081652250037,59.584013469839306,3917
5,0,0,0,0,0,5,0.001124003589802607,59.56452563549935,3913
0,0,0,0,0,0,0,0.005815158643775015,59.56452563549935,3914
0,0,0,0,0,0,0,0.0031286381208605464,59.58383855272415,3915
0,0,0,0,0,0,0,0.0059762080941484315,59.59951305706855,3917
0,0,0,0,0,0,0,0.00819856285825045,59.59951305706855,3918
0,0,0,0,0,0,0,0.0031392627743209813,59.63583199753363,3919
0,0,0,0,0,0,0,0.003011888654288427,59.65154603208789,3920
0,0,0,0,0,0,0,0.0031539268622890067,59.65154603208789,3922
0,0,0,0,0,0,0,0.0030552039760988804,59.69863471180885,3924
0,0,0,0,0,0,0,0.008494728523591535,59.714179263652994,3926
1,0,0,0,0,0,1,0.009018891448747145,59.71417560015834,3926
0,0,5,0,0,0,5,0.01796858636979504,59.656927047668795,3925
0,0,0,0,0,0,0,0.008864329747808208,59.70385961928422,3925
0,0,0,0,0,0,0,0.0067904992875778645,59.71949797887548,3926
0,0,0,0,0,0,0,0.012857714742351641,59.7351359136545,3929
0,0,1,0,2,0,3,0.008871947286762724,59.77211613054986,3929
2,0,0,0,0,0,2,0.006286088639065101,59.771716306187734,3928
0,0,0,0,0,0,0,0.0030584371137644213,59.771716306187734,3928
0,0,0,0,0,0,0,0.0,59.78735667990227,3927
0,0,0,0,0,0,0,0.006010231432417485,59.78735667990227,3929
0,0,0,0,0,0,0,0.0012136583685822806,59.818635152248625,3930
0,0,0,0,0,0,0,0.0029050575259542116,59.818635152248625,3930
0,0,0,0,0,0,0,0.009201726375216625,59.818635152248625,3932
0,0,0,0,0,0,0,0.008608709290585307,59.84996040716024,3934
0,0,0,0,0,0,0,0.005879176991234084,59.86560710238197,3934
0,0,0,0,0,0,0,0.00906485810516247,59.8656067986072,3935
0,0,0,0,0,0,0,0.004228975605594639,59.896997257689506,3936
0,0,0,0,0,0,0,0.012354405281605724,59.91263560770058,3940
1,0,0,0,0,0,1,0.01339497040358139,59.9439438547004,3943
0,0,0,0,0,0,0,0.00692236395289615,59.97522512968814,3944
0,0,0,0,0,0,0,0.008408511394301973,60.01683671329238,3945
0,0,0,0,0,0,0,0.005994997830679038,60.03247503694687,3945
0,0,0,0,0,0,0,0.01328330041408244,60.04811328275498,3949
1,0,0,0,0,0,1,0.015594591481114514,60.06375173149739,3951
0,0,0,0,0,0,0,0.0187854923320275,60.07939127762057,3953
0,0,0,0,0,0,0,0.010093923386672652,60.110666877953406,3952
0,0,0,0,0,0,0,0.007591790498980322,60.12100137798169,3952
0,0,0,0,0,0,0,0.01095843068218127,60.128447855377026,3954
0,0,0,0,0,0,0,0.006846579233884883,60.175363637886676,3956
0,0,0,0,0,0,0,0.013286918933793359,60.18569798958293,3959
1,0,0,0,5,0,6,0.017867868962836063,60.17855529757403,3958
0,0,4,0,0,0,4,0.009757567553140896,60.11311045886101,3955
5,0,4,0,0,0,9,0.002890988700431617,60.08471160563916,3947
0,0,0,0,0,0,0,0.0025199385445711774,60.08471135573619,3947
0,0,0,0,0,0,0,5.098475162668469e-06,60.115995077111904,3949
0,0,0,0,0,0,0,0.0,60.126329577140204,3950
0,0,0,0,0,0,0,0.005894301516284176,60.126329577140204,3951
0,0,0,0,0,0,0,0.008995699250883506,60.126329577140204,3952
0,0,0,0,0,0,0,0.006992830588839663,60.14198638006039,3953
0,0,0,0,0,0,0,0.006178089102845577,60.15230229154998,3953
0,0,0,0,0,0,0,0.0028743508153837934,60.15974793763997,3953
0,0,0,0,0,0,0,0.005857732012177972,60.15974793763997,3955
0,0,0,0,0,0,0,0.008998125048108306,60.17008243766826,3956
0,0,0,0,0,0,0,0.006169827665831438,60.18574229635355,3957
1,0,0,0,0,0,1,0.015295139710008959,60.18574229635355,3960
1,0,0,0,0,0,1,0.00742852567578095,60.23289650001929,3960
0,0,0,0,0,0,0,0.010505028148776449,60.2483080941934,3962
0,0,0,0,2,0,2,0.014901809121436094,60.25897421197029,3963
2,0,0,0,0,0,2,0.005919850063859731,60.27455394680389,3961
0,0,0,0,1,0,1,0.005818965482619381,60.27455394680389,3961
1,0,0,0,0,0,1,0.0015519050133053988,60.290192319006536,3961
0,0,0,0,0,0,0,0.0026348484172654804,60.30583056255562,3963
0,0,0,0,0,0,0,0.005975453840350577,60.30583056255562,3963
0,0,0,0,0,0,0,0.008784941134330475,60.30583056255562,3964
0,0,0,0,0,0,0,0.0032578583729125587,60.36839081590607,3968
0,0,0,0,0,0,0,0.005827802642376507,60.384067211120275,3969
0,0,0,0,0,0,0,0.00023108235232787328,60.41005007814373,3969
0,0,0,0,0,0,0,0.010219595680044241,60.41005007814373,3972
0,0,0,0,0,0,0,0.007155911851790033,60.44346923059059,3974
0,0,0,0,0,0,0,0.0011777994379915187,60.46944258389044,3974
0,0,0,0,0,0,0,0.003010693149278845,60.46944198618459,3974
0,0,5,0,0,0,5,0.005897226513114114,60.39655449288647,3971
0,0,0,0,0,0,0,0.004997408827200526,60.41219893282759,3972
0,0,0,0,0,0,0,0.0031056958141863367,60.45096761558385,3973
0,0,0,0,0,0,0,0.002480534966363498,60.48229205556038,3975
0,0,0,0,0,0,0,0.005954637616484893,60.48229205556038,3976
0,0,0,0,0,0,0,0.004822447209823319,60.52397898126055,3979
0,0,0,0,0,0,0,0.004230154816533543,60.53431348128884,3981
0,0,0,0,0,0,0,0.00618701968329199,60.54995179328663,3981
0,0,0,0,0,0,0,0.00507662360337932,60.54995179328663,3981
0,0,0,0,0,0,0,0.00601963448155314,60.56559002064231,3982
0,0,0,0,0,0,0,0.0028698034550726135,60.56559002064231,3982
0,0,0,0,6,0,6,0.02017762040465455,60.50935891731328,3981
0,0,0,0,0,0,0,0.005930445366324872,60.58467329745165,3982
6,0,0,0,0,0,6,0.002866128478056933,60.55627390779879,3978
0,0,0,0,0,0,0,0.00549294798079399,60.55627390779879,3980
0,0,0,0,0,0,0,0.0028915333214319665,60.57191223084038,3980
0,0,0,0,0,0,0,0.002234711385783669,60.582246730868675,3980
1,0,0,0,0,0,1,0.013941858705243249,60.582246730868675,3984
0,0,0,0,0,0,0,0.008779450508204301,60.61352872683761,3984
0,0,0,0,0,0,0,0.00875784833982155,60.61352344085392,3984
0,0,0,0,0,0,0,0.008930277587364486,60.62916175389018,3985
0,0,0,0,0,0,0,0.007233808369672377,60.62916175389018,3985
0,0,0,0,0,0,0,0.00601256971723931,60.64480901795428,3986
0,0,0,0,0,0,0,4.2032062406349635e-06,60.691744142500546,3986
0,0,0,0,0,0,0,0.0023602990544528885,60.69171500212509,3987
0,0,0,0,0,0,0,0.0,60.69171500212509,3986
0,0,0,0,0,0,0,0.0,60.69171500212509,3986
0,0,0,0,0,0,0,0.0,60.69171500212509,3986
0,0,0,0,1,0,1,0.0031297140713053067,60.68138050209679,3986
1,0,0,0,0,0,1,0.0056997868392788436,60.68138050209679,3987
0,0,5,0,0,0,5,0.007788162777030491,60.57721597849577,3982
0,0,2,0,1,0,3,0.010948097027523114,60.59653665695094,3984
1,0,0,0,0,0,1,0.009047002611801538,60.612464753898976,3983
0,0,0,0,0,0,0,0.005441834864813579,60.612464753898976,3982
0,0,0,0,0,0,0,0.006208111412740406,60.612464753898976,3982
0,0,0,0,0,0,0,9.410533378048168e-06,60.63849954555983,3982
0,0,0,0,0,0,0,0.005953974472653368,60.63843751686241,3984
0,0,0,0,0,0,0,0.002033328070883886,60.654075743878586,3984
1,0,0,0,0,0,1,0.0029924675813610834,60.66441024390688,3985
0,0,0,0,0,0,0,0.0021549390392199756,60.695689677658876,3987
0,0,0,0,0,0,0,0.003061324005090644,60.69568675936157,3987
0,0,0,0,0,0,0,0.006085431633118742,60.69568675936157,3988
0,0,0,0,0,0,0,0.008505767486792448,60.69568675936157,3989
0,0,0,0,0,0,0,0.009702821328667755,60.69568675936157,3990
0,0,0,0,0,0,0,0.008616516019980935,60.71132503812317,3990
0,0,0,0,0,0,0,0.009638949287006177,60.7269632781145,3992
1,0,0,0,0,0,1,0.00478871138902115,60.768574400419006,3994
0,0,0,0,0,0,0,0.0070890414322564346,60.79992234235205,3996
0,0,0,0,0,0,0,0.0030182411055580715,60.83120181137368,3996
0,0,0,0,0,0,0,0.0,60.83861660458823,3996
0,0,0,0,0,0,0,0.0015058073352659782,60.83861660458823,3997
0,0,0,0,0,0,0,0.005656787528148132,60.83861660458823,3998
0,0,0,0,0,0,0,0.0071413056082971224,60.87291533057734,4002
0,0,5,0,4,0,9,0.01820774808590738,60.777254303878166,3997
0,0,0,0,0,0,0,0.007767111940374321,60.822593379189016,3998
4,0,0,0,0,0,4,0.006439136063985985,60.77725358874973,3994
0,0,0,0,0,0,0,0.009006171038935803,60.77725358874973,3994
0,0,0,0,0,0,0,0.008972452730409107,60.77725358874973,3994
0,0,0,0,0,0,0,0.007230759924453238,60.787588088778016,3996
1,0,0,0,0,0,1,0.0020602602518639012,60.81085281025301,3996
0,0,0,0,0,0,0,0.0031093601898045794,60.836825593513055,3997
0,0,0,0,0,0,0,0.0,60.836825593513055,3996
0,0,0,0,0,0,0,0.0029204236335085934,60.84427215065768,3998
0,0,0,0,0,0,0,0.005089564344887766,60.84427215065768,3999
0,0,0,0,0,0,0,0.0029411141219297127,60.85460665068598,3999
0,0,0,0,0,0,0,0.002961792050185212,60.85460665068598,3999
1,0,0,0,0,0,1,0.005918214111961424,60.85460665068598,4000
0,0,0,0,0,0,0,6.53860678310065e-05,60.86540160247212,4000
0,0,0,0,0,0,0,0.0,60.89986057426234,4001
0,0,0,0,0,0,0,0.0,60.89986057426234,4001
0,0,0,0,4,0,4,0.012120254264587349,60.86141051703282,4002
4,0,0,0,0,0,4,0.006122247853928166,60.86141051703282,3999
0,0,0,0,0,0,0,0.003092962126990686,60.86141051703282,3998
0,0,0,0,0,0,0,0.0030779225274681923,60.86141051703282,3998
0,0,0,0,0,0,0,0.005669676104039289,60.86141051703282,3999
0,0,0,0,0,0,0,0.007389782712034404,60.86141051703282,4000
0,0,0,0,0,0,0,0.002862633460196668,60.8927103796043,4000
0,0,0,0,0,0,0,0.00215188376763796,60.90302153889426,4001
0,0,0,0,0,0,0,2.3382342836907357e-06,60.91335603892255,4001
0,0,0,0,0,0,0,0.0,60.91335603892255,4001
0,0,0,0,0,0,0,0.0,60.91335603892255,4001
0,0,0,0,0,0,0,0.0,60.91335603892255,4001
0,0,0,0,0,0,0,0.0030418843950965496,60.91335603892255,4002
0,0,0,0,0,0,0,0.0028636439904070835,60.92369053895085,4003
0,0,0,0,0,0,0,0.005801667782667554,60.93932882154493,4005
0,0,0,0,0,0,0,0.006706445455433511,60.93932882154493,4006
0,0,0,0,0,0,0,0.0062419477434840455,60.93932882154493,4006
0,0,0,0,0,0,0,0.00551198920189202,60.9467753372389,4007
0,0,0,0,0,0,0,0.009207391580558565,60.962413560746235,4009
0,0,0,0,0,0,0,0.005752335437141292,60.97805179674127,4008
0,0,0,0,0,0,0,1.2063666435544342e-07,61.00932934705088,4008
1,0,0,0,0,0,1,0.002426077422924842,61.0093284820751,4009
0,0,0,0,0,0,0,0.002974347880535629,61.03530127162526,4011
0,0,0,0,0,0,0,0.00484749761210765,61.03530127162526,4013
0,0,0,0,0,0,0,0.0027792641890244294,61.06166581696394,4013
0,0,0,0,4,0,4,0.011701607006987214,61.02321587596942,4012
0,0,0,0,0,0,0,0.0028847893239848203,61.06855551716442,4013
4,0,0,0,0,0,4,0.0028827341349779915,61.02322278719461,4009
0,0,0,0,0,0,0,0.006157365479352966,61.023224434767094,4010
0,0,0,0,0,0,0,0.005813582123229719,61.023224434767094,4011
1,0,0,0,0,0,1,0.0056350793067016835,61.033558934795394,4013
0,0,0,0,0,0,0,0.0036785617976742594,61.07517110475755,4014
0,0,0,0,0,0,0,0.0027868177015431816,61.09080984552151,4014
0,0,0,0,0,0,0,0.003870699458186089,61.090809579504885,4015
0,0,0,0,0,0,0,0.011582823849893144,61.090809579504885,4017
0,0,0,0,0,0,0,0.003011368304289325,61.12422967296808,4017
0,0,0,0,0,0,0,0.007357620231862238,61.12422875365656,4019
0,0,0,0,0,0,0,0.0058225814836587765,61.139867337899815,4019
0,0,0,0,0,0,0,0.002196397578521629,61.16295222363084,4021
0,0,0,0,0,0,0,0.00032323803392185333,61.17328648881538,4021
0,0,0,0,0,0,0,0.0028047025776785097,61.186034760240936,4022
0,0,0,0,0,0,0,0.0,61.210741251236726,4023
1,0,0,0,7,0,8,0.02547113923653934,61.14417585218905,4025
7,0,0,0,0,0,7,0.0013368416324349638,61.15981405362415,4018
0,0,0,0,0,0,0,0.002987216059533409,61.15981405362415,4018
0,0,0,0,0,0,0,0.0,61.15981405362415,4017
0,0,0,0,0,0,0,0.0029542528026917604,61.15981405362415,4018
0,0,0,0,0,0,0,0.003041101466007197,61.15981405362415,4018
0,0,0,0,0,0,0,0.006033241106266739,61.17545782985627,4020
0,0,0,0,0,0,0,0.0030904221497545605,61.18579232988457,4020
0,0,0,0,0,0,0,0.005857536855257013,61.19612682991286,4022
0,0,0,0,0,0,0,0.006637346989799521,61.19612682991286,4023
0,0,0,0,0,0,0,0.005890385054004757,61.22740480577158,4024
0,0,0,0,0,0,0,0.005807379842654822,61.22740363457569,4024
0,0,0,0,0,0,0,0.0030525769752072574,61.243042030042965,4024
0,0,0,0,0,0,0,0.0063383055714496175,61.243042030042965,4026
0,0,0,0,0,0,0,0.006143989076157151,61.25868030246937,4026
0,0,0,0,0,0,0,0.008877957086807216,61.25868030246937,4027
1,0,0,0,0,0,1,0.009710707346007976,61.25868030246937,4028
0,0,0,0,0,0,0,0.00612156443244362,61.274324933427636,4028
0,0,0,0,0,0,0,0.005823451507897533,61.30231583334295,4030
0,0,0,0,0,0,0,0.006044979963340493,61.317954790543766,4031
0,0,0,0,0,0,0,0.0030140102752958427,61.328281932846295,4031
0,0,0,0,0,0,0,0.00299209187964089,61.335728513162984,4032
0,0,0,0,0,0,0,0.005873599539363344,61.335728513162984,4033
0,0,0,0,0,0,0,0.002844857774303564,61.335728513162984,4033
0,0,0,0,0,0,0,0.0028695014922330265,61.346063013191284,4033
0,0,0,0,5,0,5,0.014888371465519542,61.31291664404989,4033
0,0,0,0,0,0,0,0.0008797632924283998,61.37259261839669,4034
5,0,0,0,0,0,5,0.005426814791766081,61.31291664404989,4030
0,0,0,0,0,0,0,0.002904424641972348,61.32325114407819,4030
0,0,0,0,0,0,0,0.0028433383619251014,61.32325114407819,4030
0,0,0,0,0,0,0,0.0025483331855430794,61.32325114407819,4030
0,0,0,0,0,0,0,0.0029253549809599745,61.33888951154336,4031
0,0,0,0,0,0,0,0.003675282353137773,61.33888951154336,4032
1,0,0,0,0,0,1,0.00506782650843767,61.38431803590846,4035
0,0,0,0,0,0,0,0.0028846878130358205,61.41560561041805,4035
1,0,0,0,0,0,1,0.0009361706255723638,61.43136732378428,4036
0,0,0,0,0,0,0,8.511170061618405e-07,61.4468989795073,4036
0,0,0,0,0,0,0,0.0028937701056860176,61.446882045499066,4037
0,0,0,0,0,0,0,0.0017018188144161338,61.446882045499066,4037
0,0,0,0,0,0,0,0.0,61.46252029931323,4037
0,0,0,0,0,0,0,0.00110025770783262,61.46252029931323,4038
0,0,0,0,0,0,0,0.0028770620912062523,61.46252029931323,4038
0,0,0,0,0,0,0,0.005870406563142668,61.46252029931323,4039
0,0,0,0,0,0,0,0.008417132561587973,61.46252029931323,4042
0,0,0,0,0,0,0,0.006763774178680256,61.493807962549624,4042
1,0,0,0,0,0,1,0.004895488528746265,61.50944630134074,4042
0,0,0,0,0,0,0,0.0037675599267094914,61.5250845559323,4043
0,0,0,0,0,0,0,0.005987664340129091,61.540724134742376,4044
0,0,0,0,0,0,0,0.0,61.54591060779431,4043
0,0,0,0,0,0,0,0.0032748890149693626,61.54591060779431,4045
0,0,0,0,0,0,0,0.0017043176287549204,61.55624510782261,4045
0,0,0,0,0,0,0,0.00373935860901342,61.571883482394,4047
0,0,0,0,0,0,0,3.2515524714814754e-07,61.5921033273537,4047
0,0,0,0,0,0,0,0.0,61.59210309262234,4048
0,0,0,0,0,0,0,0.00033693351764390943,61.59210309262234,4048
0,0,0,0,0,0,0,0.0,61.607741304272686,4048
1,0,0,0,0,0,1,0.0005920639098416418,61.607741304272686,4050
0,0,0,0,0,0,0,0.0002498709318975009,61.63908216677722,4051
0,0,0,0,0,0,0,0.005684755604261964,61.63908216677722,4052
0,0,0,0,0,0,0,0.0,61.63908216677722,4050
1,0,0,0,0,0,1,0.0036062736060210663,61.63908216677722,4052
0,0,0,0,0,0,0,0.0029903998475176202,61.67054711831791,4053
0,0,0,0,0,0,0,0.005985751088488153,61.686197461327495,4055
0,0,0,0,0,0,0,0.007291162138919647,61.70184520649836,4057
0,0,0,0,0,0,0,0.002795939913529952,61.73321664697891,4058
0,0,0,0,0,0,0,0.005860936395275902,61.73321664697891,4058
0,0,0,0,0,0,0,0.0030645872321299382,61.73321664697891,4057
0,0,0,0,1,0,1,0.006309107210327661,61.72288214695061,4058
0,0,0,0,0,0,0,0.0028587363064087132,61.748854966117996,4058
1,0,0,0,0,0,1,0.008467554155611885,61.73852046608969,4059
0,0,0,0,0,0,0,0.005887296590244903,61.73852046608969,4058
0,0,0,0,0,0,0,0.002816647310673532,61.76449318298025,4059
0,0,0,0,0,0,0,0.005752000400493738,61.76449318298025,4060
0,0,0,0,0,0,0,0.005001895464385051,61.78013148746055,4061
0,0,0,0,0,0,0,0.0059418606857302835,61.79576971167043,4062
0,0,0,0,0,0,0,0.0050848837723414695,61.811408004735014,4063
0,0,0,0,0,0,0,0.0009395537193254326,61.82174250476331,4063
0,0,0,0,0,0,0,0.0020449249309551012,61.83738074341498,4064
0,0,0,0,0,0,0,0.0,61.86903067303936,4065
0,0,0,0,0,0,0,0.0,61.86903067303936,4065
0,0,0,0,0,0,0,0.0,61.86903067303936,4065
1,0,0,0,0,0,1,0.0017968299146250057,61.86903067303936,4066
0,0,0,0,0,0,0,0.0,61.88466887777448,4066
0,0,0,0,0,0,0,0.0,61.88466887777448,4066
0,0,0,0,2,0,2,0.005859922438899336,61.863999877717895,4066
3,0,0,0,0,0,3,0.0,61.863999877717895,4065
0,0,0,0,0,0,0,0.0024163792974755027,61.895314232982216,4067
0,0,0,0,0,0,0,0.002880297913858385,61.895314232982216,4067
0,0,0,0,0,0,0,0.0028798078882267763,61.895314232982216,4067
1,0,0,0,0,0,1,0.0029302515214261137,61.911103262152984,4068
0,0,0,0,0,0,0,0.002779783149656905,61.91095244409539,4068
0,0,0,0,0,0,0,0.003936226564908692,61.91095244409539,4070
0,0,0,0,1,0,1,0.002486056270344305,61.93649789653779,4071
0,0,0,0,0,0,0,0.002881513882689992,61.96250398410697,4073
0,0,0,0,0,0,0,0.005151917861241561,61.96250398410697,4073
0,0,0,0,0,0,0,0.0024767283569070734,61.978143228217135,4073
0,0,0,0,0,0,0,0.004025340394211122,61.97814234985763,4074
0,0,0,0,0,0,0,0.0059034604608806905,61.993780780115614,4075
0,0,0,0,0,0,0,0.0027552122957302375,61.993780554468344,4074
0,0,0,0,0,0,0,0.004101074518166323,61.993780554468344,4075
0,0,0,0,0,0,0,3.6724402869198575e-05,62.006931610855574,4075
0,0,0,0,0,0,0,0.0015503266259871639,62.006649281308945,4077
0,0,0,0,0,0,0,0.005758916622844176,62.006649281308945,4077
0,0,0,0,0,0,0,0.0,62.006649281308945,4075
0,0,0,0,0,0,0,0.008536779034305903,62.006649281308945,4078
0,0,0,0,0,0,0,0.00880995105788141,62.006649281308945,4079
0,0,0,0,0,0,0,0.014247591982699204,62.037926290994136,4082
0,0,0,0,0,0,0,0.00947955726822664,62.03792598406609,4081
0,0,0,0,0,0,0,0.0029058868904217306,62.063898817960556,4080
1,0,0,0,3,0,4,0.012076040993538185,62.03289531787568,4081
0,0,0,0,0,0,0,0.008792388834156553,62.097558500836435,4084
3,0,0,0,0,0,3,0.007143986617253116,62.081457292614566,4081
0,0,0,0,0,0,0,0.0011162474061072677,62.097095797934195,4081
0,0,0,0,0,0,0,0.0011015192279859422,62.10743000165654,4083
1,0,0,0,0,0,1,0.0,62.13340287579134,4083
0,0,0,0,0,0,0,0.0,62.13340287579134,4083
0,0,0,0,0,0,0,0.00397152374053358,62.13340287579134,4085
1,0,0,0,0,0,1,0.0018636703161440857,62.14373737581965,4085
0,0,0,0,0,0,0,0.0040765654125419085,62.14373737581965,4086
0,0,0,0,0,0,0,0.003465075091366644,62.14373737581965,4086
0,0,0,0,0,0,0,0.00552181594036401,62.159375851956746,4087
0,0,0,0,0,0,0,0.0028391623882530327,62.15937561251634,4086
0,0,0,0,0,0,0,0.0007841648759905081,62.175017860732545,4087
0,0,0,0,0,0,0,0.0015902346509079123,62.18534839170474,4088
0,0,0,0,0,0,0,0.0,62.201237843544625,4088
1,0,0,0,0,0,1,0.0,62.19090334351633,4087
0,0,0,0,2,0,2,0.005937766135677765,62.17023434345974,4087
2,0,0,0,0,0,2,0.006580138138774235,62.17023434345974,4088
0,0,0,0,0,0,0,8.858209640841595e-06,62.20156816612043,4087
0,0,0,0,0,0,0,0.0001571016922297178,62.201510932665144,4088
0,0,0,0,0,0,0,0.0,62.21714928376873,4088
0,0,0,0,0,0,0,0.0028239911304380016,62.21714928376873,4089
0,0,0,0,0,0,0,0.0026683802923721475,62.21714928376873,4089
