throughput_KLONGTEI,throughput_KASEMRAT,throughput_NARANONG,throughput_SUNLAKAKHON,throughput_RAMA4, throughput_ATTHAKAVI_RAMA4,throughput,mean_speed,jamlength_percent,Backlog
0,0,0,0,0,0,0,7.8764396314290765,0.0,17
0,0,0,0,0,1,1,8.912429623297465,0.007551010726155326,35
0,0,0,1,0,0,1,9.888553842084232,0.028339320816404036,60
0,2,1,0,1,0,4,10.125733578879046,0.03867382084470087,85
1,2,1,0,1,0,5,9.654486830417769,0.08827452282826419,107
1,2,0,0,2,1,6,9.861986342751104,0.1717894078764425,135
0,4,0,1,1,1,7,9.20261516867328,0.27440979155415807,167
1,6,3,3,0,0,13,9.222640086746052,0.2994709187382999,178
2,6,1,3,0,4,16,9.334038351679256,0.3267785819449045,215
3,6,0,1,4,0,14,8.62123479174157,0.5141109326687698,237
6,5,1,3,1,3,19,8.121839550657846,0.7470747759904004,267
6,5,1,18,5,4,39,8.617672341022551,0.7336439192595189,289
0,14,1,5,6,4,30,8.330023966214712,0.8323571557218333,314
19,7,0,2,1,5,34,8.103264900050219,1.0624921281506352,347
9,8,2,2,6,3,30,8.042504818018816,1.2212180455679282,376
11,7,1,4,3,3,29,7.364231563997154,1.5451421072705716,404
7,15,9,2,6,8,47,7.197705676248363,1.7637892609741528,431
4,8,3,1,9,5,30,6.374178636662427,2.3633034181412587,438
7,6,0,2,3,6,24,6.036964273840631,2.8161839338818835,458
7,5,0,2,3,6,23,5.661592719318579,3.2260993201268393,484
9,10,10,7,15,3,54,5.656794473411302,2.948880108631766,480
6,10,4,7,8,4,39,5.177688987434977,3.4994953181044224,503
5,3,7,2,5,4,26,4.739937118011867,4.155206364661652,547
6,3,3,0,5,3,20,4.370855096599657,4.677297668129872,578
8,4,10,17,6,3,48,4.5714066504305055,4.3579173627822865,574
6,7,10,21,5,7,56,4.498657379088802,4.236659388590216,560
5,6,12,10,3,6,42,3.919415860731105,4.633145575362243,566
11,9,10,0,3,5,38,3.822712601265935,5.126128792442611,593
8,2,10,2,23,5,50,4.099316250351459,4.9600927550448635,608
6,19,10,1,26,6,68,4.611404593946783,4.716176227136606,618
10,6,10,1,22,4,53,4.7515125898807655,4.8183542381057665,645
8,4,5,12,6,5,40,4.627716074720254,5.078657919309985,663
8,6,11,14,3,9,51,4.527438642648315,4.915039676209782,677
9,13,7,12,8,13,62,4.691752650592495,4.909599063495445,705
14,11,6,12,6,12,61,4.779376920704299,4.993493233349368,725
9,11,6,10,7,15,58,4.461504166557799,5.421190623431406,729
7,11,6,16,4,15,59,4.347998250788177,5.551944435134845,739
10,11,17,19,3,10,70,4.194170191852135,5.678788175993121,738
8,12,11,1,5,6,43,4.002588166097398,6.116006281602621,769
11,15,10,0,3,7,46,3.951053020509651,6.38418336128524,790
11,12,8,5,5,5,46,3.765443063239311,6.579185877605936,801
11,13,13,9,23,6,75,4.079437092808213,6.3138738222012885,814
9,8,12,7,26,8,70,4.231433185286079,6.232879078363964,826
11,11,9,7,17,8,63,3.7430173504169035,7.158931941215652,827
8,10,12,7,13,8,58,3.3097582857348,8.170572836552594,848
27,6,14,1,11,7,66,2.9621236806158624,8.030990873124367,846
33,1,15,18,12,8,87,3.2650337859314242,7.717271925460691,838
24,4,15,21,11,7,82,3.016276030879324,8.216147325965046,823
9,5,1,4,8,11,38,2.7718489996688978,8.739988489089184,836
9,2,10,1,11,4,37,2.830201564245411,8.809293285830552,860
5,26,11,2,6,2,52,3.1275193176987552,8.476717381848573,878
9,29,7,4,8,2,59,3.292081980904298,8.39208237420063,889
5,31,6,3,10,6,61,3.232963915966442,8.605178772148967,907
9,27,6,4,16,8,70,3.2229441751123193,8.80009662938954,903
5,19,11,10,4,5,54,3.4762470391735976,8.324093937207856,910
8,18,9,8,8,8,59,3.581705651052983,8.208352399725372,914
16,21,10,10,6,6,69,3.5011061124356813,8.456841591148418,921
7,15,12,5,0,10,49,3.125094312661862,9.225985333947934,942
5,14,10,1,5,7,42,2.9754536849194633,9.664455046332153,964
2,5,8,12,9,8,44,2.8355983442827317,9.796313335118342,970
0,6,7,18,8,6,45,2.8738522644228053,9.855064939309447,985
1,5,10,14,10,6,46,2.889460300566252,9.855531229609712,993
1,7,9,13,7,9,46,2.838791026946275,10.429861525577916,1008
0,5,5,12,8,5,35,2.860290130028522,10.706425986656425,1037
2,6,5,12,7,9,41,2.811541262126331,11.045619402947843,1055
9,10,5,14,23,7,68,3.0103024442290685,10.88730716570374,1072
16,11,5,11,24,8,75,3.1011191660968156,10.391151430156343,1077
20,19,5,4,27,8,83,3.2210925791250453,10.27756131714776,1100
16,24,6,4,22,7,79,3.212120244251019,10.519407342702822,1114
11,15,13,17,14,8,78,3.224748873496763,10.836488951621524,1119
15,6,8,21,22,15,87,3.48668997146518,9.978200533677075,1132
14,8,10,18,30,18,98,3.5276387751001366,10.009199555914424,1163
10,6,7,10,22,11,66,3.2541904526887633,10.627522517534858,1166
11,8,10,4,13,13,59,2.996582053521492,11.00116716439178,1174
24,9,11,15,15,11,85,2.6840420469601303,10.93083481767063,1152
32,6,10,19,6,11,84,2.7205332246508735,10.803359762057719,1129
17,5,15,13,7,5,62,2.271963343850619,11.853578385593766,1111
5,3,11,6,6,6,37,2.079436124296831,12.484915124888296,1124
5,2,9,18,7,7,48,2.0946830321350176,12.60305855601177,1135
4,1,5,20,8,8,46,2.0855705072061075,12.766893773364906,1137
7,2,3,22,9,7,50,1.9791104535799604,13.200432646435829,1155
9,2,0,4,5,0,20,1.7700610148793365,13.848468775958032,1177
7,19,10,11,4,0,51,2.0497750606172187,13.307795253781451,1198
2,23,10,14,5,3,57,2.2896555278072444,13.010731163911924,1220
12,21,3,13,4,5,58,2.228809905625956,13.292677156794028,1221
6,18,1,9,5,9,48,2.1869942864226233,13.313926260240946,1236
6,5,6,1,7,11,36,2.051577839148938,14.190652569467332,1259
6,1,5,2,8,9,31,1.8965709005964324,14.413584350872393,1264
8,2,6,5,8,9,38,1.832632866656113,14.957392324311378,1296
6,3,5,12,4,10,40,1.817767396812808,14.660971015301474,1302
3,9,5,10,7,9,43,2.0425140904766406,14.506639552394391,1332
2,2,5,8,6,10,33,2.0205162090398723,14.944346070925839,1354
4,3,5,3,15,8,38,1.8990382220560944,15.164621225197378,1349
1,19,6,8,18,1,53,1.9057636050667912,14.741117957996929,1332
0,22,5,12,6,0,45,2.035075818657828,14.704120446448396,1335
1,21,12,4,0,8,46,2.0320680370196382,14.151851264142111,1331
10,27,7,1,21,10,76,2.217142955226415,14.004544414446482,1322
4,9,9,2,25,8,57,2.3034393260851243,13.826924166422524,1329
14,10,9,16,24,7,80,2.2135419984441618,14.092487301240931,1323
15,7,9,21,17,5,74,2.3430114604351346,14.069400498266871,1335
13,9,6,21,25,6,80,2.468390435503955,13.825608412429197,1337
12,11,12,18,14,5,72,2.4280222074440188,13.811058779103009,1343
10,11,16,22,9,8,76,2.1790545096873597,13.964969322120984,1340
11,12,12,3,5,7,50,2.1449467320692914,14.531553421707548,1363
11,8,12,2,7,7,47,2.1110738275116754,15.223294773380061,1365
12,9,11,14,6,6,58,2.197628124245379,14.851731807863372,1367
11,23,11,16,9,5,75,2.312683057977908,13.901474445460181,1362
15,30,5,15,6,2,73,2.517309417862797,13.389432382673942,1361
12,34,6,12,14,8,86,2.617843592649426,13.814747147831095,1358
10,26,5,13,7,6,67,2.3576943562865145,14.37227060364048,1380
6,19,5,14,7,14,65,2.281689111466716,14.593684688572337,1384
6,24,9,2,5,20,66,2.448371496505283,14.365602043505923,1406
32,21,7,14,6,20,100,2.637040042550434,13.85557998763788,1376
26,21,10,14,11,23,105,2.7647195469704506,13.398675447343361,1360
11,9,15,13,4,17,69,2.611252058824953,13.502194021516278,1347
6,9,10,4,3,18,50,2.461888643941278,14.004866094596508,1344
5,6,2,17,15,18,63,2.4064878002215,14.572992641222427,1358
12,8,9,18,12,13,72,2.3435600516047206,15.346954172537812,1373
14,10,9,8,11,6,58,2.1136031218855433,16.03613637841135,1393
8,24,6,3,12,7,60,2.109476026355731,16.157744453924188,1414
8,34,7,4,9,10,72,2.1726969719798888,15.725696749444362,1406
4,32,2,1,4,15,58,1.8981284145410573,16.15613349474518,1405
3,28,15,1,7,17,71,1.975780598397596,15.707088650443799,1406
4,17,10,1,7,14,53,1.9085378600511829,15.934551398393275,1401
10,16,11,2,6,12,57,1.8455344645119605,16.4691494450379,1427
5,7,6,3,6,13,40,1.6971251296014966,16.6160076694239,1452
16,12,5,3,2,1,39,1.520158420816122,17.572115246121577,1463
4,13,5,15,5,1,43,1.5084899466959587,17.545535584182844,1462
0,9,7,13,6,5,40,1.6046395338819766,17.62177244336762,1473
1,11,8,13,9,6,48,1.567648765029257,17.70828715191559,1480
2,10,5,14,7,5,43,1.4410645177041665,18.272635105347778,1492
3,2,10,6,4,5,30,1.3954632091891521,18.77610508640449,1509
2,2,8,17,5,5,39,1.3724533101527556,18.828168796952017,1517
3,2,5,20,18,7,55,1.659117080541657,17.786850755320163,1514
0,1,5,22,19,9,56,1.7885043744560782,17.51393859615379,1503
0,4,9,17,16,7,53,1.5200649714073764,17.75061347441903,1475
0,7,5,2,7,8,29,1.5886850316956533,18.285165414474218,1500
0,2,7,16,2,8,35,1.6949691144065033,18.054486576383464,1528
3,2,10,13,17,8,53,1.9169654621572145,17.38071662420159,1554
2,19,9,15,27,6,78,2.2850731931784445,16.50763190403681,1533
1,23,15,13,24,6,82,2.476063946169825,16.248830563049037,1549
5,23,13,16,7,4,68,2.526569905131957,15.613367521535826,1530
6,27,15,12,19,7,86,2.7253498300939305,15.69094231154153,1545
7,28,11,10,18,3,77,2.6119003871751127,15.687529372938922,1541
12,14,11,5,6,4,52,2.2530192984646082,16.108801972122826,1551
16,7,11,3,8,10,55,2.204578521609575,16.749969009999838,1570
15,7,12,4,18,7,63,1.9974191890901996,17.26962547342827,1575
15,7,7,3,8,5,45,1.8208052187900114,18.290516487486624,1607
14,9,10,4,11,3,51,1.6843638720286274,18.769043547671224,1614
15,17,11,3,13,3,62,1.8594724722802831,18.137896138585177,1616
10,24,9,11,8,4,66,1.9305664638312319,17.825652277525325,1621
15,26,11,16,5,7,80,2.0151995539395218,18.065000786500114,1620
10,30,10,16,9,6,81,2.055172402700529,18.466004526679463,1632
12,12,7,8,11,8,58,2.02109023057103,18.25355141905971,1642
34,7,5,2,19,5,72,1.936347585721158,18.244226747828787,1641
36,11,6,16,16,4,89,1.8133306730207872,18.23324378824741,1616
36,7,5,7,7,3,65,1.5727521605572656,19.529634927969784,1597
11,6,13,7,8,2,47,1.4711787322092487,19.969366959744633,1611
4,7,13,1,6,6,37,1.4639444368529475,19.86857054511873,1605
9,5,11,17,20,7,69,1.5382372831795956,20.12437722665402,1607
8,8,11,19,24,3,73,1.6247271429725125,19.817090757286902,1609
12,9,11,21,22,4,79,1.6575886351162121,20.381541586332833,1610
7,3,9,20,17,5,61,1.371432550945723,20.75749159166486,1611
13,1,1,9,17,14,55,1.3469624863674654,20.35430895626972,1613
9,1,1,16,11,16,54,1.4684702593372976,19.835505368035776,1624
7,0,4,14,12,17,54,1.51657501455218,19.770076775743938,1633
8,0,9,14,10,13,54,1.5912831751081107,19.9258139965832,1649
2,23,5,10,11,9,60,1.553403663834731,19.851461923696807,1635
16,31,5,1,10,2,65,1.7410345715604532,19.123858333706103,1652
8,37,8,3,30,3,89,1.9568044053908173,18.99460507873822,1658
14,32,11,2,15,8,82,2.136080298669014,18.558068776185994,1677
13,33,16,7,16,12,97,2.27413323077334,18.16137897597433,1679
14,27,15,3,8,17,84,2.3253562748456225,18.23045596624385,1687
31,30,11,17,13,13,115,2.3431886023963155,18.078870007546588,1666
20,12,11,17,12,10,82,2.279746437230011,18.098577518043818,1681
15,12,11,5,12,10,65,2.12573471955835,18.745286230682748,1692
15,9,4,2,13,12,55,1.9339797313494334,19.445077893228373,1693
8,11,6,13,15,3,56,1.795442698995255,20.01248794697967,1681
14,6,5,11,10,9,55,1.6044748967666274,20.672786498187957,1691
9,8,3,5,15,11,51,1.335226832835303,21.512613442318965,1676
10,9,3,3,15,15,55,1.1549915653074867,21.924571433124914,1682
0,20,1,5,7,9,42,1.148156277732147,22.15175285917641,1688
12,25,5,17,0,3,62,1.3347324899138233,21.40753778472016,1686
4,29,5,21,0,9,68,1.3931594956142395,21.089704532810206,1660
2,30,5,8,0,11,56,1.2671553351691498,20.99202334702651,1653
1,14,5,14,0,22,56,1.1519232328740818,21.644713844351063,1642
1,19,5,10,2,18,55,1.1446422129293015,21.490473884145345,1632
8,17,5,10,19,10,69,1.3154648717935589,21.227285198489557,1634
7,25,5,8,26,13,84,1.5841540748930905,20.20498282858256,1620
15,22,5,4,25,13,84,1.7603480668530007,19.997205641015203,1630
16,23,6,2,18,5,70,1.7716537138757464,19.953453270700113,1642
10,16,5,5,15,7,58,1.8312414000431911,20.070036089213676,1648
6,19,5,2,9,12,53,1.894351275379708,20.312736545041275,1675
17,22,5,5,6,8,63,1.7768163626026274,20.103408174696153,1677
7,21,6,3,6,14,57,1.5993954474104743,20.494989837372586,1694
5,15,9,15,5,12,61,1.5418699571485708,20.751594639086008,1696
12,11,4,12,7,14,60,1.5849691342326175,20.91232375906224,1710
13,12,7,15,18,16,81,1.7930266656292888,20.260125143397694,1710
13,12,5,11,16,8,65,1.834455842669073,19.822056636859934,1734
14,10,6,14,9,2,55,2.021650333552691,19.73443313029911,1776
14,17,5,13,8,1,58,2.1178974262840944,20.299743835078424,1807
10,20,5,10,3,9,57,2.0782178226794574,20.55011383773489,1830
10,10,6,14,0,17,57,1.9096642460500788,21.039736015305586,1844
10,12,6,17,0,15,60,1.8819690590653482,20.946966118290256,1848
11,12,5,16,1,12,57,1.6830725130498478,21.208596127161588,1856
9,12,5,13,5,7,51,1.5230122118278615,22.143395384257495,1868
13,8,5,1,7,4,38,1.3854484498451867,22.597585587782067,1891
7,8,6,12,9,5,47,1.2422410518410862,22.656143780628582,1888
6,9,7,8,7,8,45,1.2735812481790243,23.379894153270516,1928
0,7,6,1,10,6,30,1.2598351107062826,23.732711246261104,1959
20,8,9,0,18,7,62,1.266991991103027,23.97305494276722,1958
11,7,7,17,26,6,74,1.2862703006784872,24.128943542492127,1969
9,9,5,17,25,6,71,1.4101895033765237,24.480045435020333,1975
13,6,5,13,14,6,57,1.382454025651763,24.73376303161459,1999
13,1,9,10,10,4,47,1.3058331569058885,24.80866700827066,1989
10,5,13,7,7,9,51,1.273748182197184,24.71309349570955,2008
13,1,12,5,3,8,42,1.2462487405511686,24.878417319842082,2017
9,22,15,2,10,6,64,1.2692337914006973,24.461495384038507,2017
11,25,12,14,8,4,74,1.4584767312580427,23.67632609776893,2028
10,22,14,13,5,5,69,1.6057123853300086,23.52686904132715,2041
8,18,6,12,5,8,57,1.478351047117679,23.748419392099663,2050
11,20,6,9,7,7,60,1.4852836006097974,24.084797075079795,2059
9,24,6,12,9,1,61,1.538751813570249,24.081765356512005,2083
3,19,8,17,7,4,58,1.4615005892574882,24.51731215838019,2095
29,21,6,18,5,7,86,1.4927364269736338,24.67026390534597,2079
10,2,5,4,5,8,34,1.3624857051319956,25.370588766861577,2099
7,0,5,2,8,9,31,1.284060909074063,25.714564093483144,2110
6,2,14,12,6,9,49,1.254661002132605,25.354441146674166,2087
3,0,13,7,14,9,46,1.173303596091177,25.94024825774712,2094
3,1,14,7,9,9,43,1.2005283856061353,26.189501062176568,2113
5,6,12,2,12,7,44,1.2074478263095083,26.088468803260522,2107
5,7,10,16,13,8,59,1.195565101964821,25.79600656796803,2086
0,8,14,21,12,8,63,1.1823506974564162,25.27990716803659,2063
0,6,6,21,6,8,47,1.1688781016252316,25.670402925819786,2069
6,22,10,9,19,1,67,1.2444950515242428,24.5453762516693,2042
6,27,9,1,25,1,69,1.629794371348951,23.559408833221596,2049
16,28,9,13,26,8,100,1.76722658233883,22.86749408669034,2032
2,27,10,11,18,11,79,1.6927906168737656,23.048519473650273,2030
11,17,10,11,18,7,74,1.6505503941503135,23.03380794932837,2022
14,10,10,7,30,5,76,1.5855010191678478,23.51076788822563,2042
6,8,14,4,23,5,60,1.5325923552098786,24.444998291230164,2059
13,9,16,4,4,8,54,1.366316853929201,25.139217620673264,2073
32,9,14,18,10,6,89,1.5070387586947744,24.309562139037144,2066
31,7,15,9,12,6,80,1.5140103235569249,24.4711605179835,2046
21,10,6,3,17,6,63,1.3532315416826628,25.569430690717642,2038
18,9,5,4,9,8,53,1.263344828272489,26.225121787074386,2046
14,9,5,15,6,6,55,1.1706575996842954,26.704798891887336,2046
7,10,5,7,1,7,37,1.0241976241638175,26.999216799246806,2048
4,8,5,8,1,7,33,0.9351635444285482,27.202104791176584,2061
0,6,5,5,6,4,26,0.9039356067356966,27.62539563366631,2085
7,0,5,0,10,7,29,0.9151175474267477,27.46759052855274,2099
0,0,9,17,5,6,37,0.8875314568176398,28.10616072990455,2099
6,26,8,22,5,6,73,1.1002060174469546,26.752111865888875,2103
5,29,5,21,10,5,75,1.1390414695807385,26.67539781225167,2069
7,25,5,6,9,5,57,1.0524130734526784,26.99715344963021,2062
4,27,5,7,10,8,61,0.9645009367518134,27.573723455489233,2057
4,12,6,8,6,7,43,0.961923142232415,27.56235440103919,2072
4,18,8,8,7,4,49,1.018369838211943,27.583569686090357,2079
6,19,10,12,7,2,56,1.1247163696350262,27.445003486554064,2087
2,16,8,11,11,1,49,1.1473007278673237,27.408900204904345,2088
2,17,1,3,11,2,36,1.1553669305785967,27.276222816346216,2099
0,18,4,15,7,6,50,1.140357335001251,27.257731795693676,2107
2,16,5,17,0,4,44,1.311352454424139,26.017955004079493,2112
8,9,5,14,18,17,71,1.5015713538245574,25.07615661245048,2124
1,10,5,13,10,17,56,1.544510437142339,24.449351272605558,2111
2,12,5,13,11,15,58,1.5778223641641396,24.341214734928684,2115
5,12,4,7,18,15,61,1.552454470095239,24.801964827349043,2134
6,10,5,5,8,19,53,1.3747251332049106,25.382566221221772,2139
7,12,5,4,0,20,48,1.4088117759765852,25.53629329862028,2153
13,15,5,2,13,13,61,1.3898341414564803,26.559468040692565,2170
10,22,5,3,17,13,70,1.4748268200483055,26.018683240382053,2189
11,24,0,14,15,16,80,1.5103371879220862,25.869981848256124,2172
11,22,8,17,19,19,96,1.580533624707297,25.71758948250289,2157
32,15,10,10,6,18,91,1.6502286961877892,24.72693506927652,2144
28,9,12,7,7,17,80,1.5673572980536292,25.059847263109244,2139
10,7,10,5,5,19,56,1.3717286770391761,26.95239023166623,2158
2,11,6,2,6,15,42,1.2690293118293776,27.19740342873197,2185
10,9,12,1,16,17,65,1.383198492418165,26.72985376818031,2185
12,15,9,4,24,13,77,1.6345461162233395,25.838742005301974,2197
5,17,9,6,23,16,76,1.5788722520709684,25.832238614288165,2200
18,8,12,3,11,10,62,1.5119098334118442,26.266293187852582,2209
11,22,8,4,24,9,78,1.5812331507474984,26.586603547276514,2214
23,26,8,1,24,7,89,1.5523232995693184,26.085732078388066,2197
22,23,8,2,14,14,83,1.3943640151492656,26.167281719818842,2179
12,28,10,12,16,10,88,1.2822925770211901,26.95248472161713,2170
9,19,10,9,19,17,83,1.3849368474309944,26.897644459191245,2176
10,21,8,7,17,18,81,1.4690334665993554,27.000950977248785,2174
7,24,9,6,10,17,73,1.453953290461935,26.925934801051106,2199
7,17,10,8,3,16,61,1.3180831779703877,27.206696023393018,2180
6,14,10,2,1,13,46,1.2201365868141418,27.848393188330682,2204
12,14,9,1,0,12,48,1.0637329013389194,28.234077848597256,2209
7,17,6,15,4,12,61,0.9992349088420036,28.737011706155982,2219
13,13,5,21,15,13,80,1.0147507380085257,29.357626437435183,2214
9,8,7,22,16,13,75,1.0341696677559615,28.80472883272753,2198
29,6,5,21,24,9,94,1.051160423619574,28.556152706247623,2183
27,4,6,16,22,7,82,0.9355328410906543,28.376519550015644,2145
20,4,5,18,17,5,69,0.7763138178691341,28.67234774464304,2124
5,7,7,6,11,4,40,0.8011669086581331,28.89197742265461,2121
7,6,11,0,16,7,47,0.842760427779694,28.481308099001993,2128
1,20,10,2,10,8,51,0.9467400781111617,28.437324956123575,2138
4,21,13,15,7,5,65,1.2017055756900943,27.40757678685548,2141
2,22,12,17,8,9,70,1.387946659927645,26.697521109397993,2135
5,14,12,16,8,7,62,1.2532262029495815,26.97288238436547,2123
8,15,13,14,12,7,69,1.3050083416474938,26.972929662023507,2120
5,11,11,13,13,12,65,1.272052162368428,27.0061550900479,2134
3,11,7,17,10,7,55,1.2089148012282598,27.464506606050616,2158
2,14,9,4,8,10,47,1.1051261483455146,28.32754038535397,2175
2,13,9,15,19,4,62,1.0975486351504344,28.122942492424492,2177
11,9,9,12,22,5,68,1.1763030527993161,28.377405888069802,2208
8,8,6,19,20,6,67,1.100745053997229,28.73412179745432,2211
9,10,9,17,3,5,53,1.1897219875299803,28.628861102808994,2236
7,6,5,10,7,10,45,1.135853648510236,28.984894052138262,2254
8,7,5,5,7,11,43,0.9648812389838839,29.08656410619307,2273
2,12,6,6,4,12,42,0.9230751253114271,29.65309926060174,2293
4,5,7,6,3,11,36,0.8513979700659421,30.201735870856176,2293
8,3,5,7,15,4,42,0.7968788308133569,31.19035050151418,2297
6,4,5,7,9,5,36,0.8632733866856646,31.580626628982674,2320
3,19,5,7,10,2,46,0.8642957736205942,31.466694120065245,2311
9,21,6,8,3,1,48,0.923401602293502,30.439912252876688,2303
5,23,5,3,6,7,49,0.8632981138590975,30.914334319900583,2310
5,20,5,15,5,6,56,0.8643099793888461,30.515389590050656,2300
4,18,14,16,7,9,68,0.8950713999148122,30.164593841974185,2286
19,14,12,10,5,9,69,0.8571454221583198,29.603636765663687,2267
2,17,8,7,16,7,57,0.8567590696534545,29.571915052692862,2270
4,8,9,5,2,7,35,0.8528129547866167,29.775997230321874,2279
3,17,12,7,3,8,50,0.8551222223468412,29.852429117484576,2283
3,15,9,7,3,7,44,0.9086073323026754,29.83569379951099,2287
1,19,10,8,10,8,56,0.8343803839924854,30.05475574557636,2290
0,7,13,3,5,10,38,0.7242172493910755,30.081938701169726,2289
2,8,9,0,6,9,34,0.7806439458879159,30.191658622671813,2301
0,10,6,3,4,9,32,0.8423246592397925,29.847225185290874,2302
0,14,7,3,3,6,33,0.87030394827213,30.304718475902074,2307
1,7,7,0,0,5,20,0.8748145501551622,30.138028691656977,2304
0,11,5,16,0,5,37,0.8633458974487473,30.12818333633307,2314
0,9,13,14,0,6,42,0.9184125445787306,29.783949631882265,2310
0,5,16,14,6,5,46,1.0038550131852477,29.536084715126613,2308
14,7,15,13,8,5,62,1.165235382301617,28.691062855596773,2297
1,6,15,9,6,5,42,1.1840627892698026,28.92820936516901,2311
2,16,15,8,10,5,56,1.113156484053135,29.12409072041831,2318
5,14,16,6,0,3,44,1.160059245424884,29.237453890582096,2335
5,18,15,5,0,9,52,1.1533178952447067,29.950069096242903,2350
5,18,8,9,0,8,48,1.0894476684963024,30.407572016906993,2370
10,10,7,8,1,6,42,0.9733737886620827,30.745288411030963,2369
11,14,10,7,10,5,57,1.0166625431777934,30.58475272239113,2380
8,15,11,9,8,6,57,1.0135154480629007,30.49948918411644,2388
9,13,11,6,7,5,51,0.9741169537272735,31.173294287793013,2405
7,14,6,11,7,1,46,0.9520712954336641,31.46703398146836,2410
6,10,6,14,14,2,52,0.985255859780609,31.303468648111103,2415
6,7,5,15,7,5,45,1.0812742738454935,30.974901273115957,2438
4,7,5,12,2,4,34,1.0590504985739122,31.49521572605326,2449
25,11,6,1,4,1,48,1.0082207829621432,32.13029283865658,2467
7,9,9,1,7,0,33,1.0320398522955925,32.31954163332691,2477
10,7,11,0,8,4,40,0.9775454631765241,32.364603477408444,2497
12,7,10,1,10,3,43,0.8614288986875586,33.250694328387645,2529
6,7,6,0,11,4,34,0.925294561585304,32.84038428384463,2542
9,12,7,1,8,6,43,0.8594368718360298,32.8641051711546,2540
7,15,6,0,4,4,36,0.8197523139582331,32.95994753771724,2533
3,12,8,9,8,4,44,0.8073084443331947,33.06044140450882,2511
6,4,5,9,22,3,49,0.9422133533564797,32.15561627401969,2527
9,1,6,8,19,4,47,0.9559669032079369,32.50596975978889,2524
5,4,5,13,7,7,41,1.002035125026728,31.78087779527463,2544
9,4,5,11,0,3,32,0.9885707794008828,31.911924006114422,2559
9,2,5,9,4,1,30,0.9897234878674346,32.466942660832785,2574
5,1,4,11,11,5,37,1.025055113471364,32.56059651746646,2594
11,4,7,11,9,4,46,0.9877166114588348,33.13726074592381,2600
7,8,9,7,5,4,40,0.8089740824459488,34.06187501714795,2604
8,3,2,3,4,4,24,0.7584449658346099,33.68272232637193,2616
9,8,5,6,14,6,48,0.751707100919527,34.22504107994827,2626
7,4,5,4,9,3,32,0.7895222903604958,34.081770291172276,2633
10,3,5,2,3,3,26,0.7501292465268489,34.93887745780073,2653
12,0,8,11,8,2,41,0.7162959202114476,35.776922121522254,2664
12,5,3,13,9,0,42,0.7671997454649264,36.06126309776256,2690
10,1,6,15,9,1,42,0.7953762546990949,35.5262970276958,2693
7,2,6,13,12,3,43,0.7905557373680367,35.248811132897295,2696
6,2,6,15,3,0,32,0.8065390673362205,35.32602522830343,2696
5,1,6,10,6,0,28,0.7720911446510452,35.39808481486684,2712
12,2,5,14,15,0,48,0.7972894715337389,35.34061075085372,2701
6,2,5,8,17,0,38,0.7656179081284332,35.63754393915431,2702
29,3,6,6,11,0,55,0.7922967786461445,36.05599455647069,2692
8,3,9,3,14,0,37,0.7382678301965657,35.98096879525415,2698
7,1,10,1,14,0,33,0.7005206635424139,36.84951901432897,2701
9,0,8,2,15,0,34,0.606188811070519,37.76399158751156,2712
6,1,14,2,9,0,32,0.593213097058393,37.56590745999018,2710
10,0,13,16,23,0,62,0.8289722460442807,36.37390796618896,2726
6,2,8,17,18,0,51,0.8553588351582673,36.40342303878084,2732
6,7,8,15,16,7,59,0.8340082152007594,36.387930674805645,2736
10,6,4,9,9,7,45,0.7793725705633088,36.57435674936041,2732
10,9,8,8,16,11,62,0.9141830489280854,36.063473490956476,2738
9,8,7,11,14,17,66,0.9146066938495279,36.09123604859082,2740
4,10,8,8,14,13,57,0.9229959352295157,35.54485218804317,2743
4,12,11,12,8,12,59,0.9404988835864713,35.57765137284991,2736
5,9,9,9,2,13,47,0.8701889929352543,35.75057062460899,2741
32,10,12,6,5,11,76,0.8602633696347299,35.85774490477832,2725
0,8,10,6,9,11,44,0.802704709867978,36.195217177754536,2723
2,6,7,11,12,8,46,0.7842104067959661,36.89937998532886,2738
23,6,3,10,20,6,68,0.7666563370784238,36.741741419993886,2738
18,17,5,10,11,6,67,0.77054761160502,36.42964172271721,2726
3,20,6,14,11,8,62,0.8450308025175988,36.310214169004034,2729
4,22,5,15,11,9,66,0.8736293919520799,36.25870343939804,2713
0,15,5,12,14,20,66,0.7999369082589345,36.34612385431758,2712
0,10,6,6,9,13,44,0.7431974033746059,36.44128399057788,2713
0,12,5,5,6,16,44,0.7122129439199506,36.917166819083526,2721
0,8,5,7,3,11,34,0.7188502070007933,37.399454470396606,2737
2,7,5,8,16,11,49,0.6740120763626497,38.26510287679783,2750
14,7,15,12,12,8,68,0.6813480148231674,38.460232341095484,2760
0,10,5,6,7,9,37,0.671862376254247,38.656226509388404,2778
15,4,7,6,10,4,46,0.7050826186841803,38.68910504484602,2800
8,5,9,3,9,8,42,0.749815793209355,38.2629784323481,2817
11,14,7,7,10,5,54,0.8492364125462925,37.30641816059767,2809
11,14,9,3,12,4,53,0.900679339204563,36.780109621348664,2810
8,14,6,0,8,4,40,0.7609576628860152,37.499609956331646,2813
3,8,10,2,22,5,50,0.7198310695719546,38.064795724616324,2823
5,6,11,7,13,7,49,0.7059445608478123,38.88072040710387,2838
1,9,5,5,3,8,31,0.6740396564321033,38.95138792193609,2852
2,15,5,6,1,5,34,0.6855478799640629,38.889726900328824,2852
0,15,5,6,12,7,45,0.7014700133147739,38.22110011716638,2853
3,17,5,6,7,7,45,0.7761231976554399,37.93423053610515,2872
2,16,6,10,6,6,46,0.7079190129026313,38.868392951319706,2876
1,10,9,5,6,7,38,0.7769815129801055,38.4765533877912,2888
1,17,5,7,3,7,40,0.7366066975035546,39.03723932902432,2885
23,14,6,9,4,6,62,0.6958654804785603,39.043039856267136,2868
0,12,4,10,0,7,33,0.6838953373460808,39.418672100028466,2882
0,11,5,17,0,6,39,0.634216802923075,39.749768690440554,2885
0,15,5,20,11,5,56,0.6183293830668487,38.801610432521834,2857
2,11,7,15,11,5,51,0.6420061566108883,38.92137164251866,2857
0,8,12,15,8,2,45,0.6063079712042749,39.29287474213744,2850
0,9,17,12,5,2,45,0.6581233748017976,38.79482689819658,2846
1,8,9,16,2,0,36,0.6998996550439063,38.17091465494342,2862
0,12,12,12,0,4,40,0.7478513871244192,37.54688979233019,2866
0,13,12,9,0,5,39,0.7477613466566772,37.41798086955515,2877
0,13,11,5,0,8,37,0.7604363045251252,37.10618674959781,2885
0,12,12,4,7,6,41,0.8096437614192116,37.618186200394895,2905
0,15,10,8,7,11,51,0.74020548744893,38.082911291997256,2904
1,16,8,9,4,15,53,0.6884390537298728,39.335941003726916,2918
11,18,5,6,5,13,58,0.6526822075812962,39.117883971828185,2916
0,16,4,14,0,7,41,0.6370825148581248,39.73369408304791,2934
0,7,5,16,0,6,34,0.6189562171470173,40.0959788276577,2944
0,3,5,15,0,7,30,0.648971724720583,39.81889548516558,2961
0,4,6,12,0,7,29,0.6075651866183779,40.16093654214342,2961
0,2,5,12,9,5,33,0.6794323943293156,39.73403090846421,2957
0,4,5,11,4,5,29,0.6994898850750983,40.03637478727097,2975
0,6,6,12,7,7,38,0.6460445113784995,40.24226255586433,2990
1,7,5,10,5,6,34,0.5610020250328303,41.21996781659336,3003
1,4,3,7,0,9,24,0.5792544342661949,41.795048331455185,3034
0,0,1,8,0,6,15,0.4864166862856136,43.12631452030169,3053
0,1,1,7,0,6,15,0.46609367483331937,43.631720388283945,3064
0,0,1,5,0,7,13,0.4484782522040069,44.54456043063348,3092
0,0,3,8,10,5,26,0.4497121744897038,44.714752981927106,3093
8,0,1,13,9,8,39,0.536919905289446,44.161011443971766,3108
3,0,3,15,7,9,37,0.4951654874257013,44.57136387561408,3120
3,0,2,7,6,9,27,0.5503710973027388,44.716493647914,3134
0,0,0,5,0,7,12,0.47011674190187924,45.73505964254094,3171
0,16,1,5,0,0,22,0.39634426691086777,46.79568530374204,3194
1,20,0,5,0,0,26,0.4156275895505078,46.24670018900642,3205
0,20,0,6,0,1,27,0.35387230865551805,46.74100724305675,3217
0,20,0,1,7,6,34,0.41033136096241346,46.797872211440826,3242
0,0,14,2,8,6,30,0.28946093574522797,47.30950089476003,3256
2,0,12,3,6,6,29,0.29423065507433915,47.481824995405916,3271
2,0,10,1,6,8,27,0.33919777872939777,46.83434688108318,3269
4,0,9,1,0,9,23,0.30751229820351034,47.14444297585965,3265
1,3,5,2,0,8,19,0.2677471195205071,48.23828787557225,3276
1,4,5,14,0,9,33,0.30256210738177414,48.08952319912781,3277
15,0,5,9,0,9,38,0.34840004822772236,46.89555186198999,3262
0,0,5,6,7,6,24,0.35915509003568424,46.63196608222089,3271
2,0,6,7,9,9,33,0.3713064220555824,46.4869019826242,3273
2,15,8,6,5,4,40,0.43726879197984203,45.56222596522742,3268
3,14,7,6,6,0,36,0.46896610037526604,44.703561419422336,3261
3,10,5,9,0,0,27,0.4551820543918562,44.58124769195884,3250
0,10,5,15,0,1,31,0.364903848367601,44.90998003252757,3226
0,5,9,7,0,8,29,0.4089357710185999,44.58129792079269,3217
0,6,4,9,0,7,26,0.430700636199495,44.2489354150567,3215
0,4,0,7,9,2,22,0.4528915066948244,44.150074377943966,3198
0,6,1,6,13,5,31,0.4732773262027332,43.671368124348085,3193
0,4,4,12,15,6,41,0.6257879800896394,42.193264380309564,3178
1,8,9,12,5,6,41,0.6336588419447708,42.00771444952723,3163
1,5,5,14,16,4,45,0.6706402490501174,41.11922798620706,3138
10,5,5,15,15,5,55,0.730661411423974,40.074730811446415,3084
0,7,1,14,12,2,36,0.7580157258702994,39.54271400308304,3058
4,8,5,15,9,4,45,0.7037593068770773,39.459428883934635,3021
1,7,6,14,11,1,40,0.6293779897164035,39.661768031763465,2992
4,6,5,11,14,0,40,0.6031021807560473,39.96706735302413,2978
0,6,10,14,9,0,39,0.5693196615049547,39.8804316688559,2974
0,4,5,9,0,0,18,0.4816785293320269,40.80271915721227,2978
0,1,5,4,0,0,10,0.4619380726289731,41.125868519033254,2986
0,0,6,12,0,0,18,0.4671648957325701,41.66258069339404,3007
0,0,8,17,0,0,25,0.5255214217750795,41.442659525717204,2998
0,0,12,17,11,0,40,0.6026830958876996,41.269162149901874,2988
1,0,12,9,11,0,33,0.5700147401748371,41.50890454549521,2985
0,0,11,9,9,1,30,0.5399244878963289,41.984483513786344,2994
2,0,11,8,10,0,31,0.517272569269266,42.15937371353758,3003
25,8,12,11,0,0,56,0.49920697356534477,42.387952515831074,2995
0,7,10,10,0,0,27,0.42860381748767723,43.102644201225424,2997
0,6,6,5,0,0,17,0.4432024536690347,43.17825219232045,3016
0,6,6,6,0,0,18,0.43910265857594005,43.4605261978495,3021
13,8,10,7,15,0,53,0.4974247985384998,43.09904173583013,3024
10,2,9,6,25,0,52,0.4906457458964294,42.91278027333828,3018
17,0,7,6,14,1,45,0.5076662475552703,43.03299390495525,3017
10,1,5,9,20,0,45,0.5557761762617883,43.25417901626854,3057
0,2,9,9,2,0,22,0.47866058663332567,43.383428085673394,3076
0,1,5,11,5,0,22,0.47396364182075085,44.29277076958066,3101
0,0,5,6,1,0,12,0.4754390219009329,44.70325079628792,3110
1,0,6,9,1,0,17,0.5100103727354375,44.49307641878311,3121
16,0,7,8,21,0,52,0.4974038921970592,44.813563446329994,3122
4,1,9,2,15,0,31,0.40890366362296005,45.38845628968997,3132
17,0,5,8,12,0,42,0.3417693953723528,45.97646181682178,3138
6,0,5,9,6,0,26,0.3248689835989996,46.164656547634074,3151
5,0,4,11,6,0,26,0.3613912636197369,46.23877297119098,3156
5,1,5,8,5,0,24,0.4089910219756124,45.639564769503714,3176
8,0,4,2,4,0,18,0.42946707961970504,46.43250907720907,3198
12,0,9,4,5,0,30,0.42100758431565327,46.347857436425834,3216
12,0,7,10,7,0,36,0.4631874548396399,45.77039927691526,3213
4,0,11,0,11,0,26,0.49362715184942113,45.177619230814614,3209
16,5,11,0,5,0,37,0.5122962485955882,44.859088051642345,3198
10,5,7,0,6,0,28,0.4817108103474567,45.3575179667923,3230
7,3,5,11,6,0,32,0.4587740702390474,45.55780714321213,3226
3,2,5,2,17,1,30,0.4369934468837528,45.576257678545545,3226
1,3,7,0,15,0,26,0.4483432881166689,45.745335010173605,3235
10,4,10,0,13,0,37,0.4994039495463521,45.398161942773186,3233
5,4,11,4,10,0,34,0.514205465548673,45.561072874287845,3253
1,4,9,0,8,0,22,0.4774416639993215,45.70265620025194,3259
4,4,10,0,7,0,25,0.5146259443600546,45.84280789141948,3266
2,6,11,0,7,0,26,0.5287315862302607,46.30027672557239,3282
3,6,10,0,9,0,28,0.49213447158521834,45.933270650690126,3288
3,6,10,0,5,0,24,0.44655583999521226,46.82031397612953,3293
3,11,8,3,8,1,34,0.444625017720886,46.98627330752135,3310
2,10,6,0,8,0,26,0.4449893495454835,46.99132049373919,3326
3,10,1,0,15,0,29,0.4678693020805668,47.58635933760701,3351
1,13,5,0,19,0,38,0.5488488984455346,46.63564270053947,3346
6,11,5,0,21,0,43,0.6540804634855042,46.88627368018109,3368
5,9,5,0,12,0,31,0.5642295611263555,47.58175456115662,3389
9,12,6,0,4,0,31,0.5603366462094155,47.65547948493442,3402
9,12,4,0,0,1,26,0.5181364984765587,47.64285897033136,3413
7,4,11,9,0,2,33,0.48870973116890487,48.53374735396039,3433
7,6,10,1,0,6,30,0.4664851327301508,49.31090984899,3447
18,5,10,0,17,5,55,0.5310594520192862,48.703576685322844,3443
9,6,11,0,11,3,40,0.5222260296335673,48.03191167547605,3452
8,6,10,0,5,6,35,0.5590463404892281,48.08620400926523,3475
7,6,10,0,4,6,33,0.5239328452940072,48.62159091498865,3488
11,6,7,0,9,6,39,0.5527211504477643,49.16340481165764,3511
10,7,6,0,5,8,36,0.5835495664421263,48.662615073083586,3528
8,10,6,0,10,0,34,0.6769736366727854,48.12739016401994,3536
6,15,6,2,8,4,41,0.7145199380077759,47.78146079010878,3549
6,11,7,0,12,0,36,0.7238891197492798,48.16925739682075,3569
8,15,6,0,8,9,46,0.6748535950241673,48.43193638434541,3589
12,4,2,3,6,2,29,0.6999571499067078,48.20506589717841,3614
12,0,7,0,8,14,41,0.8012785407974696,47.790301100990455,3635
12,0,14,0,7,13,46,0.7266990128334396,48.84919576025105,3658
8,4,11,0,7,6,36,0.6442023559932925,49.21038967655573,3658
22,5,12,0,17,5,61,0.6911007261777303,49.35893466617507,3664
9,8,10,3,5,6,41,0.7091047878480572,49.4805097640363,3659
13,7,11,0,0,0,31,0.6162662958631747,49.63903231710561,3677
9,6,13,0,6,5,39,0.6283912781854749,49.88472086394212,3687
14,0,13,0,17,0,44,0.5711622758686596,50.074529961752674,3697
13,0,16,0,20,0,49,0.5701219815979457,50.05461543835645,3699
6,0,15,0,11,6,38,0.4869426282716813,51.14516689703338,3700
9,0,15,0,15,0,39,0.5043986530467317,51.23585809899081,3709
8,0,15,0,17,5,45,0.5245603155622385,50.8503512780553,3705
16,10,8,0,12,7,53,0.5482969906895478,50.63432512404033,3703
11,10,6,0,18,1,46,0.5194929525492721,51.04956805253386,3711
32,11,7,0,9,5,64,0.5559032866103705,50.37743288404084,3694
27,6,8,0,11,0,52,0.5227281509083519,50.98653518936462,3672
2,12,6,0,11,6,37,0.5157034143295689,50.41739593580381,3680
30,20,6,0,3,0,59,0.4818831997018608,51.54865393414961,3679
17,12,6,0,9,15,59,0.4400775879112989,51.814032253845866,3656
8,6,7,0,8,4,33,0.44876763001098474,52.34351739918903,3673
8,0,9,0,7,18,42,0.45580886496106554,51.728929948706686,3673
11,0,6,0,6,4,27,0.4268680061437436,52.29660298423024,3698
10,0,5,0,7,13,35,0.4361154200879832,51.59487245566858,3689
12,0,3,0,13,2,30,0.45912331565212194,51.27774671913073,3689
5,0,9,0,10,7,31,0.4862323752064578,51.843033869173055,3703
7,0,7,0,6,0,20,0.41393438147203226,52.46585236006914,3710
7,0,5,0,8,5,25,0.3815315517255862,53.11813654229753,3707
3,0,5,0,7,0,15,0.37739870309475676,52.96095124152522,3713
2,0,10,0,11,6,29,0.4073717820958866,52.87859723917711,3715
5,0,12,0,11,0,28,0.4663227839187906,52.56207151418697,3712
9,0,12,0,6,6,33,0.4255209712964836,53.51025900260413,3700
5,0,6,0,13,6,30,0.38836127976519075,53.24009948498047,3694
21,0,5,0,14,0,40,0.3544387368803335,54.251901182296336,3691
5,6,5,0,9,5,30,0.34011798891870504,53.657737016693844,3684
6,5,6,0,8,0,25,0.28879453665308863,54.22849897582204,3687
5,5,4,0,1,6,21,0.26672523163997397,54.169279247176746,3677
5,7,5,0,0,0,17,0.2098560585897535,54.580614164718384,3672
4,6,2,0,2,5,19,0.24128278984635146,54.764739837181516,3679
12,2,5,0,4,0,23,0.2148467502123191,54.99132326441849,3685
8,3,10,0,7,6,34,0.22437961184110666,55.05692626849275,3681
7,1,10,0,4,0,22,0.25253247801190587,55.12221164478189,3690
7,0,10,0,5,6,28,0.35128813212992743,54.22874489054234,3680
11,0,11,0,1,0,23,0.38149578136574497,54.10119800078035,3692
14,0,11,0,8,6,39,0.4433758556717844,53.53152698418741,3696
11,0,7,0,10,0,28,0.4977919289964563,52.488842252607995,3719
9,0,11,1,11,6,38,0.5547321861946112,51.713594873785674,3720
6,0,10,0,7,0,23,0.5360191535212026,52.146549823211586,3732
21,0,9,0,2,2,34,0.5482228188096634,51.87713998892008,3739
12,0,11,0,14,0,37,0.5017937435957045,51.79379947640657,3732
10,0,10,0,12,0,32,0.5186923223050258,51.59471954815125,3743
4,0,7,0,7,0,18,0.4019391100696825,52.68635418626262,3753
1,0,6,0,0,0,7,0.38776589686616975,53.38310616026087,3771
1,0,5,0,4,0,10,0.34116678219625873,53.68250497949693,3778
0,0,6,0,0,0,6,0.29829913659489665,54.64367766629869,3791
0,6,7,0,0,0,13,0.26611070695493794,55.52420151523611,3790
0,4,11,0,0,0,15,0.24369999546095425,55.88542292324668,3783
0,0,2,0,12,0,14,0.23438320727316184,55.73163326645378,3779
0,0,0,0,12,0,12,0.20714919992561712,56.23321723341706,3786
0,0,0,0,11,0,11,0.19379480901870547,56.724532244642205,3773
0,0,3,0,8,0,11,0.15160420937482957,57.02286732933146,3776
4,0,5,0,7,0,16,0.11374291186616355,57.49658844489918,3778
5,0,6,0,6,0,17,0.11659816676963801,57.81043870100292,3771
2,0,5,0,2,0,9,0.12155961412886865,57.694427665653556,3773
0,0,7,0,1,0,8,0.13297797168589057,57.71615717763128,3778
1,0,6,0,4,0,11,0.1135428655080523,57.89252996876029,3778
0,0,7,0,1,0,8,0.11278433188212966,57.54584682534294,3781
1,0,6,0,1,0,8,0.12557803807129192,57.79352992779534,3791
4,0,5,0,2,0,11,0.1260361054423787,58.319458348345556,3794
2,0,15,0,5,0,22,0.1063110890682089,57.98192865876912,3779
0,0,15,0,0,0,15,0.09225704512624301,58.12222926561452,3774
0,0,15,0,0,0,15,0.05858437539497739,58.74998693717932,3773
0,0,9,0,0,0,9,0.039557754428050776,59.07863476760136,3773
0,0,10,0,0,0,10,0.039542552004898195,59.18888100853618,3777
0,0,7,0,11,0,18,0.10051449288265311,58.7170656463747,3786
2,0,3,0,15,0,20,0.09298054027374242,58.336476460362626,3778
4,0,0,0,9,0,13,0.07989041968327024,58.53926357468671,3784
24,0,0,0,0,0,24,0.056012771501109844,58.94298538206893,3775
12,0,0,0,4,0,16,0.048851542988598784,58.82420337431409,3761
0,0,0,0,0,0,0,0.04501765353139076,58.84483119553911,3765
0,0,0,0,0,0,0,0.054161426812032475,58.89986423166651,3770
0,0,1,0,0,0,1,0.05594220060405171,58.99764381370168,3773
0,0,0,0,0,0,0,0.05869054727107062,58.94999656425114,3773
0,0,0,0,0,2,2,0.05090406661310739,59.01728525212841,3776
0,0,0,0,0,0,0,0.0486830293033399,59.28679781771638,3786
0,0,0,0,0,0,0,0.03233050702767119,59.56261544016376,3790
0,0,3,0,0,0,3,0.027037489128511144,59.830508084382856,3797
0,0,0,0,0,0,0,0.03041117626337627,59.93308960142702,3806
0,0,0,0,0,0,0,0.0129002207757744,60.09447540078637,3809
0,0,0,0,1,1,2,0.01414145182065016,60.17093241744002,3815
1,0,0,0,0,0,1,0.012106555755587058,60.21758313717854,3816
0,0,0,0,6,0,6,0.029672879215330558,60.2112627800609,3819
6,0,0,0,0,0,6,0.01180079610274165,60.226122118985344,3816
0,0,0,0,0,1,1,0.013773596996570095,60.29872241412854,3819
0,0,0,0,0,0,0,0.020255065893993045,60.32990530728198,3826
0,0,0,0,0,0,0,0.017234172958883093,60.42494309094463,3828
0,0,0,0,0,0,0,0.01669447883290957,60.46550409862783,3832
0,0,0,0,0,0,0,0.006935953139508698,60.50669393101957,3834
0,0,0,0,0,0,0,0.008047143673487554,60.61637215057723,3840
1,0,2,0,1,0,4,0.03061501772948019,60.61374265359942,3844
0,0,0,0,0,0,0,0.021880263948338193,60.71814019179169,3850
0,0,0,0,0,0,0,0.027516445304753438,60.81918433339931,3858
0,0,0,0,0,0,0,0.013031606088424423,60.92450242100465,3861
0,0,0,0,0,0,0,0.009670894621650732,61.00898340360713,3866
0,0,0,0,0,0,0,0.010917657206595847,61.055927215406186,3868
0,0,0,0,0,0,0,0.012365365283680287,61.08702899831549,3872
0,0,0,0,0,0,0,0.018234476505644793,61.143560534718105,3878
0,0,0,0,0,0,0,0.010618087938496985,61.215867600179095,3881
0,0,0,0,0,0,0,0.0037415927263684434,61.28860091363389,3883
0,0,0,0,0,0,0,0.013931045190118297,61.304168479052336,3887
0,0,0,0,0,0,0,0.010804578959755734,61.38644709735298,3891
0,0,0,0,0,0,0,0.009800597240047315,61.43345490113101,3894
0,0,0,0,0,0,0,0.011424960807172287,61.48031613000419,3898
0,0,0,0,0,0,0,0.007285488953975218,61.542831898847325,3901
0,0,0,0,0,0,0,0.01598837794425688,61.61569523033283,3907
0,0,0,0,0,0,0,0.02187910100183793,61.66027072193766,3913
0,0,0,0,7,0,7,0.03163068847046355,61.63130593210562,3915
0,0,0,0,0,0,0,0.009831943843488174,61.8114669781873,3918
0,0,0,0,0,0,0,0.008747638631214392,61.85289698299645,3921
7,0,0,0,0,0,7,0.013550406428873115,61.798461950406804,3918
0,0,0,0,0,0,0,0.0038331957919607563,61.89287833282826,3921
0,0,0,0,0,0,0,0.002279597738615309,61.94938944789875,3924
0,0,1,0,0,0,1,0.005704875305734505,62.01696601306242,3928
0,0,0,0,0,0,0,0.005850394636344817,62.032514072495644,3929
0,0,0,0,0,0,0,0.008544151221423204,62.081978540281604,3933
0,0,0,0,0,0,0,0.008877377450515813,62.081888622006105,3934
0,0,0,0,0,0,0,0.005233474018054705,62.12873982734526,3935
0,0,0,0,0,0,0,0.011698566051457448,62.16083187740528,3940
0,0,0,0,0,0,0,0.006290824179323651,62.2076661895081,3941
0,0,2,0,0,0,2,0.014776821853119168,62.1972377897413,3942
0,0,0,0,0,0,0,1.692228211071e-05,62.27551466333245,3942
0,0,1,0,0,0,1,0.0043058374764627745,62.27541568278473,3944
0,0,0,0,0,0,0,0.006780934987041907,62.27531686451181,3946
1,0,0,0,1,0,2,0.012032699501575459,62.29088293103494,3947
1,0,0,0,0,0,1,0.0029490460983208054,62.322073580647476,3946
0,0,0,0,0,0,0,0.00567104830781667,62.32708112106171,3948
0,0,0,0,0,0,0,0.0051162690140443565,62.35826339704574,3950
0,0,0,0,0,0,0,0.009013080924759862,62.35816334651586,3952
0,0,0,0,0,0,0,0.0023892196822012882,62.42565560875483,3954
0,0,0,0,0,0,0,1.1161276267894594e-05,62.441239617999415,3954
0,0,0,0,0,0,0,0.00273717439338733,62.44114480843211,3956
0,0,0,0,0,0,0,0.003100312277817712,62.45669561993413,3957
0,0,0,0,0,0,0,0.0035972704836108875,62.48789616007115,3959
0,0,0,0,0,0,0,0.0061412382056833985,62.51908823689903,3961
0,0,0,0,0,0,0,1.2788653349283641e-05,62.544982004264675,3961
0,0,0,0,0,0,0,1.1832181146833605e-05,62.56592468118615,3963
0,0,0,0,0,0,0,1.0715111490452893e-05,62.56590032886732,3963
0,0,0,0,0,0,0,1.2331821384766148e-05,62.56584654388507,3963
0,0,0,0,0,0,0,0.000687646171652719,62.56581654600693,3964
0,0,0,0,0,0,0,0.005793331736780175,62.581433656270924,3967
0,0,0,0,0,0,0,0.004754324340074839,62.6282955255239,3971
0,0,0,0,0,0,0,0.011510812565294423,62.65956368919729,3975
0,0,0,0,0,0,0,0.00304573608667604,62.69826991721234,3973
0,0,0,0,0,0,0,0.0033709983255636846,62.72499876551272,3976
0,0,0,0,0,0,0,0.0021711094715339122,62.75618074992635,3977
0,0,0,0,0,0,0,0.005907468510432653,62.77178269872354,3979
0,0,0,0,0,0,0,0.01430514144191189,62.771746633127634,3982
0,0,0,0,0,0,0,0.0021879373754765488,62.84052988174113,3982
0,0,0,0,6,0,6,0.015523283283984876,62.77507128520841,3982
0,0,0,0,0,0,0,0.0021359402263620604,62.85011534738986,3984
0,0,0,0,0,0,0,0.0038277969057793075,62.88135166853404,3986
6,0,0,0,0,0,6,0.009271232744872867,62.85290762850867,3986
0,0,0,0,0,0,0,0.008048616632931495,62.91006528147723,3989
0,0,0,0,0,0,0,0.002919900215971841,62.98288921886519,3992
0,0,0,0,0,0,0,0.004265472487611492,63.01912052478703,3995
0,0,0,0,0,0,0,0.0057692569920641925,63.01903534718276,3995
0,0,0,0,0,0,0,0.006434703064443407,63.029267922524014,3997
0,0,0,0,0,0,0,0.000830455889341406,63.06259425614137,3998
0,0,0,0,0,0,0,0.011001756533599,63.10991608395492,4004
0,0,0,0,0,0,0,0.014338431835041666,63.12501136316678,4007
0,0,0,0,0,0,0,0.004073391052820239,63.14270329022345,4005
0,0,0,0,0,0,0,9.287606230923027e-06,63.193657977348096,4005
0,0,0,0,0,0,0,1.0656458465843332e-05,63.193604229206755,4006
0,0,0,0,0,0,0,0.009937121834255188,63.19352945756995,4009
0,0,0,0,0,0,0,0.0037821587169228027,63.21942039019289,4009
0,0,0,0,7,0,7,0.02296820780988811,63.138032105063935,4009
7,0,0,0,0,0,7,0.003051632543664947,63.163932941230094,4004
0,0,0,0,0,0,0,0.0030398749704874336,63.163864564894894,4004
0,0,0,0,0,0,0,2.499908869945695e-05,63.17950218815482,4004
0,0,0,0,0,0,0,0.0020395349880298814,63.179352731672104,4005
0,0,0,0,0,0,0,0.007470458969606061,63.179285276637,4007
0,0,0,0,0,0,0,0.005920585854351279,63.21055886919365,4008
1,0,0,0,0,0,1,0.004447145020133095,63.236617635764,4010
0,0,0,0,0,0,0,0.0028801523947769546,63.26270162665756,4011
0,0,0,0,0,0,0,0.0006338090049658877,63.262472950548805,4011
0,0,0,0,0,0,0,0.004859240088778822,63.27808827920481,4013
0,0,0,0,0,0,0,0.003370504417417597,63.27803012847745,4013
0,0,0,0,0,0,0,9.346735441754329e-06,63.293619594565065,4012
0,0,0,0,0,0,0,8.991382619514914e-06,63.30017952156166,4013
0,0,0,0,0,0,0,0.005670285086368918,63.30010249415763,4015
0,0,0,0,0,0,0,7.505587272547844e-06,63.3103669523672,4014
0,0,0,0,0,0,0,0.00014567567817436153,63.31031901901791,4015
0,0,0,0,0,0,0,0.0019008805250148445,63.317698751292674,4016
0,0,0,0,0,0,0,0.0009397849739925351,63.32507421178782,4017
0,0,0,0,0,0,0,8.127299325836407e-06,63.36161623458645,4019
0,0,0,0,0,0,0,5.657666595773327e-05,63.3694676390681,4021
0,0,0,0,0,0,0,8.058870152685781e-06,63.38507041097226,4021
0,0,0,0,0,0,0,7.843594053147832e-06,63.38500969223706,4022
0,0,0,0,0,0,0,0.003076774403885216,63.38494478974421,4022
0,0,0,0,0,0,0,1.0127358228105713e-05,63.38488031487305,4021
0,0,0,0,4,0,4,0.011544291335876382,63.349248603293475,4021
0,0,0,0,0,0,0,1.0015041493621752e-05,63.39450925123121,4021
0,0,0,0,0,0,0,0.004726399650972366,63.394443593379535,4023
4,0,0,0,0,0,4,9.605818672109346e-06,63.38034253535379,4019
0,0,0,0,0,0,0,0.0026353408280920675,63.38026861118144,4020
0,0,0,0,0,0,0,0.0011781346795326786,63.39054769269918,4021
0,0,0,0,0,0,0,0.005278987191480033,63.390484022935205,4022
0,0,0,0,0,0,0,0.0013537613164415253,63.400758307142794,4022
0,0,0,0,0,0,0,8.643508045503414e-06,63.41632846136151,4022
0,0,0,0,0,0,0,0.0018933608570778251,63.416256995849345,4024
0,0,0,0,0,0,0,0.0058358558261172085,63.43183241072309,4025
1,0,0,0,0,0,1,0.005754057555916578,63.43177426884538,4025
0,0,0,0,0,0,0,5.340518517260147e-06,63.43917599787421,4024
0,0,0,0,0,0,0,5.80344042669842e-06,63.45482773063745,4025
0,0,0,0,0,0,0,0.005660593473650678,63.454780013196405,4027
0,0,0,0,0,0,0,0.005973039561824196,63.47034142290553,4028
0,0,0,0,0,0,0,0.0027337779350687583,63.47772624117827,4028
0,0,0,0,4,0,4,0.012049689482434935,63.45774611031575,4028
4,0,0,0,0,0,4,5.127878882250515e-06,63.457704854132395,4024
0,0,0,0,0,0,0,5.6596986906205485e-06,63.457656214116625,4024
1,0,0,0,0,0,1,5.818496381040047e-06,63.45761167640246,4024
0,0,0,0,0,0,0,0.005014654705844922,63.45756280228291,4026
0,0,0,0,0,0,0,0.0039207175844728,63.47314663372774,4027
0,0,0,0,0,0,0,0.00017892349624008965,63.49420842975745,4028
0,0,0,0,0,0,0,8.758874828974289e-05,63.50448851144631,4029
0,0,0,0,0,0,0,0.0030867959780981886,63.52008604698808,4030
0,0,0,0,0,0,0,0.005121534308757142,63.52003786161547,4031
0,0,0,0,0,0,0,0.0019261611668228724,63.53563207149346,4031
0,0,0,0,0,0,0,0.0011354795367808563,63.5459057267802,4032
0,0,0,0,0,0,0,0.00570896260928336,63.54585132791217,4033
0,0,0,0,0,0,0,0.0056418466904213805,63.545802547898745,4033
0,0,0,0,0,0,0,0.000903144142519,63.56138987462697,4033
0,0,0,0,0,0,0,0.0009198069388580026,63.34272126092586,4035
0,0,0,0,0,0,0,0.003144402634799407,63.571637253799786,4036
0,0,0,0,0,0,0,0.003080591978302884,63.579026971933274,4037
0,0,0,0,0,0,0,4.385318668990891e-06,63.602066939680775,4037
0,0,0,0,0,0,0,4.011202730523931e-06,63.60202225965632,4037
0,0,0,0,0,0,0,0.0045923924262681794,63.60198663896876,4039
0,0,0,0,0,0,0,5.221011359574099e-06,63.62045105993647,4039
0,0,0,0,0,0,0,0.001926107297029163,63.618178719463124,4039
0,0,0,0,0,0,0,0.00011102167091503191,63.62700519574384,4039
0,0,0,0,0,0,0,0.004027032843500851,63.62538972970756,4042
0,0,0,0,5,0,5,0.012037353760243952,63.62109296301645,4042
0,0,0,0,0,0,0,2.4467273734903517e-05,63.682068374180986,4043
0,0,0,0,0,0,0,1.3402732188443357e-07,63.696389098286645,4043
5,0,0,0,0,0,5,1.7398892914450267e-06,63.6470357337621,4039
0,0,0,0,0,0,0,0.003014956879943656,63.64702688450208,4040
0,0,0,0,0,0,0,3.672260193322446e-07,63.662654759292856,4040
0,0,0,0,0,0,0,0.0030912707913480085,63.662643205612724,4041
0,0,1,0,0,0,1,0.00511166924051291,63.65229705372518,4042
0,0,0,0,0,0,0,0.003060666402753579,63.683558177625336,4043
0,0,0,0,0,0,0,2.2113244122414346e-07,63.71482267559643,4043
0,0,0,0,0,0,0,0.0010968091904695724,63.7148159780085,4044
0,0,0,0,0,0,0,0.002691578463954895,63.714808336582074,4045
0,0,0,0,0,0,0,0.002970532601045779,63.725133200689115,4045
0,0,0,0,0,0,0,0.0012347304179769372,63.740898689233916,4046
0,0,0,0,0,0,0,0.0007423376862364347,63.75639053272277,4047
0,0,0,0,0,0,0,0.0028773629154578294,63.75637694594884,4047
0,0,0,0,0,0,0,0.005251464125825124,63.75635579620436,4050
1,0,0,0,2,0,3,0.005681767520281164,63.79553929370966,4050
3,0,0,0,1,0,4,0.008793937033705164,63.79552386643577,4051
0,0,0,0,0,0,0,0.0028188683935672174,63.8111538245532,4051
0,0,0,0,0,0,0,0.004166409194370869,63.82679263126497,4052
0,0,0,0,0,0,0,0.00019584656828959792,63.853178469336164,4053
0,0,0,0,0,0,0,0.002857458295518985,63.85276177854192,4053
0,0,0,0,0,0,0,3.7177679303117433e-07,63.85273774320028,4052
0,0,0,0,0,0,0,0.00181123057067051,63.85272940633196,4053
0,0,0,0,0,0,0,3.011039638056808e-07,63.868360222818964,4053
0,0,0,0,0,0,0,0.004952027332895959,63.88824962891351,4056
1,0,0,0,0,0,1,0.004345062688694268,63.90387823645928,4057
1,0,0,0,0,0,1,0.008049162757684105,63.91420898998963,4059
0,0,0,0,0,0,0,0.0031290282913078553,63.91420134229539,4058
0,0,0,0,0,0,0,2.1993886007913148e-07,63.929843741506794,4057
0,0,0,0,0,0,0,9.867820660200287e-07,63.94548092980849,4058
0,0,0,0,0,0,0,0.0029211521421374283,63.94546312890344,4059
0,0,0,0,0,0,0,0.002791016766499849,63.95290041340768,4060
0,0,0,0,0,0,0,0.0025001555862232848,63.95289501440719,4060
0,0,0,0,0,0,0,0.002765370667522392,63.960334195352196,4061
0,0,0,0,0,0,0,3.2322979735113636e-07,63.986306676689985,4062
0,0,0,0,0,0,0,1.6930872288801716e-07,63.98629582735409,4062
0,0,0,0,0,0,0,3.107150907660002e-07,63.98628695795869,4062
0,0,0,0,0,0,0,2.57622572927671e-07,63.986280855771255,4062
1,0,0,0,0,0,1,2.9029396901873064e-07,63.9862707405892,4062
0,0,0,0,0,0,0,0.008655728931668412,63.98626248493645,4066
0,0,0,0,5,0,5,0.0226780781261025,63.956019161804775,4067
0,0,0,0,0,0,0,0.0021983288550242695,64.05729608530994,4068
0,0,0,0,0,0,0,0.0027470061662759862,64.07293103500872,4068
6,0,0,0,0,0,6,0.0051477123375347,64.01324540448131,4064
0,0,0,0,0,0,0,2.872818425471713e-07,64.02887921249017,4063
0,0,0,0,0,0,0,0.002757330797014399,63.831210036219275,4065
0,0,0,0,0,0,0,0.005570274194362102,64.04451566354274,4067
0,0,0,0,0,0,0,0.002141987835778982,64.05484155701375,4067
0,0,0,0,0,0,0,2.2662054276825058e-07,64.06516815599784,4067
0,0,0,0,0,0,0,1.8201681716121176e-07,64.06516282598315,4067
0,0,0,0,0,0,0,0.0022131834942972313,64.06515882967771,4068
0,0,0,0,0,0,0,3.044874866045033e-07,64.08083770962432,4068
0,0,0,0,0,0,0,2.296933260820697e-07,64.0808293364415,4069
0,0,0,0,0,0,0,0.004687216342894638,64.08082326595714,4070
1,0,0,0,0,0,1,0.0031246042058934555,64.09645798683995,4071
0,0,0,0,0,0,0,0.006017934130185452,64.1277282324453,4073
1,0,0,0,0,0,1,0.001262863771467283,64.12772343790047,4073
0,0,0,0,2,0,2,0.014983233697199842,64.12269856881078,4076
2,0,0,0,1,0,3,0.013556307861335857,64.12799918106626,4076
1,0,0,0,1,0,2,0.007460252514646826,64.1436819442959,4075
1,0,0,0,0,0,1,0.002962681343257313,64.1436819442959,4074
0,0,0,0,0,0,0,0.0021083743752173174,64.1540164443242,4074
0,0,0,0,0,0,0,0.005838849545366867,64.16965464736667,4076
1,0,0,0,0,0,1,0.007932949309219485,64.18529537795295,4078
0,0,0,0,0,0,0,0.00620310775712706,64.18529537795295,4078
0,0,0,0,0,0,0,2.509626746148162e-07,64.2269867521561,4078
0,0,0,0,0,0,0,6.067895879866658e-08,64.2269867521561,4078
0,0,0,0,0,0,0,2.8166836750936645e-07,64.2269867521561,4078
0,0,0,0,0,0,0,1.1802910084599959e-07,64.2269867521561,4078
0,0,0,0,0,0,0,3.053547351315431e-07,64.2269867521561,4078
0,0,0,0,0,0,0,2.941931406323907e-07,64.2269867521561,4078
0,0,0,0,0,0,0,0.001789430369760466,64.2269867521561,4079
0,0,0,0,0,0,0,0.004648953436675423,64.27390232081952,4083
0,0,0,0,0,0,0,2.074078310734029e-07,64.29714814635791,4083
0,0,0,0,0,0,0,3.4561296458084436e-07,64.29714814635791,4083
1,0,0,0,0,0,1,0.00888816609110985,64.31278816274049,4087
0,0,0,0,0,0,0,0.0025706881235568312,64.32846267597196,4086
0,0,0,0,0,0,0,0.0,64.34411160374728,4086
0,0,0,0,0,0,0,0.0031464932393252096,64.34411160374728,4088
0,0,0,0,0,0,0,0.005958826497909366,64.35974998053085,4089
0,0,0,0,0,0,0,2.4384975878277123e-07,64.39107712666718,4089
0,0,0,0,0,0,0,0.004106104516203693,64.39107712666718,4091
0,0,0,0,3,0,3,0.011713315816945439,64.39438401669759,4092
0,0,0,0,0,0,0,0.0028684492186728974,64.42938926976393,4092
0,0,0,0,1,0,1,0.002873139439133248,64.42938926976393,4092
4,0,0,0,0,0,4,2.551975110435251e-08,64.39438401669759,4088
0,0,0,0,0,0,0,2.454236987190078e-08,64.39438401669759,4088
0,0,0,0,0,0,0,0.006037571215136819,64.39438401669759,4090
0,0,0,0,0,0,0,4.173915999247976e-08,64.40471851672586,4089
0,0,0,0,0,0,0,0.0003038218146893518,64.40471851672586,4090
0,0,0,0,0,0,0,3.131451862121439e-07,64.41308207204241,4090
0,0,0,0,0,0,0,0.0027719590589505667,64.41308230202497,4091
0,0,0,0,0,0,0,0.004881218040688539,64.41308230202497,4092
0,0,0,0,0,0,0,0.0029455957665196924,64.43375130208157,4093
0,0,0,0,0,0,0,0.0022745874923221585,64.43375130208157,4093
0,0,0,0,0,0,0,0.002799385904047467,64.43375130208157,4093
0,0,0,0,0,0,0,0.0019128171031856372,64.43375130208157,4093
0,0,0,0,0,0,0,0.0029411848669351984,64.43375130208157,4093
0,0,0,0,0,0,0,0.0029598870293296394,64.44948173857374,4094
0,0,0,0,2,0,2,0.00863568096262226,64.42881273851714,4094
2,0,0,0,0,0,2,0.005171641674373565,64.42881273851714,4093
0,0,0,0,2,0,2,0.007301249085312012,64.42881273851714,4094
2,0,0,0,0,0,2,0.005657772252541133,64.42881273851714,4093
0,0,0,0,0,0,0,0.002908748163448379,64.42881273851714,4092
0,0,0,0,0,0,0,5.069631889450028e-08,64.43914723854543,4092
0,0,0,0,0,0,0,0.0,64.4547856445007,4093
0,0,0,0,0,0,0,0.0028608535189480946,64.4547856445007,4094
0,0,0,0,0,0,0,0.002853542082074445,64.4547856445007,4094
0,0,0,0,0,0,0,0.00186589241496956,64.465120144529,4095
0,0,0,0,0,0,0,2.5577212445883345e-07,64.47256673986243,4095
0,0,0,0,0,0,0,0.004354903232935108,64.47256673986243,4097
0,0,0,0,0,0,0,0.002780385516345218,64.48001329983136,4097
0,0,0,0,0,0,0,0.0,64.48001329983136,4096
0,0,0,0,0,0,0,0.0,64.48001329983136,4096
1,0,0,0,0,0,1,0.003047572931412072,64.48001329983136,4097
0,0,0,0,0,0,0,0.0032386164179530317,64.48001329983136,4098
0,0,0,0,0,0,0,0.0012980846631744278,64.51144415900735,4099
0,0,0,0,0,0,0,0.0,64.52708237522336,4099
0,0,0,0,0,0,0,0.001200016379254166,64.52708237522336,4100
0,0,0,0,0,0,0,3.230162153034845e-05,64.53741687525167,4100
0,0,0,0,0,0,0,2.6810965126457375e-07,64.53741687525167,4100
0,0,0,0,0,0,0,0.0,64.53741687525167,4100
0,0,0,0,0,0,0,0.004635463260420245,64.53741687525167,4102
0,0,0,0,0,0,0,0.004294204467561986,64.53741687525167,4102
0,0,0,0,5,0,5,0.01955966153571465,64.4915202198644,4102
0,0,0,0,0,0,0,0.00302769967355294,64.58247235309565,4103
0,0,0,0,0,0,0,0.0027512367877071692,64.59811128594127,4104
5,0,0,0,0,0,5,0.0034976331896706568,64.53843500970491,4100
0,0,0,0,0,0,0,0.0036647863280936635,64.56441090887756,4102
0,0,0,0,0,0,0,6.284348130329374e-08,64.59568746533996,4102
0,0,0,0,0,0,0,0.0011869103350372462,64.59568746533996,4103
0,0,0,0,0,0,0,0.0001437712556180024,64.61163183272643,4104
0,0,0,0,0,0,0,0.0033418415004532126,64.62729390388061,4107
1,0,0,0,0,0,1,0.010332283464746116,64.65874063168083,4110
0,0,0,0,0,0,0,0.002020185260675577,64.67641267542987,4109
0,0,0,0,0,0,0,0.0,64.69228781055477,4109
0,0,0,0,0,0,0,0.0,64.69228781055477,4109
0,0,0,0,0,0,0,0.004829941064073907,64.69228781055477,4111
1,0,0,0,0,0,1,0.0045105766791331044,64.69973436887514,4112
0,0,0,0,0,0,0,0.002942744698178418,64.71006886890345,4112
0,0,0,0,0,0,0,0.003242912016334496,64.72581382331265,4114
0,0,0,0,6,0,6,0.016953295189216993,64.69025161405413,4114
6,0,0,0,0,0,6,0.0,64.69025161405413,4108
0,0,0,0,0,0,0,0.0,64.69025161405413,4108
0,0,0,0,0,0,0,0.0,64.69025161405413,4108
0,0,0,0,0,0,0,0.0,64.69025161405413,4108
0,0,0,0,0,0,0,0.0,64.70590766799205,4109
0,0,0,0,0,0,0,0.005259554661524686,64.70590766799205,4111
0,0,0,0,0,0,0,2.14644908138469e-05,64.73725041413462,4111
0,0,0,0,0,0,0,0.0,64.73718419839508,4111
0,0,0,0,0,0,0,0.0,64.73718419839508,4111
0,0,0,0,0,0,0,0.0005580692145904354,64.53957617875922,4112
0,0,0,0,0,0,0,0.002537724421588976,64.73718419839508,4113
0,0,0,0,0,0,0,0.004644192360729675,64.74751869842339,4115
0,0,0,0,0,0,0,4.4605015093026484e-06,64.77887684794234,4115
0,0,0,0,0,0,0,0.0020192216603679134,64.77882338737959,4116
0,0,0,0,0,0,0,0.0,64.79446160528448,4116
1,0,0,0,0,0,1,0.004971734537678311,64.79446160528448,4118
0,0,0,0,0,0,0,0.004397164039002216,64.79446160528448,4119
0,0,0,0,0,0,0,0.0011150376930580592,64.8257716250764,4119
0,0,0,0,0,0,0,0.0,64.8414098986081,4119
0,0,0,0,0,0,0,0.002804009103299869,64.8414098986081,4120
0,0,0,0,0,0,0,0.0029255377368445426,64.8414098986081,4120
0,0,0,0,0,0,0,0.0002596559092934035,64.8414098986081,4120
0,0,0,0,0,0,0,0.0008148826788907261,64.8517443986364,4121
0,0,0,0,0,0,0,0.0,64.8941168028165,4121
0,0,0,0,2,0,2,0.008559560050750906,64.87344780275991,4122
0,0,0,0,0,0,0,0.002802015869441717,64.89411680281651,4122
0,0,0,0,1,0,1,0.0028181709716646004,64.89411680281651,4122
3,0,0,0,0,0,3,0.00430543141478107,64.87344780275991,4122
0,0,0,0,0,0,0,0.0030232134860321653,64.90472436172759,4122
0,0,0,0,0,0,0,0.0020862005661370694,64.90472436172759,4122
