throughput_KLONGTEI,throughput_KASEMRAT,throughput_NARANONG,throughput_SUNLAKAKHON,throughput_RAMA4, throughput_ATTHAKAVI_RAMA4,throughput,mean_speed,jamlength_percent,Backlog
0,0,0,0,0,0,0,9.904311108768514,0.0,12
0,0,0,0,0,0,0,9.510618986914455,0.01033450002829683,29
0,0,0,0,0,0,0,10.022759566896088,0.025972844830059516,47
0,0,0,0,0,0,0,9.870536560620804,0.025972844830059516,74
1,0,0,1,0,0,2,10.333945156036938,0.08519748163136198,102
1,2,2,0,1,1,7,9.692544718728476,0.1610700015374209,136
0,5,0,0,1,1,7,9.59040697712632,0.21950449024332105,151
1,3,2,9,0,1,16,9.781123340995398,0.22396879390330995,183
1,4,1,0,1,2,9,9.565911879737097,0.3048554958352322,215
4,7,1,1,2,2,17,9.609625254065127,0.3680565639198997,243
5,5,1,2,3,7,23,9.189191544933953,0.5175431478361121,276
5,9,0,4,3,6,27,8.801754790284336,0.6614450677980692,295
2,18,2,3,4,5,34,8.091185174206931,0.7841682703197494,329
18,10,1,0,2,5,36,8.058923419855786,0.9231542675832608,344
8,13,0,2,9,6,38,7.6906583991621265,1.2702216059362201,367
6,6,0,17,3,4,36,7.2251683175567365,1.4735316566947083,383
8,14,8,6,9,4,49,7.1080784924082,1.5512812446046969,393
7,6,3,3,5,7,31,6.767612590639059,1.916600969534299,406
7,8,1,4,5,10,35,6.251822298373629,2.217453165596758,428
11,12,4,3,6,8,44,5.632135531645202,2.7024422561643995,431
8,8,1,1,11,1,30,5.45278042606183,2.8340356754759917,452
8,4,2,2,5,8,29,5.280950236898707,2.9359543941743413,479
6,4,14,3,5,6,38,5.042759118085694,3.2600302342249314,506
5,7,10,14,5,4,45,5.321845516028418,3.1742452480764047,531
7,8,12,12,8,7,54,5.418343984050645,3.333081087509233,546
3,9,10,5,6,6,39,5.397879636028895,3.697571694328567,561
7,8,14,0,4,6,39,5.1422677397140815,3.9468959443175433,575
6,12,7,1,3,2,31,4.756827062850577,4.593031423849901,596
13,6,9,3,23,3,57,4.994595232254844,4.170970758951034,607
13,18,9,2,27,11,80,5.389934698354284,3.640660258310229,624
9,19,5,3,23,8,67,5.223231359274462,4.129550759809245,646
10,12,9,18,5,5,59,5.410375343238659,4.153093884749678,680
11,7,13,17,5,9,62,5.310810598211163,4.153801308623151,691
9,12,7,0,5,15,48,4.991382635439416,4.436051817642534,702
8,13,7,1,5,16,50,4.753070178612906,5.01385090560805,726
9,11,8,1,5,16,50,4.415890474054105,5.514591931868266,743
9,12,11,11,6,10,59,4.2826864626802905,5.721198612695813,742
11,8,13,7,6,8,53,4.05993694259438,6.08458524540663,755
10,7,11,7,7,13,55,3.7600439726220656,6.474392588532279,769
10,2,15,4,6,11,48,3.1821525269618403,7.340701004684946,768
8,1,6,2,5,13,35,2.905653820036601,7.9787797517872505,787
8,1,3,2,12,9,35,2.6442207380440315,8.394731110661734,805
21,3,10,17,9,4,64,2.9817203550975604,8.263447634229431,815
7,1,6,20,15,5,54,3.0953118137208215,7.954021516196404,831
8,25,1,20,9,7,70,3.3624588373310624,7.819349357689696,847
24,29,1,8,12,4,78,3.559983554215033,7.229334575623694,826
12,28,11,16,11,6,84,3.7956799239473553,6.760221433539706,810
15,25,10,16,12,11,89,3.9621800352030516,6.4589008518683215,812
12,24,10,13,12,10,81,3.8168162229847966,6.728026804991802,801
7,22,10,5,11,8,63,3.752271561109404,6.824988613458445,819
15,22,11,3,10,9,70,3.712797759783321,6.841559411952906,823
4,9,17,4,4,5,43,3.434161573677954,7.552036471183804,844
9,7,13,3,3,2,37,3.4062832394967706,7.975714033051078,866
6,3,9,5,5,8,36,3.207013739824315,8.42419898046265,900
4,4,7,17,6,8,46,3.2302747995478995,8.311149624213925,916
12,7,7,21,15,6,68,3.173300653143369,8.535845421462074,918
10,9,2,9,20,5,55,3.1761098231275935,8.813262866095721,926
0,9,6,2,8,5,30,3.077639919376323,9.269561854378564,950
1,12,6,2,12,7,40,3.131325247400459,8.886252986816936,947
0,7,6,2,8,8,31,3.0080714911203508,9.174292659162933,971
9,13,5,5,22,10,64,3.0939312638628187,9.122648003975453,979
13,12,18,1,26,8,78,3.173258068180026,9.371739214700012,977
19,10,10,15,27,6,87,3.38245672371561,9.327312169098919,997
12,8,14,14,15,7,70,3.1834501323628497,9.560978398639781,991
12,1,9,7,9,10,48,3.016909820807767,9.829082013924095,1003
12,2,2,2,5,12,35,2.541170033853315,10.703137460475132,1031
12,3,6,16,5,13,55,2.5416500351412368,10.948984497935006,1051
12,0,5,22,7,11,57,2.4008756483883165,11.30716138692988,1040
11,26,5,18,9,10,79,2.4031248213613963,11.067687338448549,1041
8,26,5,4,11,10,64,2.5092248599868276,10.890747533711693,1039
17,29,5,14,17,11,93,2.94353589368006,10.435537166049834,1037
8,32,5,14,33,15,107,3.2174092731597503,9.690867315303443,1042
6,21,5,15,19,8,74,3.132882978033196,10.006623657376212,1045
9,21,5,12,12,6,65,2.9948157270351072,10.588300145870003,1062
7,19,11,10,7,9,63,2.8250058501271833,11.273375884462432,1081
28,18,10,14,6,12,88,3.104097514440052,10.573805701212176,1083
31,12,8,4,9,6,70,3.086480550792962,10.33743875518875,1064
29,14,9,1,11,7,71,2.9016378789044737,10.574551309337492,1050
11,13,10,4,12,6,56,2.6523070084273352,10.972174757404147,1063
7,10,8,4,12,6,47,2.535666800148189,11.399519986363869,1079
10,8,8,4,16,4,50,2.4221778862089063,11.67430401298469,1088
14,10,6,5,9,6,50,2.235278599056936,12.138809180943653,1096
8,13,8,2,13,6,50,2.1885100770522294,12.238749675276983,1111
0,9,15,17,4,7,52,2.2081222161076806,12.012627799270284,1119
20,8,16,20,6,4,74,2.4378177531321117,11.876486911569222,1116
8,9,6,17,9,7,56,2.3090246619804513,12.525606709113575,1130
8,5,5,2,8,6,34,2.464818793184313,12.831690075078601,1171
4,5,6,4,6,6,31,2.2982882169094827,13.363575555340624,1193
15,5,6,4,9,5,44,2.194793004727895,13.498219109299958,1205
11,0,7,5,7,6,36,2.032515741245291,14.08134597264775,1229
6,2,5,3,3,7,26,1.748253582640287,14.743403564475027,1246
1,26,5,12,11,9,64,1.9737081093963214,14.216624215655854,1236
4,30,5,15,9,2,65,2.190240929294743,13.780975744567835,1242
3,24,7,10,7,3,54,2.131007293276315,13.824846595823766,1225
4,14,6,5,17,6,52,2.185600418407938,13.688391953926793,1229
0,7,8,16,13,4,48,2.244882774576646,13.795673072892507,1229
2,7,9,19,12,1,50,2.2681169268839985,14.059040746113489,1236
0,9,10,22,1,1,43,2.2734505622208956,14.179986830228092,1240
1,4,7,22,22,5,61,2.3094456489571873,13.932437868244147,1242
12,9,5,21,24,6,77,2.339284855406207,13.693203425540508,1228
15,6,5,9,24,1,60,2.281872771745067,13.951108146416436,1247
13,6,5,2,13,1,40,2.2150381472314584,14.191874629129906,1260
13,5,6,2,14,5,45,2.127674497471082,14.496763594330373,1279
12,6,5,1,10,6,40,1.9887168817794127,14.910681554231127,1285
11,18,5,4,8,7,53,2.0630467264338557,14.629978964780863,1302
9,20,7,4,7,9,56,1.9995754971230637,14.75020999928223,1302
8,22,6,16,5,14,71,2.257657784242259,14.136654737478528,1312
12,21,5,17,19,13,87,2.599657756453137,13.850344474331107,1340
15,16,5,15,26,14,91,2.746538667883358,12.934539355254241,1321
11,29,10,14,23,12,99,2.6463614273119087,13.453434101943682,1323
9,16,18,11,19,14,87,2.7495905358871826,13.530687994069512,1342
7,16,12,14,7,13,69,2.503127332857104,13.891489674377457,1339
30,9,13,5,10,13,80,2.5936430620901803,13.713192434442407,1354
33,11,13,6,14,10,87,2.50523289948739,13.779626306497143,1331
31,8,10,11,11,10,81,2.2371726169178503,14.284909204072196,1330
12,9,9,3,11,10,54,2.1089647764425257,14.510409684517638,1343
11,10,10,3,13,9,56,1.9605142939625573,15.280524904654284,1355
10,10,11,15,8,6,60,2.0715703123956954,15.157942270731079,1374
10,9,11,18,13,7,68,2.020886342091601,15.17788915821735,1372
11,3,5,8,4,5,36,1.9394230134226058,15.676418757179036,1391
5,2,8,2,11,7,35,1.9501967150331296,15.896854270558187,1419
5,2,10,3,5,7,32,1.8368021610276726,16.45132566935292,1431
6,1,9,8,1,6,31,1.6903024342921662,16.89094676455986,1453
6,2,13,5,1,9,36,1.6917747799000455,17.158499211237643,1485
4,19,10,15,3,7,58,1.5877386584714799,17.46634640134625,1494
3,22,5,10,0,1,41,1.5203179290390025,18.123084546182948,1506
0,20,5,8,5,4,42,1.4378866154467507,18.93566112779066,1520
1,19,5,4,4,9,42,1.473742674202837,18.051176680263506,1529
1,3,5,3,8,7,27,1.4087619218482994,18.970446142546955,1550
2,5,6,1,5,8,27,1.3469604958907557,19.565218453364505,1561
5,5,6,17,7,10,50,1.4473039064049245,18.781646522108417,1570
4,1,5,21,3,9,43,1.4035178348189543,18.852618553540243,1567
3,1,5,20,4,9,42,1.4519961952027423,18.325671963509016,1550
2,6,5,21,14,8,56,1.6389216718741746,17.71894591564041,1532
3,9,13,21,16,7,69,1.7604493760465205,17.438836414150963,1513
3,27,13,20,10,3,76,1.7784220865034157,16.929265761580556,1476
2,32,10,19,11,0,74,1.7928641852457712,16.334690010234105,1463
0,30,12,9,12,9,72,1.9139515813524182,16.930918607673007,1456
2,27,10,6,9,8,62,1.8226831973448536,16.798874363826318,1458
0,14,5,7,2,7,35,1.7251096274827213,17.02328093722976,1461
4,19,5,9,23,5,65,1.953982940922189,16.71926159315545,1481
12,21,6,11,23,5,78,2.2166569241775087,16.004666117484025,1475
16,20,7,8,25,5,81,2.2729519138027086,16.208517191155362,1478
16,19,9,17,17,5,83,2.3597795585647625,15.990140556433392,1487
12,16,15,11,29,5,88,2.56904593873619,15.66138576951971,1483
12,21,13,14,24,5,89,2.365577930939773,15.809227159116125,1493
14,8,11,9,14,6,62,2.2365255092362517,16.412291561990923,1507
14,10,7,10,16,5,62,2.1996909900361485,16.714416020149713,1524
26,10,10,5,10,6,67,2.1795868547833046,16.895956692227127,1544
35,13,10,7,13,4,82,1.933304323928945,17.383648839764692,1526
20,10,1,5,13,5,54,1.802990471521195,17.976679096088723,1522
12,9,1,10,13,5,50,1.735270561239807,18.45098384169895,1529
13,10,5,5,23,5,61,1.6226086120167236,18.408428429874874,1537
5,6,5,5,19,5,45,1.5987087449876276,18.63246078677977,1531
19,8,5,3,7,5,47,1.6705833397790075,18.873138171158917,1559
8,7,5,2,12,6,40,1.43225509530686,19.306775270509767,1562
5,6,5,16,25,6,63,1.6245604335763706,18.94394327227898,1569
20,7,5,20,11,5,68,1.6276993184995967,18.803756033028733,1553
8,7,5,14,2,1,37,1.6486633033233762,19.2333860772442,1554
5,20,5,11,0,6,47,1.6488438308286661,19.022781535335895,1557
1,28,4,8,11,2,54,1.7719234046627557,19.111260493200735,1570
4,23,6,8,11,7,59,1.7993156773621994,18.926785360118206,1585
6,13,9,14,10,3,55,1.7144177151212945,18.433864316820816,1567
6,4,7,13,4,2,36,1.5714939431356523,19.322602652616872,1591
8,4,6,5,16,2,41,1.4573377213066434,19.884592659584886,1616
7,8,1,1,14,3,34,1.2865310824041043,20.82776325871928,1628
5,3,5,3,1,0,17,1.114424699580255,21.13741348625584,1647
4,5,5,2,0,4,20,1.038579376298094,21.903517025179646,1660
1,6,10,2,6,3,28,1.0187835976459108,22.111846520343633,1685
11,7,8,16,13,3,58,1.2371467773103122,21.704579067611526,1698
8,5,10,22,9,3,57,1.2287746545435785,21.515830207734137,1695
14,5,16,12,6,0,53,1.256278355733899,21.609688633120573,1703
11,16,11,0,11,0,49,1.4092945214536967,21.14833941393054,1734
7,18,10,13,5,0,53,1.611724121502338,20.465730455868393,1753
8,13,5,13,4,16,59,1.8244647312899112,19.391487376635883,1757
10,13,5,12,8,16,64,1.7503909322621596,18.933952387279827,1769
17,18,5,12,4,19,75,1.8912938703342814,19.365421564812685,1779
13,8,6,12,10,17,66,1.708758847626545,19.780690380274258,1804
8,8,5,2,9,13,45,1.7244550396264768,20.08171464074234,1834
11,8,5,4,8,18,54,1.622192788817541,20.44489619755686,1829
13,6,5,4,6,15,49,1.593231535286932,20.436758073333653,1846
8,7,9,11,4,10,49,1.5490230794863808,21.32521672229304,1864
17,5,9,15,5,9,60,1.6545841149788723,21.110504448096112,1855
15,5,15,3,3,8,49,1.5580578651818942,21.104593039964534,1856
13,21,12,8,4,6,64,1.5708724148709268,21.00192097534942,1850
10,28,13,9,6,3,69,1.5939978655960558,21.301326351560157,1840
9,30,15,6,8,9,77,1.5031108733823106,21.72992207714206,1831
12,29,11,13,7,14,86,1.4352871071291897,20.882945696875918,1819
3,12,10,7,6,12,50,1.3412045189735224,20.892197511625707,1814
5,15,10,7,5,18,60,1.3104183900135993,22.07367070439039,1822
6,12,13,1,5,20,57,1.235653094148133,22.118915305949457,1832
2,10,10,2,4,8,36,1.0760470944865195,23.231248764564967,1846
3,10,11,17,4,8,53,1.0707341403449337,23.160628358187683,1842
2,5,9,21,9,11,57,1.137989723591307,22.792415454201084,1836
2,3,8,21,12,14,60,1.2468534078975477,22.61192983581598,1825
0,4,5,21,1,12,43,1.34475098185922,22.295376810794984,1819
1,1,5,24,7,11,49,1.1929706094024344,22.80519768992783,1816
0,2,5,8,9,8,32,1.1054821217641653,23.49478623802347,1834
0,25,6,2,10,5,48,1.1144625776488324,23.205215967451856,1822
0,28,6,4,14,3,55,1.1136004569409923,23.01083903086502,1802
0,30,5,3,13,7,58,1.1489235471126933,23.17006136801167,1805
7,16,14,7,21,6,71,1.3517436825341431,21.933733320588342,1796
8,11,12,7,27,7,72,1.6707160049951952,20.660826541778736,1794
16,15,7,10,27,9,84,1.7125496403912626,20.2688122448359,1787
9,18,6,9,16,5,63,1.771734359979574,20.5213561603609,1804
9,20,6,16,6,12,69,1.8473509436626805,19.898514494778354,1822
8,19,5,15,18,11,76,2.01184141520475,19.61509697905025,1834
14,23,5,13,19,16,90,2.1013930734319013,19.377000589585226,1830
13,23,5,16,17,10,84,1.993528174242369,20.20313232784336,1852
0,20,5,13,18,12,68,1.7904696752962643,21.408485836323816,1864
31,15,7,12,6,11,82,1.6896327045747617,21.568569970740082,1859
12,11,8,9,10,12,62,1.431546746228815,22.92457713853379,1867
11,15,6,5,7,9,53,1.2492109081279175,22.98486232240411,1881
12,9,8,4,8,13,54,1.197577131436926,23.869046742214895,1899
13,7,3,5,6,3,37,1.1929278809174086,24.334457643127283,1928
11,9,6,3,8,8,45,1.0683529359730985,24.836007104015557,1926
10,7,6,2,6,8,39,1.053985153555239,25.05545746469281,1943
28,8,5,4,11,8,64,1.1909450780798512,24.745489565318692,1942
20,13,5,14,15,7,74,1.3011671490552503,23.838893490556345,1934
16,7,5,15,23,8,74,1.4543611938223715,23.021194279854072,1919
27,7,5,15,21,9,84,1.6959428007163917,22.520749738489524,1927
13,10,5,12,28,9,77,1.6872405444326195,22.444159501483078,1924
11,8,4,11,16,3,53,1.5323889433036166,23.236809261676974,1929
0,8,16,4,7,2,37,1.4366481490648029,23.98347294137155,1946
26,9,13,8,2,0,58,1.3853937793589641,23.864871465142016,1939
13,24,11,6,21,7,82,1.370502234777105,23.338163683681227,1927
22,28,14,7,13,8,92,1.4183939205986065,22.94449474612597,1914
13,30,10,5,11,7,76,1.2299572031793276,23.42158769544168,1899
8,18,12,16,9,9,72,1.1646542800051054,23.562039542823968,1890
5,13,11,20,10,11,70,1.1830648390682563,23.383512126224048,1879
5,10,15,23,12,6,71,1.1352269109766189,23.738092151630905,1878
9,14,15,2,10,6,56,1.2484035781751812,23.346705053182244,1880
4,11,16,2,5,7,45,1.2274067338252166,23.802995531586607,1898
5,7,16,1,4,7,40,1.1763484664370851,24.168111952840984,1910
5,9,8,1,17,3,43,1.1035651037478142,24.59349828759257,1924
6,9,5,2,17,0,39,1.048139055274399,24.985238607863206,1941
6,6,5,2,3,0,22,1.025348375062472,25.367073596401593,1962
2,7,5,1,0,0,15,1.0109600963679322,26.204259083169536,1991
18,16,6,3,7,4,54,1.1202112701437095,25.798279811806513,2004
13,20,6,6,8,9,62,1.1428702887625242,25.647635114078454,2001
15,22,6,3,12,13,71,1.2226972892562507,25.418308082481303,2004
16,18,5,17,13,15,84,1.313359270385205,24.923777910037195,2005
9,16,5,16,23,8,77,1.46778847980645,24.446948036373655,2008
8,21,6,13,16,5,69,1.4804312964319615,24.484986502098618,2011
10,9,5,15,11,6,56,1.5000616052973923,24.542127455671682,2028
7,9,5,12,6,8,47,1.4366818814290754,25.07993715009986,2060
11,8,6,14,3,13,55,1.3678613861629243,25.37029493284978,2074
10,9,7,10,8,12,56,1.2511175603931266,25.691547203359676,2085
13,11,10,5,6,13,58,1.1355124843243931,25.668275538528484,2096
11,11,6,2,6,11,47,1.0520935166076704,26.027477207610467,2113
12,12,6,17,6,9,62,1.2110460432340842,25.559511428362736,2126
5,12,7,20,20,7,71,1.3456155623568444,25.583890619156374,2140
27,11,5,14,16,5,78,1.3983577230645883,25.928535950907207,2150
10,8,5,4,14,6,47,1.431385147189292,25.83113442691777,2169
12,8,5,2,9,6,42,1.4425561760254988,25.700738383197166,2171
12,10,5,15,6,10,58,1.488436490982196,24.963453471417427,2166
14,10,6,15,6,13,64,1.3023784007534525,25.94050494748547,2153
10,8,6,13,4,9,50,1.1284308368383635,26.24599346519856,2136
7,24,5,13,6,1,56,1.1749382962470498,25.2842083637066,2149
12,27,5,10,21,5,80,1.2728685605420318,24.821370267059073,2145
8,29,4,3,18,12,74,1.415315828187741,25.095360927122023,2158
11,27,6,2,7,18,71,1.303104373538206,25.449474828687073,2162
8,19,9,3,10,5,54,1.3504523417874505,25.90188947640134,2176
14,10,7,2,8,11,52,1.2463330784202078,26.689375875298772,2184
13,19,10,17,7,17,83,1.2251452025620118,26.122999357028615,2166
6,21,19,21,9,16,92,1.2852653101129103,26.413565054923787,2174
27,27,13,23,6,14,110,1.4127993986296312,25.107183749682967,2142
15,26,9,22,16,9,97,1.3943811384524112,24.925000029734534,2145
8,10,9,19,16,2,64,1.2461272423190772,25.83078253036466,2131
5,7,6,22,10,5,55,1.2588515365616857,25.992273696557522,2142
3,4,9,20,17,6,59,1.2295440684837693,25.500086245203704,2113
1,5,11,10,14,6,47,1.2136885427146684,25.727849000027796,2123
3,9,12,17,13,5,59,1.3191253601239201,25.27399325853908,2125
3,6,10,15,7,5,46,1.358436980953759,26.10083743870938,2141
3,10,10,13,21,7,64,1.4463348190361651,25.72835152963753,2151
6,10,9,11,28,8,72,1.461768049819684,25.554264130527894,2149
9,8,14,12,21,11,75,1.3866276271963618,26.355110903342656,2154
10,20,11,10,10,10,71,1.3843144186228822,26.17637852729804,2170
3,21,6,10,20,13,73,1.3741117727834908,26.702052627055327,2178
9,14,7,9,15,13,67,1.2959544967812964,26.979843773359317,2185
26,9,9,3,10,14,71,1.2195662606975213,27.819612096768484,2183
2,11,9,4,14,13,53,1.1151258273611075,28.1996010436341,2183
23,10,7,4,10,13,67,1.0470933591562983,28.51633901526556,2178
13,7,6,2,16,15,59,1.1115547182990784,28.791452539526514,2192
9,8,7,4,13,13,54,1.142118875163784,28.37336254284361,2197
9,9,6,18,16,11,69,1.2134503438312951,28.100182353602982,2218
18,1,5,20,15,3,62,1.284126663291274,28.10789117693086,2219
9,1,6,12,19,5,52,1.227275543912043,28.40735767264398,2233
3,0,16,4,13,10,46,1.226241139307492,28.375224167275373,2238
4,3,15,4,5,7,38,1.125840978890872,28.663753695212122,2243
0,7,14,2,1,9,33,1.0641267258607479,28.77356374839562,2255
3,3,14,12,16,6,54,1.114910156474538,29.377273439320792,2273
5,4,10,7,0,3,29,1.0414746490664946,29.953889022036396,2285
2,18,12,12,0,3,47,1.0174557083067095,30.637825264313527,2286
4,21,9,10,1,1,46,1.013187682360689,30.48555516731345,2275
0,20,5,13,0,6,44,0.8993492828634263,30.61166741323927,2267
1,19,5,6,1,7,39,0.801430545925104,31.195910596431247,2275
1,4,5,5,3,10,28,0.7596760802572945,30.85457735629618,2289
2,3,5,9,2,8,29,0.6076757565973339,31.89696504480603,2297
5,3,6,4,8,8,34,0.6683766918019286,31.618459178555018,2301
5,8,6,0,6,7,32,0.7084574448055756,31.769810419169126,2307
7,6,5,1,1,7,27,0.6997733263210172,31.66960511435816,2308
6,10,5,16,1,4,42,0.724620756828406,31.340096487632827,2316
5,10,5,20,3,3,46,0.8115858577926998,30.98781359628648,2310
9,11,5,21,12,4,62,0.8285690690457519,30.62984112749189,2286
10,9,9,24,10,1,63,0.8944492507439645,29.78669986034744,2265
10,6,11,18,14,0,59,0.945049344603551,29.384487823352632,2255
4,0,9,10,7,0,30,0.7628885697530245,29.820452258018666,2272
24,2,5,1,15,0,47,0.861130558021912,29.711045074837365,2286
17,1,5,2,12,0,37,0.8266997590394881,30.328333481093836,2300
11,22,3,16,9,0,61,1.1399881854875067,29.107067298786795,2312
14,27,5,13,7,0,66,1.3511738889773304,27.923767592014244,2290
17,27,5,15,10,0,74,1.4032879593620702,27.35321720363223,2294
20,16,6,12,12,2,68,1.4655869871559575,27.192115427543357,2294
16,8,10,9,8,2,53,1.374735684887769,27.934907515999623,2307
7,9,9,10,6,5,46,1.3583244671116743,28.211679803851386,2315
7,11,6,9,4,2,39,1.278556362485136,28.68810094024761,2328
1,8,2,8,18,1,38,1.2782508112949007,29.279864912810147,2341
8,15,5,8,21,0,57,1.1459865959818347,29.528229895424843,2344
10,13,5,7,22,2,59,1.193975486709357,29.344349808305793,2358
13,10,5,4,17,0,49,1.06202310623724,29.505975990550198,2384
5,9,5,3,9,0,31,1.0515714571920678,29.553761693267212,2393
25,8,6,12,9,0,60,1.197847504670761,29.28342804016315,2414
10,12,8,16,5,1,52,1.2130260571210556,29.737060990019284,2418
8,7,10,13,7,0,45,1.2648610087261052,29.47804626551739,2430
3,7,7,8,4,0,29,1.1936875945197318,30.318179619401004,2437
7,9,7,0,5,0,28,1.042962574378042,31.34841259059811,2464
7,3,5,2,17,2,36,0.9259172466372315,31.911387382983186,2472
5,7,2,2,17,2,35,0.8011798388400703,33.2588681150916,2486
5,3,4,3,6,0,21,0.7371883874982663,33.57854694413366,2512
7,0,5,1,4,0,17,0.7769921717817085,33.61285149713248,2543
5,11,5,1,2,1,25,0.7794767467890215,34.80315628482945,2572
5,0,5,1,10,0,21,0.7222200879545138,35.380184731754056,2579
2,0,6,13,7,2,30,0.7350367132236459,35.467816765027365,2599
2,3,14,11,6,0,36,0.7291249983374877,35.98094048125537,2617
7,2,7,3,0,0,19,0.6941227077052381,36.379862484719695,2643
21,0,6,0,14,1,42,0.6606493844848321,36.62404790454725,2639
2,2,5,0,11,0,20,0.5961251872460787,37.50588435079499,2653
1,0,8,0,13,3,25,0.6328142928406686,37.36669357807969,2669
1,0,8,3,10,7,29,0.6118001859270106,37.42442185838291,2678
1,1,6,3,10,6,27,0.6108682538025664,37.703511690706485,2685
1,3,9,0,7,7,27,0.5826682803776382,38.071328347986366,2721
0,2,10,0,7,6,25,0.621449866172075,37.979663632326734,2749
0,3,9,3,8,7,30,0.6294453722267621,38.20716124033796,2758
1,10,12,6,7,7,43,0.672566456934728,37.817440961745945,2769
2,7,6,5,15,6,41,0.6437730747554702,37.860229178806655,2788
5,6,5,17,10,7,50,0.7224655108828691,37.94216618860445,2799
4,11,6,22,8,10,61,0.6781504955308139,37.56126932351412,2791
6,8,11,22,6,8,61,0.6332123440876473,37.756450235338,2788
1,16,9,6,25,14,71,0.6386327788069287,38.38779123364517,2786
20,11,8,6,16,14,75,0.7401760445093637,36.94054163235204,2757
0,13,8,5,13,10,49,0.8366557303214566,36.84495814668535,2759
0,16,9,4,11,11,51,0.8060392794306913,36.69225005752111,2756
0,17,12,6,2,18,55,0.7913759371570336,36.79811269373751,2757
0,10,14,8,0,15,47,0.7815993494991283,36.845532201499886,2757
0,15,9,7,0,12,43,0.756628448194742,37.78833277920212,2776
4,14,13,5,0,15,51,0.6982237985579383,38.140766421025,2768
21,9,14,6,20,17,87,0.6874316142990841,37.7686820289384,2747
25,9,15,7,15,15,86,0.6621173271565526,37.74128734371121,2729
18,10,15,15,13,12,83,0.6967252176892539,37.60887855288912,2706
1,7,11,17,13,15,64,0.691134826471575,37.301706972072154,2679
4,6,7,13,8,13,51,0.693294923528225,37.018426793543796,2673
6,7,7,11,0,15,46,0.7267351423174081,36.84617868968903,2675
4,8,7,12,1,12,44,0.7165703128702584,37.71417506817631,2662
4,7,9,10,2,11,43,0.6553635827558136,38.02711835200904,2666
0,13,5,8,18,12,56,0.6293032995198239,38.17660473580518,2674
12,7,5,11,9,10,54,0.5839409238412667,38.42774740241493,2675
4,10,4,8,11,3,40,0.6282374316326254,38.039350164350616,2679
1,8,11,4,6,4,34,0.6329161443623111,38.41221102198665,2677
5,10,10,4,8,1,38,0.7413336067131295,37.74123073985981,2690
5,10,7,6,0,1,29,0.7604244721763589,37.574732686315905,2695
7,6,8,5,0,1,27,0.7050004302656027,37.918994870756116,2706
15,10,16,11,0,1,53,0.7520161883922378,37.33470933873265,2707
8,8,11,10,18,3,58,0.7810317618649953,37.486982682566314,2698
18,12,10,11,10,2,63,0.7954748281045435,37.42248052650231,2695
8,12,7,10,11,0,48,0.750728668496627,37.70652958624178,2696
6,18,5,8,9,0,46,0.7002170431292304,38.16047079170792,2706
10,11,6,4,21,0,52,0.6814387685989385,38.0276899054383,2705
7,12,6,6,8,1,40,0.6051382039212823,38.621404956800525,2710
2,7,5,3,8,0,25,0.5647081547980565,39.088125020922604,2727
5,17,5,5,2,0,34,0.5632870186324291,38.80210249442913,2735
0,22,6,0,19,4,51,0.5744362008194107,38.87282990321665,2738
12,15,5,8,23,7,70,0.5550860128552682,38.76263627249608,2720
20,15,5,0,17,7,64,0.556238259613904,38.73677836062642,2713
19,12,5,0,9,6,51,0.6455510323417395,38.407300062161084,2703
12,14,3,0,6,5,40,0.7058919182846936,37.78362260638128,2701
17,13,5,11,6,2,54,0.8276426351171401,36.62100866554042,2691
7,16,5,13,12,0,53,0.9066031284646274,35.78828383802584,2692
13,11,7,15,3,0,49,0.8819562933602191,36.13523702948899,2700
12,6,6,10,23,2,59,0.8079736958313851,36.35170607305473,2691
25,8,5,1,16,5,60,0.7933103106958143,36.086581159716346,2679
15,12,6,3,9,7,52,0.7405720280885812,35.93978913166457,2666
1,14,8,1,7,3,34,0.7438731854859121,36.34400369247934,2682
17,9,10,3,14,1,54,0.7584327828863052,36.34340039331233,2679
4,14,7,1,16,2,44,0.7434785389376688,35.78191715355663,2658
6,12,5,1,12,6,42,0.7394158420313286,35.75773030028419,2657
2,9,11,5,9,9,45,0.672512216379185,36.24771952570094,2653
3,13,6,5,12,5,44,0.6935716935623728,36.92842559980548,2656
2,14,5,8,14,4,47,0.7810803527084627,36.5681139299742,2659
1,16,9,16,11,3,56,0.8337283557499409,36.67897344572907,2654
1,12,8,12,12,7,52,0.9355023878990527,36.240420652033066,2660
2,8,12,15,10,7,54,0.9096849148018211,35.37051192054541,2651
1,9,14,14,5,10,53,0.8725198821833225,35.57278267147598,2646
3,18,9,13,5,11,59,0.9049010103461731,34.39341841766658,2624
0,27,6,18,0,6,57,0.8635025119846205,34.99494160433679,2624
5,22,7,16,18,7,75,0.8999058724722974,35.0972697733756,2613
0,16,5,7,20,7,55,0.934807539358239,35.54859425127946,2623
0,11,5,9,6,7,38,0.9276829529986101,35.949088708216834,2635
5,16,5,12,0,7,45,0.8649502090676838,35.77065482355315,2638
5,14,5,13,7,11,55,0.793431163388695,36.18468917916617,2626
11,14,6,8,9,13,61,0.8603636827733331,35.11158572846889,2641
12,16,6,7,10,17,68,0.8003252505428201,34.53636938309137,2628
10,13,5,5,10,11,54,0.7614554122892921,34.96339048583021,2651
7,15,7,3,17,4,53,0.8406065183604502,34.162154779480744,2660
12,19,6,2,7,8,54,0.8362910160991769,35.163722145029375,2666
13,17,5,2,8,6,51,0.8557307960855057,35.623519324702535,2678
10,17,12,10,9,5,63,0.9761635058487664,34.239569223963414,2683
13,13,10,10,7,12,65,1.005940150736607,34.21225023403317,2682
7,17,8,16,9,11,68,1.0684822995267917,33.60703615413963,2687
14,15,11,12,8,11,71,1.013407012378107,34.31405501873586,2686
4,10,6,8,2,10,40,0.9007214893613523,35.742205844169774,2702
20,15,10,8,3,10,66,0.8470812219974273,35.75803589568544,2690
13,9,5,4,18,3,52,0.7594180157597952,35.784312077567044,2696
8,3,5,4,11,4,35,0.7213017228241189,36.0720809900882,2716
9,2,5,8,10,4,38,0.7367896417772581,36.73809362765162,2723
9,10,5,5,9,5,43,0.7371974065573884,36.697838477463094,2731
10,12,5,4,7,12,50,0.8149138819543257,36.7721928453404,2751
6,10,5,4,8,13,46,0.9120252126029128,36.02857996213104,2755
12,7,5,4,5,13,46,0.9747520373258421,35.20366188743268,2756
6,8,5,6,7,13,45,0.975707006224766,36.15803710696131,2780
9,8,5,6,3,8,39,0.8868266668941469,36.94812546513169,2796
8,7,5,6,4,6,36,0.7676191777245768,38.02321759857975,2806
12,2,13,6,12,8,53,0.7677780792061529,37.31748086480521,2799
10,1,14,6,12,10,53,0.6841871923428743,37.56214569009259,2817
0,1,18,6,5,10,40,0.6784611432237622,38.05077232669693,2825
26,1,11,8,9,4,59,0.6894764673563138,38.57110484426642,2837
7,2,9,5,21,4,48,0.699955770233902,38.7909602533137,2836
5,1,7,6,7,3,29,0.7124837230034902,39.274527625455704,2857
13,14,9,6,4,5,51,0.6803014826547278,39.23948033827611,2848
5,18,12,8,7,3,53,0.6865039049629549,40.29352582803722,2826
7,14,15,10,6,9,61,0.727495364406401,38.09912174193387,2811
2,13,8,13,4,13,53,0.7613670916879213,37.28592559018312,2800
1,13,3,17,4,8,46,0.7295173285705864,37.157701196171665,2807
2,13,5,20,0,8,48,0.8071953353987341,37.699182644880025,2787
6,12,6,19,12,6,61,0.8422641599178206,39.09697918543057,2781
1,9,5,22,6,6,49,0.795334001248844,38.202415325551165,2765
6,4,5,14,0,8,37,0.7090098945310981,37.244695523817896,2767
5,8,5,9,3,8,38,0.6500812415751702,39.35306802521704,2768
1,2,5,14,9,9,40,0.6785083607079583,37.542682507798936,2781
15,4,15,15,7,13,69,0.7110381203478873,37.38686321674685,2771
6,4,13,14,4,6,47,0.7357891343643116,37.121637003553026,2764
5,15,8,17,4,4,53,0.7870964180418858,36.572725491732605,2762
4,18,9,11,15,5,62,0.8688730183193843,36.07388861610246,2754
5,16,13,9,1,4,48,0.8844171270561464,36.1729004645797,2753
0,14,10,6,3,5,38,0.7929240207077308,36.97772015427984,2771
0,10,11,8,0,6,35,0.8845983954403153,36.72107821232418,2783
0,11,10,7,9,10,47,0.781716237281646,37.07545436016961,2776
1,6,11,10,6,14,48,0.7690250589626197,37.26986404919944,2792
1,10,5,8,6,5,35,0.7316275971776429,37.71535889461147,2819
1,6,4,13,4,6,34,0.6991744229972062,37.86028839398451,2830
1,1,6,13,0,6,27,0.7072575637029276,38.21471858450549,2857
0,2,5,14,0,8,29,0.7529120869497674,38.59702808024192,2874
0,2,5,10,0,9,26,0.7338817888550242,38.789582207382495,2893
9,1,5,9,0,8,32,0.7236654294497273,39.2641044177924,2919
0,1,5,10,11,9,36,0.7502254323545409,39.10981512362261,2937
3,1,6,8,10,6,34,0.682239403586186,39.788007606391425,2960
3,4,7,7,6,4,31,0.6201252299111589,40.292934103219096,2980
7,14,5,8,6,0,40,0.66698556621979,40.42923548510574,2996
5,16,9,6,5,3,44,0.5818575442827428,40.768921766121636,3003
1,13,9,3,3,1,30,0.534219734358203,41.53161700591277,3018
0,14,2,2,1,8,27,0.5544224474935089,41.91769555613121,3043
1,11,0,15,0,9,36,0.5188271726455569,41.60917553279796,3050
3,9,0,13,11,7,43,0.4995990694896532,41.719359931312184,3039
8,3,1,9,15,7,43,0.47107362947085063,42.01122245586811,3050
3,1,1,0,9,6,20,0.40643750682974755,42.101109207458215,3062
2,3,0,0,9,4,18,0.44732623973187774,41.76945274500238,3067
0,1,0,0,15,6,22,0.4622505205295745,41.869401094870106,3064
18,5,0,10,17,5,55,0.6084963763850244,40.26069698433106,3055
0,8,0,14,9,1,32,0.5794941480811503,40.00752322510716,3037
0,9,5,14,13,0,41,0.6151249665478772,40.44854209917533,3025
0,2,7,12,11,0,32,0.6801279984653983,39.22181245586829,3002
2,0,13,14,15,2,46,0.7982044057168285,38.84466414070217,2987
3,1,15,15,14,3,51,0.7072383224577339,38.91309129854933,2956
1,1,15,19,11,5,52,0.7183910486042812,38.65903413960925,2939
3,0,15,11,0,4,33,0.5980109325856606,39.45987199231547,2913
4,0,5,7,0,3,19,0.5478593737817973,40.094727773330874,2915
5,0,5,1,0,4,15,0.45463523513692194,40.288219680592526,2935
7,0,5,0,11,3,26,0.4396542835292019,40.94327067651965,2937
11,0,5,17,16,2,51,0.4713795829571294,41.27677201731462,2949
5,0,5,14,15,1,40,0.4544048547532509,42.32166406333779,2973
1,0,5,10,7,0,23,0.4509103582439521,42.92381801710256,2990
26,6,8,9,9,0,58,0.631027480887608,41.305832825906556,2969
6,7,10,10,4,1,38,0.6007203859482302,41.60084643595123,2966
10,6,7,4,2,0,29,0.6268823484074262,41.81519557995693,2981
12,7,5,9,4,0,37,0.6280011476417066,41.993593738353226,2984
15,7,9,3,8,3,45,0.5920671294774341,42.480575107707686,2992
8,5,2,7,9,1,32,0.5608474861720233,42.947559949789905,3004
13,5,5,6,5,0,34,0.6355703567384658,42.2469085666287,3034
31,5,6,8,18,1,69,0.6572875910781144,42.06291506010409,3016
14,6,6,8,15,2,51,0.5420543055590265,42.72306625978789,3025
14,2,5,7,10,0,38,0.525299507991159,42.5549267891975,3005
9,6,5,12,9,0,41,0.5430032032509244,42.75427408477177,3003
7,7,1,7,22,3,47,0.5674473157129962,42.529939440834475,3008
8,6,5,1,15,0,35,0.5273277071589177,42.39571745177579,3010
7,7,6,0,4,0,24,0.48152724919553813,43.032887997804046,3024
15,2,5,0,7,0,29,0.5006269861326429,43.253443623689364,3037
13,0,5,0,14,0,32,0.559259796753189,42.958506230000225,3042
8,0,4,0,22,0,34,0.5846434955652225,42.84944103777859,3043
19,0,5,5,13,0,42,0.5350278454278518,43.08239765040188,3042
9,0,7,8,12,0,36,0.5353021725603015,42.55028223306356,3053
11,0,8,5,16,0,40,0.6079959177796328,41.83851344787869,3043
5,0,10,7,27,0,49,0.6491400848046537,42.10844588253185,3035
6,0,11,7,14,2,40,0.5826914887567981,41.85258297673402,3045
2,0,12,5,3,0,22,0.5468895353787493,42.62398401830646,3079
3,0,10,5,3,1,22,0.5686093926361092,43.00614052719532,3102
9,0,9,5,17,0,40,0.5517810886280986,43.331184509312486,3082
13,0,11,6,10,0,40,0.5081179631862258,43.21492014860881,3075
6,4,9,6,7,0,32,0.5071945972685086,43.42255612854333,3070
3,0,11,18,8,0,40,0.47507720113967156,43.294079278938135,3053
6,7,9,7,11,0,40,0.5797296137719962,42.356827106714896,3033
5,8,16,0,10,1,40,0.610763358571658,41.0114300716754,3028
3,1,15,1,5,0,25,0.5886706472163098,41.63056100286155,3033
7,3,15,3,5,0,33,0.5221254087016263,41.434179938562615,3032
2,11,15,1,11,0,40,0.5838442389480784,41.81478783845688,3034
4,11,7,13,0,1,36,0.6354134940449274,41.174545702027224,3039
5,12,9,16,1,2,45,0.6440376036952972,42.2656882290102,3055
5,12,5,14,0,3,39,0.7022157767803334,42.03177569799385,3056
6,10,5,8,4,6,39,0.6735428775414656,41.94430679972582,3061
8,13,5,8,0,7,41,0.6207687895506423,42.197782098930844,3071
6,15,5,7,0,8,41,0.6680695102772292,42.61042600174307,3081
7,11,5,5,0,6,34,0.6060957484075847,42.99171497455682,3107
10,14,5,5,6,1,41,0.5881250127723431,43.20769187990917,3128
1,12,6,8,3,0,30,0.5554527077508729,43.83347355265044,3140
17,8,5,6,5,3,44,0.5890944265352948,43.559351452725494,3145
11,14,6,8,9,0,48,0.6066844331167198,43.68867488583337,3147
15,13,5,13,12,0,58,0.6149043381657997,43.580108022279845,3152
9,12,7,8,11,0,47,0.6077909740054477,42.80993191944197,3144
13,9,12,7,8,0,49,0.6849198677253769,42.221731079786245,3145
11,8,10,8,4,0,41,0.6776353083940296,42.5806124619774,3155
5,10,10,10,4,0,39,0.5671856822103907,43.52559671419846,3152
3,12,7,10,19,0,51,0.5995924901761852,43.53892416038287,3165
6,18,6,4,9,5,48,0.5514740303185033,43.85685044333805,3153
7,16,5,2,6,7,43,0.561933318642476,43.93625965805293,3153
5,13,5,5,4,7,39,0.6137098506801579,44.271681590029544,3163
7,7,4,2,5,7,32,0.6040388774506135,44.72286749137987,3189
7,3,6,0,0,6,22,0.4970097217230478,45.356697618483096,3200
7,1,9,0,2,7,26,0.5283235725499598,45.36894497619025,3218
20,2,5,0,3,7,37,0.5495256110743227,44.92574953868535,3215
4,4,5,7,15,7,42,0.5466434992726671,44.91352658999509,3200
3,6,5,6,7,8,35,0.5307189316508787,45.214722760936326,3208
3,3,5,6,11,7,35,0.49993467932195845,45.7193698084887,3211
6,6,5,5,5,6,33,0.4907305023522953,45.97860548679483,3228
4,5,5,5,9,7,35,0.4358520632039455,46.43492307729686,3225
1,2,6,5,10,8,32,0.44049989375095755,46.31829163824537,3248
0,9,5,7,3,7,31,0.44480886502669115,46.16595229018855,3270
1,10,5,8,3,6,33,0.41429334900063924,46.455038906571794,3269
1,11,5,11,10,9,47,0.4579156512111679,46.289552195261024,3273
1,8,5,13,0,12,39,0.4632866064293523,46.2088427788284,3272
0,7,1,12,1,12,33,0.4810841097213222,45.253765660621525,3270
0,13,7,16,0,12,48,0.5429132109267204,44.57827591648755,3260
2,14,6,14,8,14,58,0.650276527171205,43.74410618152792,3263
14,15,5,13,5,14,66,0.6986423530589692,43.128260370269274,3235
4,14,5,14,10,18,65,0.7876381690158818,42.60828770886486,3230
1,11,5,16,9,16,58,0.7346293656213909,42.22000327557739,3206
3,12,4,17,13,16,65,0.6620094171013243,42.68100408844467,3173
1,10,6,16,15,16,64,0.5979234859977026,42.964807558376044,3132
1,14,7,12,17,13,64,0.5346522767668059,43.16000388339365,3117
0,9,6,14,15,8,52,0.4389581817629027,43.86627633333912,3098
0,3,9,8,10,13,43,0.40879332176232647,44.28041624951029,3091
0,3,6,11,13,16,49,0.4507780059579104,43.640234239430974,3093
2,7,12,3,9,10,43,0.35946957236396276,44.451306386863195,3087
0,7,7,2,1,10,27,0.3145564063752525,44.915876173540056,3087
0,5,11,3,0,6,25,0.3437748660314841,44.94329665176095,3097
0,4,11,0,0,6,21,0.3283151866322167,44.78975757083706,3092
0,5,13,13,0,5,36,0.3265790152412859,44.66373867033576,3086
3,4,13,13,13,1,47,0.37996304054550656,44.26377675933045,3077
2,2,15,14,14,0,47,0.428995835655195,43.9390104672751,3069
5,5,15,13,10,0,48,0.44069749471774483,43.61799161467017,3064
5,7,15,13,10,0,50,0.4921055248792279,43.067103345933674,3050
1,8,15,11,2,0,37,0.4884110474808215,43.12602970276995,3041
2,6,15,7,5,0,35,0.4665534570423084,43.49223471694154,3040
5,6,10,5,2,0,28,0.3881494808915763,43.82098876112284,3054
5,7,13,7,6,0,38,0.3935106688896294,44.25899212359044,3061
21,3,11,7,13,0,55,0.4352529983388002,43.49359301549171,3044
29,5,9,1,9,0,53,0.4211143679988229,43.36459202625141,3032
10,5,6,4,11,0,36,0.41008020470481754,43.690555166730974,3031
14,3,9,4,9,0,39,0.42996428356603417,43.55612233172068,3025
9,3,10,9,9,0,40,0.4120710432874668,42.9593516116336,3020
3,2,5,12,10,0,32,0.4699182330514629,43.44558465439894,3030
4,3,6,13,9,0,35,0.4971996149847539,43.59397940622448,3040
3,1,12,7,12,1,36,0.4921878280047684,42.92036012489802,3043
26,0,10,10,16,0,62,0.5583991085451577,42.68913378976334,3035
10,0,10,5,9,0,34,0.5782825615952292,42.640751724348426,3036
16,0,12,4,7,0,39,0.7279436159771755,41.468423983989446,3048
13,0,10,3,16,0,42,0.7989206298906578,41.54556735140367,3081
7,0,7,6,10,4,34,0.7386996512471689,41.65444698089539,3082
9,1,5,4,16,7,42,0.7035270488936054,41.40077173672181,3086
10,4,7,4,10,7,42,0.6686381926246123,41.73550450928136,3090
11,4,10,3,8,6,42,0.592349091595616,42.15770012732724,3088
11,6,10,2,7,7,43,0.5841144631682987,42.40453324106875,3100
7,4,5,8,7,6,37,0.5725980385353168,42.79341913597184,3103
7,2,10,0,6,4,29,0.5697207689995466,42.64972478920165,3109
6,4,11,0,28,5,54,0.6353931522241876,42.617728294280546,3105
8,11,10,0,22,5,56,0.716004559190548,42.09259620540533,3106
7,16,10,0,11,6,50,0.8064999521505559,41.49452127233096,3113
9,17,9,8,11,9,63,0.8298881986896574,41.05153902341172,3110
9,12,5,3,11,8,48,0.803279995574231,41.28716703210429,3132
38,11,7,8,14,7,85,0.8058521647695333,41.5039210380018,3128
13,12,7,7,18,6,63,0.7604777642109518,41.61395424059567,3145
12,15,7,7,10,7,58,0.7881321503479173,41.45471700406899,3142
23,12,13,8,16,7,79,0.805535292669686,40.77096334519589,3128
20,11,13,7,18,10,79,0.716720056131623,41.703375461620006,3128
14,11,12,5,16,6,64,0.6127546527152489,42.44768708695135,3109
10,11,6,8,13,8,56,0.49777557563864805,42.82255114015601,3090
5,9,10,6,15,10,55,0.5261050747762458,42.60034667249189,3082
5,14,11,7,1,9,47,0.5871104981772821,42.10483934450352,3071
5,9,10,8,0,12,44,0.5989866571541408,42.18614312455946,3070
5,18,10,10,0,11,54,0.574321368469369,42.0584749575369,3047
5,20,10,13,0,11,59,0.5646381323395903,41.57959837289266,3041
6,19,6,13,1,13,58,0.7304101809503629,40.50057203373411,3042
7,18,6,14,18,10,73,0.7321384887298881,40.96630286249679,3012
23,7,7,14,16,7,74,0.7423632058676235,40.574221454217096,2996
14,12,9,12,7,6,60,0.7807941015384219,40.375814312805495,2994
8,11,5,8,7,6,45,0.7609048869646057,40.74822228590302,2999
4,15,15,4,8,6,52,0.7865216194948668,40.7244643513503,3000
5,8,6,7,5,5,36,0.7484925539166221,40.69170609514182,3006
8,10,7,4,26,5,60,0.8749073129665724,40.15757587095083,3014
6,9,7,3,33,6,64,0.8565992985310412,40.666862784076855,3019
10,12,7,4,20,6,59,0.8214319702202644,40.948302798713755,3038
7,6,13,7,13,5,51,0.7721200501403056,41.73987420407352,3053
7,7,11,2,9,0,36,0.7244590076857842,42.09452611222193,3070
5,6,8,6,12,1,38,0.7094550878633402,42.25297186221875,3081
7,5,12,3,13,1,41,0.5893068494605618,42.94604103762641,3094
7,5,11,5,8,0,36,0.5113443525295246,43.5165604277052,3106
6,16,12,8,3,0,45,0.5437985386019575,43.350050051990095,3118
23,17,11,6,18,0,75,0.6600374705186596,42.06566061750137,3109
32,20,10,5,16,0,83,0.7143573161458893,41.49922795047464,3084
27,19,15,8,9,0,78,0.7847605494956001,40.552243958484354,3074
16,5,15,5,6,0,47,0.7109251778461508,41.06544962769534,3068
10,5,15,8,14,0,52,0.6554792496734487,41.66104344089906,3074
12,2,15,2,4,0,35,0.6312617044338441,41.99898505472859,3087
7,1,9,3,7,0,27,0.6168163737868922,42.44061122068462,3108
11,0,5,3,9,0,28,0.5815228061075792,43.03686268933034,3127
7,0,6,1,14,0,28,0.490143073924727,44.204840824506284,3148
7,0,7,7,16,0,37,0.49261712855097234,44.85007700031543,3170
12,0,5,7,5,0,29,0.4902660004533368,45.13658747986877,3197
13,0,5,10,5,0,33,0.47122311044402226,45.9646003923318,3222
8,0,5,5,7,1,26,0.3485329611292248,46.5528147420268,3232
0,0,5,6,5,0,16,0.2937188640873226,47.017900757946144,3243
16,0,6,5,8,0,35,0.3089213913689136,46.98173506919857,3239
6,0,7,5,10,0,28,0.34804054046381233,47.13148296898307,3245
9,10,7,8,18,0,52,0.4024135827850341,46.551958202737445,3242
6,11,9,7,15,0,48,0.39450907006061103,46.740463507886616,3246
8,15,5,7,8,0,43,0.366792579722894,47.31060181501919,3256
8,11,8,8,11,0,46,0.3458824071592095,47.602505324193594,3265
11,14,10,6,7,0,48,0.4359240698840207,46.238561225934944,3270
6,13,10,7,10,0,46,0.46263070251258703,46.07728010517993,3263
11,12,10,17,4,3,57,0.47264322398754305,45.86325733431296,3260
16,14,10,20,8,7,75,0.5190934538127175,45.56609337780009,3258
9,3,6,21,14,7,60,0.5271915081705961,45.35441216364439,3245
8,5,7,22,10,6,58,0.5992150625979145,44.55119752887673,3225
8,0,5,22,4,7,46,0.6030027576753068,44.628363971878535,3219
6,0,5,23,2,9,45,0.6153150644921107,44.3605714602101,3212
23,0,5,19,8,10,65,0.6638709544700075,43.67286105626178,3191
11,0,6,16,4,8,45,0.6462553889194848,43.905337775328746,3192
12,0,6,15,5,8,46,0.5695334886406391,44.23180508903102,3181
9,0,5,15,8,1,38,0.5032638433343912,44.509079702327476,3192
11,0,6,6,13,3,39,0.4695281184323821,44.714395306224745,3186
5,0,0,1,17,4,27,0.42332104028550954,44.948283787694386,3201
3,0,8,8,20,4,43,0.47961841739366917,44.620225669343725,3184
4,15,6,0,13,3,41,0.6113076967080446,44.03749422300518,3181
0,17,6,0,6,2,31,0.8162457314393249,41.8199430618515,3186
8,12,6,0,18,3,47,0.9561905922466042,40.96414097109639,3171
10,17,4,0,21,5,57,0.9729450218404014,40.972382768195814,3169
16,5,6,0,20,6,53,0.9029034016794988,40.462521388531755,3177
13,7,6,0,20,8,54,0.8075922901843111,41.16525459201153,3190
4,8,12,0,9,19,52,0.6593024129517187,42.42810224902874,3192
8,10,12,1,17,11,59,0.6731613108607629,42.770223799408775,3187
11,9,8,5,15,9,57,0.5827419878865121,44.08821516163406,3195
7,6,8,7,0,9,37,0.5413536486198054,44.57525939084983,3199
8,7,10,4,0,10,39,0.5217420314636423,44.32682291444182,3198
26,4,9,5,3,6,53,0.5276748392035006,44.99828693276129,3182
10,7,10,5,0,7,39,0.596766549695799,44.546850851380505,3184
9,6,10,7,3,7,42,0.5808321747523324,44.945364832836596,3166
7,19,7,7,5,7,52,0.6708614380705058,43.78288616309442,3139
10,19,10,6,8,7,60,0.7171131374810265,42.60292918326486,3124
7,22,12,9,6,14,70,0.7206130576988149,42.643270059054,3087
7,12,15,13,3,18,68,0.7135593386888782,41.84859433645724,3058
5,17,15,13,2,13,65,0.7884988566657725,40.8551197884959,3045
6,22,15,19,17,18,97,0.8587341809276363,40.315459579511675,2996
2,19,9,11,17,17,75,0.8451296100851334,39.95342465626641,2978
6,16,10,17,12,13,74,0.779940770498117,40.058452306299735,2971
9,19,10,19,5,5,67,0.7691568989729902,39.71005479117569,2958
13,16,8,21,7,10,75,0.8269836936593515,39.02439153621963,2936
6,15,5,19,5,15,65,0.7930286142654331,38.64154413509874,2912
14,21,6,13,10,18,82,0.7917417186454999,38.330369784534405,2886
9,18,6,4,10,11,58,0.6994795219995802,39.178861564841775,2876
16,22,6,4,18,10,76,0.6552001433874113,39.65798156511723,2870
15,21,5,3,18,7,69,0.6664195741738788,40.091901617116,2858
11,13,5,8,20,10,67,0.6557664690336877,40.29312379400951,2852
12,13,5,5,9,12,56,0.6936599186175323,40.034489014612994,2856
16,10,5,4,12,12,59,0.617660121748726,40.42923036800862,2848
13,11,6,3,9,11,53,0.5703390951998254,40.51624498837966,2848
10,10,10,4,9,8,51,0.5620364418760792,40.530766221713876,2847
7,8,12,15,5,6,53,0.573532339884139,40.085423255269234,2846
17,3,10,16,4,11,61,0.6790041096085839,40.923238011929016,2845
5,9,6,16,4,12,52,0.7050514065060751,41.13575719904732,2842
7,9,5,15,2,17,55,0.7404598352969535,40.4943575228281,2828
5,7,5,15,5,15,52,0.7165146748471618,40.26905722203876,2811
6,8,7,13,0,15,49,0.6327459345445289,40.35293738484677,2806
5,20,6,10,4,13,58,0.6355890821009516,40.47669031314344,2804
4,19,5,7,10,14,59,0.6911586474767493,39.96720235763756,2801
5,18,6,11,5,9,54,0.7067665679049481,40.09748748151108,2803
5,10,5,7,11,9,47,0.7206800728737783,40.14321948555956,2801
3,7,5,6,18,7,46,0.7328263013074976,39.79801397865652,2784
0,6,5,11,13,5,40,0.7138241079572306,38.99786931175875,2784
0,7,0,8,7,7,29,0.7265839436132708,38.54885783670087,2782
0,7,6,0,8,7,28,0.7602907579237294,38.059896246432245,2786
0,6,7,1,1,7,22,0.7871246749593851,37.5403689189284,2804
1,6,6,0,21,5,39,0.8534391044256258,37.05599376159134,2797
13,6,9,4,27,9,68,1.00646086847081,35.90683745347389,2803
20,7,8,2,26,12,75,1.1543941141787424,34.94549483767309,2824
10,8,9,2,17,6,52,1.0956418883911985,35.328886048329124,2842
6,7,12,3,7,11,46,1.012143836678086,35.29912942513444,2862
10,4,5,2,6,12,39,1.0976636115971745,34.40981742795741,2874
9,5,6,12,5,9,46,1.0708441814044125,34.75988568861534,2878
11,18,6,9,4,5,53,1.0315091728062533,35.234060861951896,2893
13,22,8,4,5,2,54,1.0254182454316874,35.93702711802407,2886
14,22,6,8,5,13,68,0.9506785009689612,36.44878789404159,2885
4,18,5,5,7,15,54,0.8312067417605373,37.39471708945186,2894
5,13,9,5,5,13,50,0.7479827690269064,38.76051446488128,2938
5,15,7,6,5,11,49,0.6029480285894657,39.90434600938628,2936
6,13,8,6,6,16,55,0.5879064450748325,40.51350295405886,2946
4,13,6,8,8,10,49,0.5542970133294808,40.765182564143856,2943
6,11,11,7,9,5,49,0.5640074682060839,40.570640804141185,2939
5,3,15,6,7,7,43,0.6008931974289154,40.71387475552449,2920
3,1,15,10,10,8,47,0.6367879821852437,40.32091531881656,2902
8,3,15,18,13,7,64,0.7188077652259038,39.17921875360741,2887
13,3,15,13,8,9,61,0.7592661941083741,38.632895013534096,2895
6,1,15,16,6,7,51,0.7062855554306995,39.0718161876506,2895
5,3,15,20,12,8,63,0.6897053103080764,39.04380859542204,2874
7,2,6,21,12,6,54,0.7073695488154449,38.43743263616018,2845
3,9,4,21,15,6,58,0.7201482929663094,37.58369965634264,2816
4,9,11,21,5,5,55,0.6101785513529823,38.470026101378174,2813
2,11,7,3,1,5,29,0.5951664642481497,38.512873889054084,2818
0,15,10,14,4,2,45,0.7085823261735071,37.80414498788886,2822
0,15,8,18,1,0,42,0.7908997964752008,37.478152817620305,2826
1,14,5,12,0,1,33,0.78693831743606,37.49712066388023,2834
0,15,5,6,0,0,26,0.8092627973232579,37.43617468808009,2844
0,20,5,10,0,1,36,0.8476923376578595,37.23182086236588,2842
0,19,5,14,0,4,42,0.8500735939718086,37.751623664566125,2863
0,19,3,4,0,6,32,0.7759669684601246,38.70034365011513,2891
0,16,2,4,18,7,47,0.765095413676584,39.16686771059359,2885
1,19,9,7,19,7,62,0.8527206388874642,38.87472897045642,2913
2,17,11,8,14,6,58,0.7579172845714048,39.5965206605645,2906
2,14,11,13,9,7,56,0.6866394227749493,40.5541841680849,2913
1,6,7,5,7,7,33,0.5832684462398985,41.09487372971268,2929
0,6,5,4,5,6,26,0.5539816302995121,41.6659168400943,2950
9,2,5,0,18,6,40,0.6067242756167269,41.38180297869726,2945
12,0,4,4,25,5,50,0.7640234157051574,40.215472353720095,2942
11,0,4,10,24,6,55,0.7011134426130929,40.52469708817784,2946
7,0,3,11,12,9,42,0.7203275406380946,41.36459581664592,2965
5,0,5,13,19,6,48,0.7552667956365169,41.70180653214016,2972
28,0,6,7,20,10,71,0.7397074376149128,41.41807148736245,2973
15,0,5,10,26,6,62,0.6827725090638226,41.125220843601554,2982
6,16,6,8,22,1,59,0.6353813138643519,41.71422395887939,2986
6,22,1,13,8,0,50,0.6547714511652003,41.27610839076982,2985
5,22,7,9,2,3,48,0.6297843674167479,41.2570435874098,2995
9,18,5,15,1,6,54,0.6415434731820682,41.646342937293824,3004
11,0,8,16,2,9,46,0.6794323212535337,41.59236273942524,2997
36,0,10,14,17,7,84,0.8086407315582772,40.38487845241836,2970
30,0,9,12,21,9,81,0.8596976424939917,39.542913287831745,2939
22,5,12,10,11,9,69,0.7994043344065894,39.33572965674486,2918
13,7,12,15,15,6,68,0.9541270560322519,37.50630080015105,2874
14,12,12,10,23,8,79,1.0675331457875188,36.499680149931635,2862
13,10,11,19,23,8,84,1.1541885699666559,35.8518395963504,2833
10,5,8,20,9,5,57,1.0194859331115194,35.98635461625706,2818
15,23,6,21,4,5,74,1.0164267690151316,35.88460994079593,2779
9,24,7,22,21,1,84,1.0225042011067367,35.23532793695298,2745
24,27,7,22,20,9,109,1.0014041886376106,34.99379912886041,2703
16,28,7,22,18,7,98,0.8543734345951636,35.2918081373514,2657
17,22,5,9,7,7,67,0.8081495922490144,35.70414881143478,2641
8,19,5,16,21,5,74,0.9390649617032859,35.146683489010286,2619
11,17,10,10,12,6,66,0.9197799712004284,35.08278650792644,2617
7,18,10,16,7,5,63,0.9279240433686498,34.46118477089804,2610
12,22,12,10,2,6,64,0.9166400163739477,34.26553002388483,2595
6,19,11,3,9,6,54,0.892756928177353,34.09201396014805,2594
9,15,10,2,6,5,47,0.8285764978260368,34.72775147913183,2597
7,10,10,13,11,6,57,0.8845645095340774,34.558394104827094,2611
13,13,10,15,10,6,67,1.02986567138213,34.243453249562705,2603
10,19,10,9,22,6,76,1.142643620113884,34.28569078404441,2599
7,17,4,13,11,6,58,1.1996632979483295,33.95943796804696,2601
7,17,8,11,6,17,66,1.332052630022206,32.86140693876301,2607
15,7,6,13,8,17,66,1.3354298988168134,32.79036507635869,2611
11,10,7,13,6,15,62,1.2925260750122218,32.81878547128775,2625
6,13,8,8,18,15,68,1.3716530959062594,32.45422823339041,2621
20,12,9,2,20,9,72,1.3111780066982706,32.62327047397031,2628
23,13,9,7,12,6,70,1.2383872183074147,33.61954934073363,2644
7,11,6,7,13,12,56,1.234130520058447,34.081104449279984,2665
11,8,4,12,15,13,63,1.1554695568461057,34.784145363812684,2679
4,21,5,10,18,8,66,1.0954315823369956,34.656752947429155,2668
5,27,7,11,16,7,73,1.07647981910658,34.842882392886324,2660
3,27,5,8,15,9,67,1.0309306758534331,34.93207453564909,2665
0,27,8,9,11,7,62,0.9283402092838333,35.766644523884075,2673
4,10,11,7,15,10,57,0.8449340210856463,35.63483346134703,2669
6,7,15,15,4,17,64,0.8962619040147819,35.66771119962995,2682
1,8,15,21,7,22,74,0.9123173822148322,36.082470164265374,2682
11,8,10,21,0,14,64,0.7787104125274126,37.11683604913261,2667
1,6,10,13,0,10,40,0.6318605016312863,38.03143064367019,2675
1,6,6,13,0,14,40,0.5112616459986272,38.38366737463464,2671
4,1,5,7,15,15,47,0.48865666811886355,38.65822210153246,2671
6,2,6,15,21,14,64,0.5927612358371046,37.724881988676565,2665
7,1,5,10,12,3,38,0.532329809077519,38.35448511724046,2669
10,24,6,9,7,1,57,0.5501812398114018,37.74018644160218,2655
7,25,5,10,10,3,60,0.49838659507801825,37.473317171664306,2636
5,22,5,12,4,9,57,0.5073359346854447,37.40784491373572,2605
4,23,5,13,6,13,64,0.568973263135768,36.554979072059915,2578
10,20,6,9,7,20,72,0.7227981277092821,35.65050328244521,2565
16,23,5,13,7,16,80,0.722749062566444,35.33520194420871,2549
9,18,5,11,8,19,70,0.6854485201623187,35.16415886061107,2526
2,16,5,8,19,20,70,0.699243838268764,34.96163456400211,2517
20,18,9,10,1,11,69,0.7190375605628417,34.573801353528694,2504
17,21,11,6,15,11,81,0.7680392794299784,34.32742461723801,2475
13,20,9,7,11,6,66,0.9355032426248853,33.44299126989904,2478
16,20,9,15,7,11,78,1.0109564559357356,32.4451257373334,2464
21,24,9,23,8,11,96,1.0602417800104338,31.875816016455783,2436
14,26,7,20,6,8,81,1.077215421078984,31.450674159001355,2437
16,23,7,5,7,11,69,1.107245884800095,30.743476063904843,2429
12,18,6,7,19,10,72,1.1900691489392041,30.89444126496076,2439
13,18,9,7,19,6,72,1.228696251866088,30.665468191345393,2415
10,15,5,2,13,8,53,1.2482472757442657,30.970003458545097,2430
11,15,4,8,9,6,53,1.2704751398551384,30.932512777163875,2426
10,15,5,8,8,12,58,1.2439343425993608,30.72515099160604,2411
9,15,6,4,6,14,54,1.1085267838025414,31.59215135093616,2423
7,18,12,5,8,10,60,0.9678135477884647,31.996269985519408,2439
23,20,11,8,11,10,83,0.9424780630908359,31.572131314037883,2443
8,23,6,7,14,10,68,0.899019046438846,31.98501428193981,2468
6,21,5,14,9,9,64,1.0615806277957454,31.73012301003815,2472
5,15,6,14,7,8,55,1.114253475425903,31.67777484636202,2481
6,11,5,13,8,6,49,0.9767899719368901,32.09962714125711,2491
3,7,8,12,7,10,47,0.9260143961238353,32.70605955828694,2504
7,4,4,11,22,3,51,1.0143277953838108,32.89837307514292,2535
9,3,5,17,23,8,65,1.0201288267756417,32.639837321743904,2536
9,5,6,16,22,10,68,0.974886731575452,33.26464855105241,2534
11,3,11,3,7,13,48,1.0460360679429632,33.214614871591245,2560
9,4,10,9,20,7,59,1.173727381182789,31.782237685554477,2552
13,4,14,15,21,15,82,1.241088753014628,30.94672108062707,2554
6,4,12,8,10,12,52,1.1178819324996299,31.118740414785517,2548
7,7,11,14,12,16,67,1.0900667188763977,32.24754422062048,2556
3,6,11,18,12,14,64,1.045561486072636,32.639491825058904,2564
34,6,10,14,12,13,89,1.1277137006320062,32.088698259102244,2552
32,9,8,14,12,7,82,1.0842810621114036,32.68908935969855,2541
12,6,5,10,13,8,54,1.0293695416921567,33.38155882663904,2569
11,7,12,7,12,5,54,0.9556944399707292,33.72978121578123,2576
13,6,12,8,14,0,53,0.8275107892846232,34.40028810723355,2576
6,7,10,7,10,0,40,0.7701031724065697,35.02865690491865,2569
6,9,9,7,13,0,44,0.7830103839477809,35.1888354843615,2575
9,8,10,8,8,0,43,0.7892885641151145,35.040460281436054,2578
12,8,12,7,11,0,50,0.7512644332261061,35.05234409513917,2573
11,6,16,7,9,0,49,0.8593782370049313,34.638712479324475,2575
5,3,15,5,12,0,40,0.8179873534379407,34.670286687229286,2569
7,5,15,13,9,0,49,0.8058248828481506,34.465705163284866,2559
3,6,15,13,9,0,46,0.7609193705464659,34.83524208208346,2544
1,5,12,12,5,1,36,0.6711086482696876,35.625676890729096,2543
7,20,11,8,0,1,47,0.6587884725877823,35.36795584879674,2537
0,16,10,12,0,0,38,0.6472599725283711,35.34805850170479,2539
0,15,10,13,0,0,38,0.6472218834795146,35.28104970653641,2541
1,11,10,12,0,0,34,0.6380526192279827,35.116768904197,2530
0,15,10,8,2,0,35,0.6617087849106487,34.610130662658925,2531
1,15,8,2,1,0,27,0.6714510910250515,34.96641750459357,2537
1,18,5,10,6,0,40,0.6906614040684635,34.995985418207006,2551
1,18,6,7,10,0,42,0.7251447144590784,34.35460240908224,2554
1,15,5,8,5,0,34,0.7634524235022176,34.360582769886,2563
2,12,8,3,5,0,30,0.8252102945680085,34.315269256324,2574
5,15,5,10,4,0,39,0.7584890800585958,34.73250118625956,2573
3,12,5,7,8,0,35,0.745853644398612,34.56040747034105,2582
2,13,11,5,19,0,50,0.8494513202852215,34.53365073902798,2590
4,14,11,6,9,0,44,0.8470251417284571,34.348544004038324,2606
2,19,7,4,12,0,44,0.8693097735396453,34.96179212065037,2628
0,15,11,6,8,12,52,0.8431353762236652,35.373019349588766,2640
1,14,7,9,8,10,49,0.7910784713914788,36.3447907552036,2650
0,16,7,10,3,11,47,0.760041459383567,36.67818092723106,2661
10,8,8,14,21,7,68,0.8301686759167176,36.39193519606892,2643
12,10,7,15,28,8,80,1.034635803340092,35.49525553680916,2640
20,10,1,12,25,11,79,0.9588523573950876,36.22975425542454,2671
17,20,0,17,15,10,79,1.0247029668448575,35.60876963892664,2666
17,19,1,13,26,11,87,1.1004894583941616,35.273147764410076,2683
15,16,1,17,28,12,89,1.0762327895532875,34.96841965523933,2672
14,13,7,18,22,14,88,0.9815923085548878,34.41018266953803,2635
16,7,5,3,17,12,60,1.023920422837944,34.6745313196712,2652
35,14,5,7,11,12,84,1.0801891365176888,34.69460338723292,2650
7,12,5,14,10,16,64,0.9796557623985903,35.040483286758906,2647
7,13,5,14,12,10,61,0.8780343755972139,35.49559158234403,2650
7,11,5,11,9,11,54,0.757260491440246,36.244313044940604,2645
32,13,7,7,11,16,86,0.818405038586962,35.41796757938694,2619
31,11,6,7,22,15,92,0.7346629510435808,36.03007708089916,2600
13,12,5,5,18,7,60,0.6500801484338455,36.2436026592523,2580
13,9,6,5,9,7,49,0.6706586506388991,35.650363050029796,2576
3,16,6,6,9,5,45,0.7544634238789423,35.08254592610561,2570
6,12,8,6,11,0,43,0.8639035846160503,34.38758234633125,2567
4,11,10,11,7,5,48,0.9655665405291127,33.63076914745924,2565
3,15,13,17,12,8,68,1.1284570040654271,32.431070411573124,2549
6,12,11,18,15,6,68,1.1743439872955113,32.91746641216613,2539
6,8,12,9,10,8,53,1.0461657501650965,33.073524535483116,2537
3,10,8,11,5,6,43,0.9172207151156078,33.53912993671442,2541
0,18,8,9,7,6,48,0.8864182089328155,33.953975527632,2574
3,21,7,6,7,6,50,0.8822494675764756,34.23120670013459,2600
1,21,6,7,1,6,42,0.8881810361962794,34.53649932171979,2611
7,24,7,6,17,7,68,1.039959370391747,34.05631833655379,2621
14,16,5,5,21,6,67,1.201250987280303,32.790799345421796,2612
18,17,5,6,23,7,76,1.2280413430162058,32.6069758159954,2624
20,15,5,6,23,5,74,1.2799129232281072,32.56241561597763,2622
17,15,5,5,18,11,71,1.183911829761435,32.64994190643982,2633
14,14,5,11,8,14,66,1.1175575090420504,33.31663178670608,2634
17,11,5,10,16,12,71,1.0584599300823025,33.91725152267006,2651
18,5,10,10,16,12,71,1.0086850286999063,33.979231849375644,2650
17,1,16,6,14,3,57,0.9054581060080243,34.91735856106401,2665
15,2,13,7,13,4,54,0.8379136886291215,35.43330101121344,2673
14,0,9,7,11,2,43,0.6750503181995455,36.555754111934434,2681
12,0,8,16,10,1,47,0.6885005585178108,36.161245807641635,2693
12,0,11,19,8,5,55,0.7699056215842938,36.234993872872735,2708
6,0,10,20,9,6,51,0.6492654800707596,36.88175933026293,2699
7,20,10,23,5,7,72,0.7179921045156648,36.087921983261886,2680
4,21,9,22,5,1,62,0.6643024268671422,36.86761345745391,2680
28,22,9,20,4,2,85,0.6482862626229116,36.269927819276504,2643
8,15,11,14,5,2,55,0.638229259628154,35.889505986983664,2617
8,11,6,15,0,5,45,0.5774197003390343,36.066106035899836,2596
5,15,6,15,6,7,54,0.5951660312472578,35.96646501675363,2581
4,12,6,15,3,9,49,0.6296443519797698,36.03877657778838,2574
5,9,8,16,7,8,53,0.6597186567573703,35.18367551586779,2556
6,7,6,14,7,6,46,0.6711311404785504,34.666868179076786,2532
5,9,5,10,5,7,41,0.6105993687834864,34.680255364940784,2515
5,16,6,13,7,7,54,0.7650160337281882,33.745211179298934,2510
4,22,5,5,7,6,49,0.88139177520291,33.32063878919662,2502
2,24,5,7,14,6,58,1.0554994540700733,32.5739346386422,2486
3,24,7,10,14,5,63,1.1501110765718676,31.579283425548972,2478
1,23,5,13,10,5,57,1.3664858245694034,30.06870814307467,2487
0,19,14,8,1,7,49,1.386771194170165,30.542501881518255,2497
0,16,12,8,19,6,61,1.511202698539078,29.548484912511935,2528
6,15,13,9,21,5,69,1.6098720866514604,28.89007989628528,2531
4,16,9,11,21,6,67,1.561053967107853,28.831684840638605,2538
12,11,12,7,14,5,61,1.4737932001914156,29.426887077877492,2569
6,12,9,6,23,20,76,1.5085227483588894,29.086116884609247,2578
2,11,9,8,23,11,64,1.3808644792862763,30.223396978386283,2606
3,7,8,3,14,13,48,1.2821712559920277,30.507488011482433,2605
6,7,12,17,12,10,64,1.255714386014157,31.219250299313273,2606
28,12,10,21,13,6,90,1.2480244800790472,31.969733775047896,2591
35,7,10,12,15,10,89,1.2932164549143594,32.01791967735289,2593
20,10,7,13,17,9,76,1.1839889668854355,32.98526542852998,2594
12,21,10,8,12,10,73,1.1674112763098974,33.153976098661694,2602
4,25,11,7,11,9,67,1.139908856363208,33.272820646358866,2601
1,28,14,8,8,15,74,1.1157057793773866,34.38929220823071,2619
11,28,14,8,23,14,98,1.1059540100515262,34.312939001538496,2611
2,18,15,7,6,20,68,0.8976868045653429,34.60161275926752,2594
2,25,6,7,2,18,60,0.9916529001843609,36.26598349567547,2612
6,24,5,7,1,18,61,0.9298255502205163,37.08250071015117,2630
0,13,5,8,21,15,62,0.827687599471039,37.23239902736529,2623
17,12,5,18,20,15,87,0.9089877351930965,36.17379635427367,2594
14,19,6,19,12,19,89,0.8607220343450427,35.956742510875415,2564
7,22,5,22,9,15,80,0.8596606993879814,35.45391902007672,2534
