throughput_KLONGTEI,throughput_KASEMRAT,throughput_NARANONG,throughput_SUNLAKAKHON,throughput_RAMA4, throughput_ATTHAKAVI_RAMA4,throughput,mean_speed,jamlength_percent
0,0,0,0,0,0,0,7.796983285317651,0.0
0,0,0,0,0,1,1,9.409419024932502,0.007485576416905071
0,0,0,0,0,0,0,9.788276901679186,0.03532087085456184
0,4,1,0,0,0,5,9.972230517427812,0.035320870854561835
0,2,1,0,2,0,5,10.000784192466332,0.03948607857074809
2,1,0,0,1,1,5,9.662738847393706,0.15478087660048565
0,6,0,2,1,0,9,9.578793906180671,0.18921536640732073
1,4,0,4,0,0,9,9.19819699102583,0.3101513613920554
2,9,2,8,1,6,28,9.514615240020655,0.24413662534036176
0,2,5,3,1,0,11,8.899214112156796,0.42654951028431226
8,9,1,17,1,3,39,9.439879272203967,0.3329249050005176
2,6,1,3,4,4,20,9.071428873483327,0.49318025701531315
9,10,4,5,8,5,41,9.308967642906172,0.4786325645771271
0,7,5,4,2,3,21,8.54031032897083,0.6994028062355901
0,11,6,2,13,3,35,8.318239946768806,0.984365177171016
28,7,10,6,6,5,62,8.139966451991087,1.0710403099800931
7,12,7,16,7,2,51,8.030034154253055,1.1641036047764626
9,9,6,0,14,10,48,8.604546152143655,0.9783674898492998
12,8,9,7,9,7,52,7.972911879295287,1.3250545110199934
3,8,6,6,10,3,36,7.413915592291075,1.6242180558418673
2,16,3,2,7,4,34,7.095347887236775,1.7703614699740986
0,7,9,3,3,12,34,6.561167764966907,2.14084514594138
13,11,4,5,1,2,36,6.554428786046017,2.3255512277108243
9,10,1,5,2,15,42,5.914631621546315,2.681512376912317
8,11,9,3,28,8,67,6.461369902791546,2.6076440311387628
7,3,6,5,5,6,32,5.677230872203757,2.924732890894465
11,14,5,6,11,12,59,5.693743321930017,3.0736496684166057
23,6,1,2,19,7,58,5.642986539626533,3.1420573996616254
0,10,8,2,7,11,38,4.709651590304201,3.7590762111557696
8,9,4,5,13,5,44,5.009373410115883,3.908305978315522
18,13,1,2,12,14,60,5.373564766622454,3.520370930933592
4,3,9,7,6,11,40,4.853950158847797,4.052224842839775
9,20,5,0,11,5,50,5.065497279414212,3.9483169628417403
9,5,7,6,17,13,57,5.173849176422957,4.038425087038312
8,17,9,5,9,6,54,4.97699283936394,4.195653986984213
8,7,6,5,11,11,48,5.030818592015999,4.201156177043705
22,15,4,7,8,7,63,4.90978600589218,4.427163944367227
11,7,11,3,16,6,54,4.3717603824684765,4.945998793981347
0,17,11,7,13,7,55,4.261124220119876,5.059465048663263
18,8,6,4,7,5,48,4.264354827518153,5.563284955113813
8,13,3,4,17,2,47,4.4135119645320415,5.559061743535427
20,7,2,2,11,1,43,4.075072951449611,5.77673291906123
5,6,9,9,4,4,37,3.7873757653311717,6.309974246450414
7,7,2,5,6,7,34,3.802908681457301,6.672225561418729
7,14,3,9,7,5,45,3.623924786816507,6.989626683335659
0,9,1,4,17,6,37,3.393562439812276,7.3852425631149785
14,1,2,7,4,0,28,3.252364188678357,7.786540822120145
15,18,6,4,9,5,57,3.216563156686103,7.586469433295865
10,12,5,5,8,1,41,3.298164973785054,7.553390323538061
8,8,1,2,11,6,36,3.151624041522528,8.206621726069462
12,8,11,5,13,0,49,3.431659579743688,8.324168210531274
17,11,7,5,12,5,57,3.3946781112977145,8.545485744815577
6,6,4,6,6,5,33,3.2007107110975257,8.569409299267184
9,8,5,6,15,0,43,3.358905415624154,8.863995416886326
17,8,0,7,8,0,40,3.271005328392612,9.276440809546962
8,6,7,4,15,0,40,3.0283715224940146,9.971463950772272
20,8,5,7,6,0,46,2.977224133382214,9.897734251000708
0,11,5,7,12,0,35,2.6367060652586973,10.367526366353475
9,7,0,9,9,0,34,2.5596173708266843,11.180036563023522
19,6,11,5,6,0,47,2.4868887875859063,11.320353054257849
5,7,13,8,19,0,52,2.4453745830031175,11.326015504364271
17,6,4,3,2,0,32,2.1729163244609637,11.56002246843705
9,4,10,4,12,0,39,2.2785639005630114,11.793171461737144
19,11,0,0,2,0,32,2.3198780823284046,11.847698358871163
10,6,4,8,19,0,47,2.5017153244172934,11.797669697405656
17,6,8,2,7,12,52,2.483114270244252,12.394926507973198
4,10,4,5,12,3,38,2.3351030350515547,12.762254545059381
6,9,5,11,13,7,51,2.315382699597033,12.38552146053935
6,12,6,7,9,7,47,2.385944486482498,12.220020163758534
3,20,8,8,7,0,46,2.238621583156473,12.992627281203347
11,5,5,5,9,6,41,2.292331086638629,12.947475171194558
4,13,7,6,7,3,40,2.2673177197112437,13.070785788906859
9,9,6,7,9,0,40,2.3315148888672463,13.02770735708884
4,4,5,3,10,0,26,2.1354517087481377,13.739955652618828
12,5,5,10,8,0,40,2.0212157774413853,14.037609008636558
3,8,5,0,5,0,21,1.9742213046280075,14.459488339361965
4,7,5,5,12,0,33,1.8341388186707719,14.472052263935812
18,12,5,2,10,0,47,1.9432256078808026,14.283351565192884
4,9,5,3,9,0,30,1.927810643484625,14.12026140564505
6,12,8,3,4,14,47,2.0408603615468386,14.135363869289082
8,5,5,3,14,8,43,1.9895921601304112,13.62498814078601
0,15,9,14,11,15,64,2.10065232687501,13.98324606620422
5,5,7,7,9,10,43,2.092136180890876,13.940512712975773
0,4,4,14,8,15,45,1.849262711138671,15.04882004252877
0,25,6,6,5,15,57,1.9525868401555586,14.567276649913588
10,9,12,10,16,17,74,2.1113683609825746,14.74704126601648
18,24,5,7,7,9,70,2.065937070982914,14.644051560566368
6,4,5,6,11,6,38,1.9700907888898542,15.44948260166408
5,24,5,5,2,17,58,2.0075460559796507,15.341450158271112
2,7,5,5,7,8,34,1.9073225030394758,15.498652609330183
3,21,6,6,3,10,49,1.9767429610507943,15.16015749664378
0,8,5,4,8,9,34,1.885456853507003,15.731653287257181
12,19,5,5,10,9,60,1.8960690770196067,15.245126794310385
1,26,6,7,17,9,66,1.7108181276082413,15.837900455571132
14,12,5,6,14,5,56,1.9283455332932753,15.290001955878674
3,0,4,3,17,6,33,1.9469442126169556,15.51231847179871
6,14,14,6,8,14,62,1.980638136864664,15.728940634694366
5,22,5,14,11,7,64,1.9956164252801167,15.694363079366468
6,14,5,6,7,5,43,1.9493119210511114,15.229034703086326
5,21,5,6,10,17,64,2.032551310397272,15.292165172834768
0,13,6,11,13,16,59,1.8631577722969466,15.741784334016316
17,10,6,8,0,17,58,1.8085680470474614,15.843230868374018
14,18,5,15,11,3,66,1.9716638324154638,15.604161672087681
2,0,5,9,7,9,32,1.7267930888374718,16.12218180672945
2,20,5,11,11,8,57,1.8910037731890506,16.240733471827426
8,22,5,15,7,15,72,1.987246709493527,15.587040726026464
13,13,5,8,13,3,55,2.1118633190859755,15.058496199358968
17,7,13,4,6,12,59,2.1664641437887022,15.454200547339479
6,11,8,11,5,4,45,2.1767574830626364,14.494603700943612
4,19,11,5,10,9,58,2.3891362539280445,14.82761467083164
7,13,0,10,8,5,43,2.38660846739945,14.738182301634982
14,1,7,3,9,12,46,2.3176610393119064,14.959836627397822
0,17,2,9,10,9,47,2.0847907574555253,15.509623753775486
16,9,10,3,10,5,53,2.0537012360642444,15.663361564377674
0,8,6,6,6,16,42,1.8709568979805942,16.178279969618465
12,12,8,13,10,11,66,1.7960154325205673,16.498007008543247
0,10,6,9,29,9,63,1.9466892121670583,16.65503701599668
0,12,0,2,25,4,43,1.7982506685419544,17.62393145926419
3,10,6,2,20,1,42,1.661524189020229,17.8000643742825
16,13,9,5,16,7,66,1.803287496578198,17.719221486506612
0,10,9,7,8,0,34,1.682661299272994,18.29913065772764
9,13,5,3,13,5,48,1.7465090652455555,18.141069886302148
29,19,8,7,7,0,70,1.819129682966414,18.372061555392115
9,7,3,17,9,0,45,1.7671107023944845,18.00299351760805
27,14,6,5,11,17,80,1.8980565082994112,17.989842533998864
28,4,7,18,18,0,75,1.8766191800059926,18.582533705694534
10,10,12,15,10,8,65,1.8010269159902705,18.53985974791232
2,13,2,16,10,0,43,1.8970806105689106,18.64093953802926
17,8,8,5,10,0,48,1.9144589297457628,18.425422178262362
0,0,6,2,10,10,28,1.674736922834861,19.378070008464526
13,13,10,14,7,5,62,1.6497866507917094,19.206190239962897
4,19,13,12,7,9,64,1.5554603067885122,19.607850561591984
12,11,6,12,4,2,47,1.568723028587229,19.46958013807205
8,0,6,5,20,17,56,1.5939825123175173,19.974106227809646
0,0,14,6,0,10,30,1.3533317855447342,20.645025544682667
15,18,5,2,0,7,47,1.4221568957635,19.834625996567897
24,0,4,4,11,8,51,1.5200386931320808,20.27393392844116
12,18,7,2,16,15,70,1.5412391196821806,20.0908440180218
14,20,5,18,0,12,69,1.49384372253287,20.31006911386983
0,21,5,11,12,9,58,1.5695833253159481,20.584760843251214
0,17,5,6,0,6,34,1.5525155246661877,20.36723651056164
13,22,5,5,14,15,74,1.6277055637921303,19.43822449302329
0,14,5,7,11,11,48,1.5329861465052872,19.92919773264974
8,20,1,8,5,11,53,1.5173135208443933,20.606579898895873
7,11,17,15,5,8,63,1.6338240888319693,20.20633798508143
4,12,6,2,6,9,39,1.6052232727289253,20.126141378909143
0,10,6,17,11,5,49,1.506813300410803,20.17116327210811
1,1,5,12,11,9,39,1.5077361724812794,21.08073185762103
0,17,5,18,16,9,65,1.5665304622071354,20.758122089305083
13,4,5,11,16,9,58,1.6430949812766615,21.010943884635264
10,14,11,16,10,4,65,1.5413858006501653,20.89294053718293
5,21,11,10,6,10,63,1.6686124727591507,20.814894738222904
5,8,10,5,7,18,53,1.6449582466652566,20.964585737478778
2,16,9,9,7,14,57,1.583755772248182,21.163910424301445
3,7,10,11,10,12,53,1.5983034564861598,21.433218987210882
11,14,10,6,10,4,55,1.573350970029778,21.227284818964154
1,23,6,0,10,5,45,1.4929677269938852,21.98109595098784
10,13,6,1,16,10,56,1.5260273577006662,21.899437971280065
1,23,16,0,10,3,53,1.5344319116721774,21.33217873112938
5,9,5,9,14,6,48,1.4470713162524373,21.870414174708326
0,20,15,0,1,15,51,1.3726105967315798,22.45018654844933
23,7,1,12,9,5,57,1.2483408440501376,22.213877708259112
7,24,5,10,6,13,65,1.1517342550073084,22.349014276372337
7,10,5,5,1,9,37,1.01435394250905,22.525594663898893
7,8,5,6,8,8,42,1.0433660841777745,22.495948488992163
0,17,5,12,5,7,46,1.1556492577664121,21.924590341273184
0,10,7,11,1,8,37,1.1503789875231047,21.662738338376045
2,18,5,12,11,6,54,1.2881535051589743,22.078308142793784
5,17,5,16,1,10,54,1.3000007721638391,22.16151860076788
12,12,4,15,6,11,60,1.2939166806103057,22.01914634202597
0,13,10,6,7,4,40,1.2667234224887947,22.00470247944322
6,6,11,17,5,7,52,1.3264916654742196,22.32533358762793
0,15,12,10,10,8,55,1.3373456882416324,22.532241013599556
0,8,3,18,6,7,42,1.3366278758039853,22.659645013053733
5,21,13,11,8,10,68,1.383853378655069,22.37026433550464
13,17,5,12,0,7,54,1.412422719399225,22.8277769937379
0,16,12,4,11,8,51,1.3680112713257377,23.39652905785072
0,19,4,12,3,5,43,1.2709493581772722,23.469767771688087
1,10,15,14,10,4,54,1.2604934706530218,23.90635736188971
0,4,3,15,1,6,29,1.2316611292283108,24.18393634320703
0,7,7,11,0,9,34,1.0797021573701582,25.02491256278759
8,19,9,9,16,9,70,1.121445159232777,25.435191177035325
11,19,5,7,2,3,47,1.0002550412425544,25.990655420063735
2,11,15,7,11,5,51,0.9881847017068431,25.48480045670039
0,13,4,6,2,7,32,1.0754804069196542,25.677263551722593
10,8,5,11,13,5,52,0.933299311584259,26.0093507343401
0,17,6,13,3,6,45,0.8962133356869133,26.331776591321972
4,6,4,5,9,6,34,0.9112277648195467,26.6989073568875
0,19,3,11,3,5,41,0.9435092799798726,26.811166230975356
2,14,15,17,6,0,54,0.9479259329298215,26.503046202146717
0,12,12,1,6,11,42,1.0188879883136444,26.476535861915366
5,8,5,17,10,0,45,1.0308414196135411,26.379402975423016
0,12,5,19,8,9,53,1.0922438859833392,26.37891819797224
0,9,5,15,8,12,49,1.041675203302123,26.763401281667104
20,13,4,13,1,5,56,1.0073972269212093,26.739057030131907
0,8,14,8,5,10,45,0.9171103843791356,27.09691147516203
1,15,7,6,7,5,41,0.9074635903283513,27.123175224158384
0,8,11,13,4,11,47,0.870259523951577,27.741647542528693
0,9,13,10,0,5,37,0.8153512707321565,28.061077356915806
0,16,11,5,0,6,38,0.9160295476676029,27.86382610291513
0,12,10,5,0,7,34,0.9173508798544756,27.83942782286217
0,16,11,5,12,7,51,0.9706983308526256,27.64831027325761
1,18,0,16,6,8,49,0.9505146685817607,27.80168909894009
17,11,15,7,6,5,61,0.8787996524464851,27.963796258402144
3,15,13,18,1,7,57,0.9299554978079734,28.056917386717128
0,12,12,5,3,7,39,0.9174245620518753,27.80401148144518
5,8,5,16,3,8,45,0.9035545843430098,27.78632699252453
2,9,5,0,11,7,34,0.7248297212409786,27.850303694821655
2,7,15,17,11,9,61,0.7149730053178532,28.21011322597582
0,18,6,3,0,6,33,0.682483449480007,28.33834322877407
10,18,8,1,6,6,49,0.6799426652031951,28.382046085991174
0,14,5,4,5,9,37,0.7456186612423528,28.03356327940821
5,16,6,17,8,7,59,0.880807781436007,27.119145801857876
0,11,5,0,6,7,29,0.9477824477328947,26.996295860863828
10,14,9,18,9,7,67,1.004975447155692,26.42845220787964
5,14,5,7,0,8,39,0.8534420983214653,26.68922770125906
0,9,4,13,0,6,32,0.8260342404365477,26.68549239257583
0,21,4,16,1,5,47,0.8918678863626681,26.350121129512942
5,17,9,10,0,7,48,0.92761488991113,26.10733714526295
0,10,4,7,5,10,36,1.105221329259932,26.003685295054897
2,11,5,16,0,6,40,0.9879536382701776,26.09891430753669
3,12,6,9,23,8,61,1.1449561525545529,26.369289867546318
18,5,5,5,14,6,53,1.0058140022205138,26.692327452774705
8,8,13,4,4,5,42,0.9156492737363212,27.007918332829473
0,10,10,15,0,6,41,0.8026491637353714,27.449312246290752
2,6,6,5,13,9,41,0.8304763538846437,27.800978365624193
0,14,6,5,5,6,36,0.7290496065744225,27.945566867423867
11,20,14,9,2,5,61,0.7529636257325638,27.945554485178153
0,6,3,4,8,6,27,0.7896502544251934,27.85341820235186
0,8,13,4,0,9,34,0.8664649453446847,27.71209106488882
0,9,6,6,4,6,31,0.75001221475539,27.85774483913948
2,9,8,5,0,6,30,0.6678724100842426,28.101528796147832
2,17,5,11,11,7,53,0.6824669343654127,28.355179306541167
6,9,7,3,1,5,31,0.7069775845847587,28.558665398130753
1,8,5,11,3,6,34,0.6936939460423919,28.56830708216976
3,11,1,2,0,6,23,0.788176731154336,28.575303774405327
12,9,5,6,1,7,40,0.8352370983878225,28.81638644139135
3,10,5,2,0,8,28,0.7948660965750556,28.631647710469565
1,7,5,7,6,8,34,0.7761834076714829,28.2716702644252
0,17,5,4,10,8,44,0.9260338819847898,28.266499197403487
12,7,5,2,8,7,41,0.9509278806523387,27.906010298779254
0,18,6,13,5,9,51,1.063458111361176,27.615740612760696
9,12,12,10,0,7,50,1.0155468600680215,27.575785583490998
0,15,0,8,13,7,43,1.0220840630340045,28.024830744846668
0,8,7,6,2,12,35,0.9129027224558705,28.949353438950848
7,20,7,9,2,5,50,0.9458834157817925,29.071723839069477
12,16,3,12,0,7,50,1.0956233645760198,27.94072160335867
9,11,10,14,7,16,67,1.2040947884658377,27.172287693512647
11,10,3,11,5,8,48,1.0998148478334484,27.523539381735503
13,15,1,9,1,6,45,1.0151599376121132,28.024989303660483
0,9,5,12,17,8,51,1.084765904829976,28.053187941095654
6,6,13,13,5,6,49,0.9950801014128358,28.577287116998246
6,14,9,18,12,8,67,1.110750412787069,28.50207691032588
1,16,3,5,6,6,37,1.1133404685294088,29.405601817803447
4,12,8,18,2,10,54,1.0315227123793564,28.759728994653354
0,15,4,7,10,7,43,1.0018824910858066,29.770979811572396
5,13,5,9,17,8,57,0.8975776030218855,29.18614631163031
5,15,8,6,4,6,44,0.9029536326153137,30.11114130850935
13,21,0,3,5,6,48,0.8327718888771489,30.61499817503997
4,9,8,6,9,20,56,0.8539142867894652,30.725742250403233
17,15,1,1,6,15,55,0.8350284679760687,30.780539998463308
9,15,1,1,3,6,35,0.6933456628194367,31.556726432992924
1,8,10,17,2,0,38,0.8159273426445187,31.331993064126987
12,10,7,15,19,5,68,0.9746640478619313,30.56623763776859
0,9,2,5,5,10,31,0.8424343157395594,30.59418012586042
27,14,15,10,6,7,79,0.9122878320649583,30.47849626528497
0,12,0,13,0,7,32,0.8110236450796112,30.7127506084973
13,11,5,7,10,6,52,0.9790227443774382,30.112169442480553
0,11,4,7,0,5,27,0.8950897947939959,30.292906752051817
15,7,15,2,7,8,54,0.9795141144680493,29.651243775873354
1,8,2,6,7,7,31,0.9509602481282959,29.82743069979701
10,14,5,2,9,11,51,0.9148022697220298,30.242567329764622
0,23,5,4,9,6,47,0.8442777468982068,29.95732067849666
2,8,5,2,8,10,35,0.8540093308714085,30.242119351181895
1,8,11,7,1,4,32,0.8213858238583609,29.812415194472393
7,15,16,2,7,7,54,0.9367954675326812,29.372763712665513
6,16,7,6,6,0,41,0.9903629370162762,29.220187512184012
7,3,8,5,11,8,42,1.025861128328952,29.376352274612472
7,10,5,12,8,7,49,1.081542009088767,29.62637540784573
2,12,4,3,3,7,31,0.8549238206494427,31.099860010429044
7,17,10,6,12,11,63,0.9388797816389907,30.856264294871302
0,10,3,4,1,11,29,0.8363068949501271,31.961742328985743
1,14,10,10,4,4,43,0.813950745209791,31.686172165293783
0,19,7,4,22,17,69,0.9829983989584369,31.3253359968883
18,17,5,10,3,15,68,0.8553250730835171,30.916987802331608
3,14,10,5,9,9,50,0.8114970892229818,31.344644182295433
0,10,2,7,9,4,32,0.7382093290190633,32.15295259312452
0,23,5,1,8,10,47,0.7697004437235742,31.883229000895714
1,10,5,6,5,4,31,0.748947109143834,32.01008399724283
10,8,9,5,8,2,42,0.8047405324527217,31.920419625425694
0,13,2,9,8,8,40,0.7635182134617886,32.881581609439785
0,10,5,12,13,6,46,0.8472598127464104,31.924312689399464
0,10,9,8,4,7,38,0.8107543425606546,31.96647870424281
0,8,4,10,19,7,48,0.8934932468954715,31.833216501476834
1,18,3,5,5,7,39,0.8830783210258012,31.583657818680315
0,13,0,17,15,13,58,0.8119819964780315,32.06995085005211
15,10,3,15,7,4,54,0.9230391728606673,31.705914998137928
0,6,10,10,7,8,41,0.9236125043243417,31.638876612001336
2,7,1,12,1,19,42,0.9652569683753391,31.241758130428334
0,10,6,10,8,14,48,0.8177704297399395,32.048371066905545
1,24,5,12,0,6,48,0.7931503006231636,32.47083251849681
2,10,3,16,23,4,58,0.8901547680832204,31.963942597464964
19,17,4,4,14,5,63,0.8989423852098423,32.24951633152594
4,11,2,7,3,8,35,0.8342633536307256,32.24490960412487
0,0,5,6,1,8,20,0.7078357261219478,33.49231791426841
2,12,6,8,12,11,51,0.7519416531093116,33.40471462871011
11,21,5,5,0,6,48,0.7850865592278192,33.12709202224809
5,18,4,5,11,6,49,0.8908289209930891,32.41636227974657
5,10,7,7,4,8,41,0.8134908672536056,33.05011436463076
9,18,0,3,8,9,47,0.7734363993263599,33.54850746073545
1,21,5,10,0,6,43,0.778151087395976,33.42653451925865
9,10,5,3,5,10,42,0.8340757749563819,32.94516086561548
0,19,5,2,3,9,38,0.8151376787138103,32.93246478025472
0,8,5,5,6,5,29,0.7755466004869247,32.81247635306194
11,8,5,18,15,4,61,0.8765196752652186,32.73856691841919
0,8,5,3,10,5,31,0.7561092693949362,31.750476237788558
8,19,7,5,6,6,51,0.7668062190300807,31.502306685240942
4,9,5,4,6,7,35,0.7827005047297028,32.07899910643809
2,17,1,3,7,5,35,0.8372822983065715,32.36643253435833
14,16,0,5,8,5,48,0.730273458461762,33.44562503122929
0,8,0,6,3,7,24,0.7158166790283633,34.476791721195156
5,11,0,6,2,15,39,0.7079057607547732,34.265301271717
0,13,0,6,12,7,38,0.6451116442792639,35.178748472142324
0,9,0,6,4,2,21,0.5610704407646125,35.55686966907318
9,10,0,5,8,8,40,0.5596592309369921,35.68560982430969
0,18,0,7,2,11,38,0.4809954840402667,35.907149001151396
6,10,0,6,2,7,31,0.495656286515452,36.53064887205433
0,11,2,16,6,6,41,0.5132649464845728,36.42181585021651
5,12,3,13,0,5,38,0.5405967173610752,36.61481749131559
1,7,0,15,8,8,39,0.5651452603646019,35.99222006124784
0,9,0,13,6,9,37,0.6115868056800705,36.00841628692914
5,15,0,5,2,4,31,0.6281220545208255,35.92600342220213
0,13,2,18,1,7,41,0.5354046812817107,35.871584631142824
0,12,5,9,9,5,40,0.5832343237198977,36.0200969737208
0,20,5,6,0,6,37,0.5656730007210949,35.8209406923099
0,6,5,7,7,5,30,0.5079505740600077,36.21879496395218
0,7,5,19,2,10,43,0.538878394110261,36.316112757335866
13,12,5,11,7,5,53,0.5260767536975344,36.28939086956361
5,11,5,2,3,6,32,0.4984849938520538,36.031159967002026
0,13,3,16,0,7,39,0.5354653634977682,36.15244037725813
1,11,2,16,1,6,37,0.5129727648529155,36.5016786224641
0,14,3,15,5,6,43,0.5671273452993469,35.94127201203753
0,10,1,18,1,1,31,0.5296502617492677,36.39963970448523
0,13,0,14,4,4,35,0.5743594838605715,36.46185087530574
11,5,5,14,8,2,45,0.6125515681655911,36.02778659937678
0,4,0,1,0,5,10,0.5059620475534423,36.531835913947944
0,9,0,17,5,2,33,0.5762843661549174,36.541613536329486
0,9,0,14,11,5,39,0.6379766120596922,36.60982244516439
13,10,0,17,5,5,50,0.7061635137375287,35.75741890206972
0,9,0,13,8,4,34,0.6385800831419188,36.20412432706526
13,10,0,13,9,0,45,0.7496897887951993,35.44785538030065
9,10,0,18,6,8,51,0.8240506175242787,35.30759469519675
0,8,0,16,0,4,28,0.8237241731362483,35.61712021167391
11,7,0,17,5,6,46,0.7576585977744767,35.067387074148044
0,9,5,14,15,7,50,0.7768435665596783,35.023129612672214
0,10,2,3,0,1,16,0.6109721868483541,36.361139904529615
9,7,2,0,6,14,38,0.5959041426185596,36.25696982677675
5,7,0,2,2,6,22,0.5839000893809075,36.6087599112908
0,11,0,11,6,10,38,0.5400829778632666,36.89091352127141
5,6,0,8,5,8,32,0.48796205792099195,37.04767331880813
0,13,5,1,0,5,24,0.5138461308071733,37.78737545259591
0,6,5,3,8,3,25,0.473305931819256,38.7637410285464
2,10,3,0,1,10,26,0.4564460688767054,39.186667244142036
6,13,1,6,2,6,34,0.4709166729225983,39.60638350868234
0,8,1,4,1,6,20,0.4523248622355709,39.50943819608402
1,13,5,0,2,4,25,0.4506961848711175,39.449348713406515
0,7,1,6,0,10,24,0.4143609298858594,39.4791824054402
4,13,0,10,10,6,43,0.42078088679462244,39.78044751021825
3,8,0,2,4,5,22,0.38455332943833626,40.016008346744826
11,7,0,6,0,3,27,0.34767597106911513,39.89391460808379
0,5,0,2,1,3,11,0.3448633319193433,40.26498125589233
1,6,0,9,6,6,28,0.3431199552991782,40.31812100859712
0,8,0,3,0,4,15,0.3458084780865643,40.50931718026962
1,5,0,2,0,1,9,0.3576473593291786,40.605754699362194
0,4,0,1,1,2,8,0.3692392556169058,40.55930800437579
0,1,0,0,0,11,12,0.35545137169714364,40.64769478670436
5,12,0,11,5,5,38,0.40565379064783896,40.112857253045796
6,10,0,6,0,5,27,0.3701253869741571,40.378067831215326
6,9,0,4,5,3,27,0.4379027960650019,40.0914682755382
8,6,0,10,2,9,35,0.40736793878868804,39.93496885295089
9,9,6,1,0,3,28,0.3857421007140363,40.12254446945329
12,3,3,0,21,5,44,0.4757722898246014,40.13258033960722
22,7,3,11,0,8,51,0.37492505196588416,40.365074127534896
0,8,0,4,8,5,25,0.4459112571320616,40.32808579339632
8,9,0,0,0,3,20,0.4275806209216784,40.56746760490569
8,4,0,10,2,8,32,0.4660525654456159,39.93486912830352
0,6,1,7,0,4,18,0.46453486136057043,40.6816474180436
3,7,1,6,4,5,26,0.42898817737107614,40.20045063843992
1,5,0,10,1,3,20,0.46120627093544386,40.12225329436278
2,5,0,14,0,7,28,0.41148877012806867,40.49852618197375
8,10,0,3,0,7,28,0.3460864214525168,41.06201243919271
0,14,0,0,0,6,20,0.3447179384540498,41.31825289569477
2,11,0,5,3,6,27,0.35061212178002243,41.92592333012381
3,14,1,0,0,2,20,0.29066994341413055,42.196142126777126
0,2,0,7,2,5,16,0.28133695104734935,42.368936113478334
0,6,0,0,3,4,13,0.2753414740958124,42.64731445951434
0,5,0,10,0,7,22,0.22531064995934166,42.806790079670364
0,6,0,5,0,3,14,0.23573007524852363,43.00984371044688
3,5,0,0,2,3,13,0.23902860871095646,43.42530015367644
0,3,0,0,0,5,8,0.20887215695982164,43.697324819052575
0,8,0,0,1,3,12,0.21576117934517883,43.793974786901195
0,4,0,10,2,2,18,0.22132632397915214,43.56078704458171
0,4,0,1,0,7,12,0.2208225426730314,43.72581692344845
3,8,0,9,1,8,29,0.23439730954788865,43.81859138888473
0,9,0,0,0,6,15,0.22402735936433757,44.0200036476388
0,6,0,6,0,3,15,0.21714217883129566,43.71992889069962
0,3,0,0,3,2,8,0.2153796181117558,43.90990929322054
0,6,0,9,0,2,17,0.2289028130019248,43.90416532963146
9,7,0,0,0,2,18,0.2679943122583477,43.7679326628053
0,6,0,11,0,1,18,0.2694639896771812,43.94198816586244
1,7,0,0,3,2,13,0.2806225794693082,44.29852131152709
2,10,0,1,0,4,17,0.28375838037854095,44.13131512884389
1,7,0,1,2,3,14,0.2967760343619604,44.17516696337148
0,5,0,0,0,3,8,0.28034784268647905,44.40448564749639
0,6,0,0,7,9,22,0.27643983574441783,44.51682637058296
0,5,0,0,0,4,9,0.20446540190775844,44.77936925397091
0,4,0,1,8,6,19,0.23501454951888873,44.81907681564941
16,4,5,1,0,5,31,0.21183473255632984,44.76582985994809
0,6,5,2,0,4,17,0.2221815385229305,44.77542952471584
0,3,5,1,8,3,20,0.23800019895150729,44.56304240746591
8,6,5,2,5,7,33,0.2592176858319024,44.27364659401498
0,6,5,4,2,6,23,0.28311178606108095,44.20832311369081
0,8,5,6,6,4,29,0.303118505879315,44.11453221785474
0,5,5,4,10,6,30,0.31327736998651573,43.99366748279039
1,6,6,0,8,3,24,0.3291531025908324,43.67380979604623
0,4,5,0,7,6,22,0.3441123724352275,43.70615447553558
9,6,0,11,3,5,34,0.3908700367781468,43.63850624499324
0,7,5,4,5,7,28,0.3524429210744748,43.65165091988835
0,5,5,1,5,7,23,0.34555147452341717,43.83570228094457
0,10,5,2,1,4,22,0.3618064731762523,43.40257531844578
0,4,5,2,1,4,16,0.4747002368850905,42.983395119149804
0,5,0,2,8,7,22,0.5479789942876161,42.75758566439221
6,8,1,7,8,5,35,0.6212716407684942,42.52367348196996
7,5,0,0,4,4,20,0.5622592367131314,43.20580360434358
7,3,5,7,3,3,28,0.4916146686099337,43.56916308988731
0,4,0,4,7,3,18,0.4148166699043199,44.001210305069
11,3,3,2,7,7,33,0.41385776382915224,43.74760180683136
0,6,5,1,1,5,18,0.3109880902658674,44.81636026668052
0,6,5,3,6,2,22,0.3012943470855437,44.786791055014774
0,3,4,0,9,3,19,0.2939806122725124,45.385165898568225
3,2,5,0,9,3,22,0.30658970258267293,45.327802543528456
0,2,0,0,6,1,9,0.3152411085880796,45.68449216466749
1,2,5,10,1,6,25,0.34274880260590274,45.006590690032276
0,4,5,0,8,6,23,0.3381463687735846,45.18077486614188
14,7,0,1,2,13,37,0.41103952349683426,45.39525649482224
0,9,4,2,0,6,21,0.2966275190770611,46.092061882161666
11,8,0,2,3,5,29,0.2843137265352358,46.05396246885457
0,0,0,2,15,2,19,0.29372987776986587,46.07044476881731
2,7,2,2,7,6,26,0.33550090837582264,45.6624819170256
1,4,2,0,3,5,15,0.32189876673978746,46.01033809377736
5,6,0,0,0,2,13,0.2658455816162395,46.047542395686804
4,3,2,10,1,5,25,0.4479341894552614,44.93368383929724
2,3,1,2,10,15,33,0.4583705370126354,45.03044015667846
0,10,1,3,7,4,25,0.42838586562680026,45.405793009466954
2,6,4,1,1,13,27,0.38223949021784986,46.278203104723666
5,9,1,1,0,5,21,0.3935902235822945,45.21665568233229
3,6,0,0,0,6,15,0.35710469114063054,45.30444073616939
0,6,3,0,0,6,15,0.3261827386299746,45.36987966506221
0,6,4,0,0,9,19,0.29795917653842796,45.8514934324398
0,8,0,5,4,7,24,0.2735530960617156,46.329227743205465
0,5,0,0,2,5,12,0.22335794709565965,48.01904866955243
2,8,0,6,0,5,21,0.205718101075002,48.5518227183789
0,5,0,0,0,5,10,0.18235650596536307,49.86122186108891
0,4,0,5,0,3,12,0.17045174473897098,50.546855844747874
5,9,0,6,0,10,30,0.201730115553266,49.95797216264735
0,14,0,6,3,4,27,0.251675805171618,50.09241056673658
0,7,0,6,0,6,19,0.22254683017337726,50.11162264232021
0,18,2,5,0,2,27,0.2943251615570276,50.071044083806036
0,4,0,7,0,5,16,0.2762209655425293,50.079007198535265
5,7,0,0,0,5,17,0.32789787920323765,49.40899077760988
4,13,0,5,0,11,33,0.3206417548480974,49.551895437801356
0,14,1,5,0,3,23,0.3005178840314874,49.80041428328234
0,9,2,5,0,5,21,0.318938568599227,49.611691228465176
5,11,1,0,19,5,41,0.42232062405708254,49.460135516512466
0,13,0,0,3,5,21,0.35337880393440135,49.484114154109136
11,11,0,5,0,4,31,0.36207176544025554,49.10058585474473
20,8,2,0,2,8,40,0.30669166636797557,48.64016312673912
5,7,0,6,2,5,25,0.34103928357928237,48.735539127423934
5,7,1,5,0,9,27,0.33348297971031293,48.8613913864439
13,6,2,6,0,4,31,0.3249692530703447,48.47619809849314
7,5,1,6,18,3,40,0.3582255899032976,48.358230059809884
1,8,1,0,0,8,18,0.2757460889286171,49.11599850173288
11,6,2,0,16,1,36,0.3328013407457912,48.11878132646576
0,1,1,0,6,6,14,0.3663064581628902,48.360258215853875
15,6,3,5,0,2,31,0.399970579320598,48.41464981954153
0,12,1,5,13,3,34,0.41252563921695595,48.60656402591212
31,7,3,5,0,11,57,0.4836476595491101,48.07845418837622
7,15,2,1,12,14,51,0.5338200766886647,47.120243443400256
0,13,1,6,4,7,31,0.4899413566752725,47.274472280918175
11,19,5,6,0,6,47,0.6148541999892573,46.11961056785471
6,8,2,0,7,8,31,0.5683649821655139,46.28471675534408
9,8,3,6,10,8,44,0.6027843852647978,46.22715833913869
7,6,0,10,6,8,37,0.5916258439964495,45.64483752343974
0,7,3,16,7,5,38,0.5772321084348603,45.66779287426301
1,6,0,0,7,4,18,0.5438843340338432,46.522144725960096
14,4,1,6,0,11,36,0.5745731895569748,45.88215065162627
10,0,0,9,6,6,31,0.5617199085600102,45.42255220115239
0,15,0,10,8,7,40,0.5682879739461285,45.908635341823036
0,7,2,0,3,8,20,0.5005297436090179,46.67901629326185
17,17,0,12,0,5,51,0.6099547532838812,45.57500903208711
19,10,2,9,9,11,60,0.5935943216997361,45.71829444596597
12,0,4,9,0,0,25,0.5470443083824469,45.1634254860296
2,16,6,4,0,6,34,0.5777544144354817,44.627223115152766
13,19,6,9,0,12,59,0.7057575492796284,43.3574028594733
0,14,8,0,17,5,44,0.7421651636995678,43.386383874002604
0,8,5,2,9,3,27,0.7083632328540821,43.96029175084852
0,8,9,0,13,5,35,0.7630080888468829,43.677288396969324
11,11,11,0,1,5,39,0.7444980305719009,43.74316747673859
1,18,14,0,16,11,60,0.7432727089640899,44.340254046064
6,11,13,10,6,11,57,0.6897012847047148,44.432825710820445
12,10,1,0,7,10,40,0.566576194470636,45.43398486283214
5,12,10,0,6,2,35,0.6429563643663722,45.56601679786735
0,9,2,0,2,14,27,0.5797568736428105,46.40694488105034
7,8,8,0,7,7,37,0.5568818913975573,46.98014646176827
10,12,4,0,6,9,41,0.6154410285962426,47.613523821544696
9,14,5,0,6,15,49,0.5099302474502257,47.95146843088251
12,2,5,12,11,6,48,0.5435814618793141,47.71909643414615
11,12,0,14,12,14,63,0.5555399491215861,46.80010170173851
0,16,0,14,5,8,43,0.6317398617566768,45.23208172945054
1,18,0,0,10,7,36,0.8018950692158966,43.87076430852229
11,5,0,0,2,10,28,0.8013037629010319,43.901919552584125
9,6,0,12,8,9,44,0.7556787135193025,44.4967481967068
10,14,1,0,20,8,53,0.8007306643832901,44.37511682894029
12,16,1,0,4,13,46,0.7440943190787195,44.624687287393215
0,16,5,0,19,12,52,0.7131972376515259,44.75645074688793
13,0,5,0,6,5,29,0.7543150239479556,43.714193048337975
12,18,5,0,8,12,55,0.7609609866859288,43.94487526294993
0,4,5,12,5,6,32,0.6552405439613537,44.588211074512046
1,17,5,13,12,10,58,0.6460177463714682,44.6928377535817
15,11,5,14,6,12,63,0.6790780811653435,45.404967787028234
31,3,5,16,2,0,57,0.7072216794844677,44.06796971991448
0,20,5,1,13,3,42,0.6487403498650098,43.92190257507612
9,7,5,0,10,12,43,0.6537403496565242,44.05874507035733
11,20,2,10,8,7,58,0.7392872716077286,44.04725135035121
16,10,0,0,9,7,42,0.8524004622581843,43.56454132964556
10,11,4,0,6,10,41,0.8200396299192488,43.944533989465306
6,8,0,0,3,9,26,0.6587013823087433,45.19615813620796
13,11,0,0,15,11,50,0.6740816974369548,45.335167931259456
10,22,0,0,10,0,42,0.7234834633877881,43.66244220793198
8,9,0,11,18,10,56,0.7953375720652334,44.088849649989264
10,11,0,0,1,7,29,0.7452582993978771,43.70767281400846
11,12,6,11,13,23,76,0.7927653179040897,43.46657848814272
2,13,2,0,0,4,21,0.6253567810409235,44.314249102797035
15,0,0,0,0,4,19,0.560551234476754,44.6839544394176
0,10,0,11,15,6,42,0.5661129491286485,45.3964857723344
11,3,0,13,7,6,40,0.6615809784325417,44.41520308790624
8,16,0,0,7,5,36,0.6992082397760149,44.253829495322705
8,5,0,0,2,1,16,0.6393419418528492,44.69860050114104
8,21,0,11,7,2,49,0.6602565591280443,44.52949373560637
17,2,0,14,6,6,45,0.7051858859296308,44.47939845515355
8,21,0,0,6,5,40,0.7501698646788892,43.951205277760614
9,5,0,0,3,4,21,0.7466447187048911,44.10866694208592
13,19,0,11,10,0,53,0.7210327693249933,44.31104462503324
9,5,0,0,9,1,24,0.6993715020218343,44.99653412732295
4,12,0,0,5,6,27,0.659268888102095,44.344480363270215
4,4,0,0,7,6,21,0.610208748556325,44.71708941930883
7,13,0,0,2,7,29,0.6737213392841623,45.13518575605211
5,4,0,0,1,7,17,0.6297923181160738,45.85341007619726
10,10,0,11,3,6,40,0.5687835728072742,46.16680411294557
6,4,0,6,6,0,22,0.48377947702448304,47.29244058473664
3,12,0,0,4,6,25,0.4767559087487832,48.21568305586084
7,2,0,0,7,6,22,0.4801185576894287,47.99839366153509
0,11,0,0,7,7,25,0.48768901705934325,48.528042798477514
12,4,0,0,0,6,22,0.4496551983220026,48.65043729500307
4,12,0,1,17,7,41,0.5729682951261434,47.91657272282459
7,2,0,0,2,7,18,0.6001078432462321,47.58151748929033
13,11,0,0,8,6,38,0.5806781160794602,47.70183956649472
7,4,0,1,0,8,20,0.5251458421293644,48.58032965775406
3,16,0,0,3,0,22,0.46441328896301476,48.054491024117475
0,3,0,0,0,6,9,0.46035726469808136,48.11379342120832
0,14,0,0,5,7,26,0.4731558368315985,47.84608895107863
5,4,0,1,7,7,24,0.38351776213824074,49.44728654282364
2,14,0,0,1,6,23,0.3419661129551393,50.36324823428001
0,7,0,0,6,6,19,0.3810913959723246,50.46624416580554
0,3,0,1,6,5,15,0.3085476260991241,51.533944321650736
4,7,0,0,5,1,17,0.32053560479113274,51.90206781929189
0,18,0,0,6,9,33,0.3265295176457694,51.3905007349484
4,4,0,1,2,0,11,0.282736611712495,52.31108424736452
0,18,0,0,13,0,31,0.35299651308176505,52.51694771560377
5,5,0,0,3,1,14,0.3377489122391495,52.93546034034617
19,1,0,0,0,0,20,0.3225456995393942,52.12923042025334
1,0,0,0,15,0,16,0.3583269605479439,51.8277132571606
1,10,0,1,7,2,21,0.3713532006979591,52.64170727307207
15,0,0,0,5,3,23,0.3708785522150984,51.74916409724
2,3,0,0,0,0,5,0.30999784585988144,52.71461730948237
9,2,0,0,1,1,13,0.31105611050865933,53.2497717525749
6,1,0,0,0,7,14,0.24034874031750159,53.874039421688416
2,14,0,2,0,3,21,0.24925301967570132,54.02464893579084
0,2,0,0,6,0,8,0.23373288784526663,54.63929083974351
0,12,0,0,1,2,15,0.24484075186800067,54.33165523168
0,2,0,0,0,0,2,0.2298396064470234,54.97815431254175
0,12,0,0,0,0,12,0.23216145256606185,54.87766541433926
0,1,0,0,0,4,5,0.19139643076415125,54.81465525484492
0,13,0,0,0,6,19,0.179653829107788,55.376947468693075
0,2,0,0,0,2,4,0.17121486867391905,55.323854692656525
0,14,0,0,0,0,14,0.1750844319680398,55.34748545129679
0,3,0,1,0,0,4,0.12070622132948489,55.98069501377299
0,1,0,0,0,0,1,0.10737739258098059,56.281912507199614
0,11,0,1,0,0,12,0.11799986250448313,56.512154356877076
0,2,0,0,0,0,2,0.09846370866574579,57.02459697056011
0,3,0,0,0,0,3,0.07776914035042065,57.5301327083577
0,0,0,1,0,0,1,0.08021745477176637,57.7569713307417
0,0,0,0,0,0,0,0.08148651798845538,58.33073096111918
0,1,0,0,0,0,1,0.05153946015004359,58.92562291903889
0,0,0,1,0,0,1,0.05387537589220801,59.17106041975242
0,0,0,0,0,0,0,0.0401611001310567,59.3514622339473
0,0,0,0,0,0,0,0.02670105100606263,59.51352276406752
0,0,0,0,0,0,0,0.028450453705086965,59.591040941089766
0,0,0,0,0,0,0,0.042480799404509224,59.671058079753635
0,0,0,0,0,0,0,0.023060774234101192,59.703224761713365
0,0,0,0,0,0,0,0.020255511974289014,59.930525362100916
0,0,0,1,0,0,1,0.03114229607546951,60.07430852834489
0,0,0,0,0,0,0,0.030659884955975533,60.11368733774545
0,0,0,1,0,0,1,0.018259162303256037,60.238834060852355
0,0,0,0,0,0,0,0.020290556004885208,60.28566649477392
0,0,0,0,0,0,0,0.0193650316639443,60.34864483935126
0,0,0,0,0,0,0,0.020593023942241603,60.41085707240976
0,0,0,0,0,0,0,0.026268554192058365,60.47475874179147
0,0,0,0,0,0,0,0.023789714996415346,60.614195934265084
0,0,0,0,0,0,0,0.02087770179649506,60.65579197508842
0,0,0,0,0,0,0,0.035872214406350245,60.69739922235811
0,0,0,0,0,0,0,0.035403862551493505,60.77565187922715
1,0,0,0,0,0,1,0.05016130684405069,60.81824808252557
0,0,0,0,0,0,0,0.042150329730517015,60.86520753845837
0,0,0,0,0,1,1,0.038566731159243875,60.95905871613258
0,0,0,0,0,0,0,0.04347252202853949,61.06190156978176
0,0,0,0,0,0,0,0.02221616101231178,61.154019321802515
0,0,0,0,0,0,0,0.021165421043648536,61.23997933123535
0,0,0,0,0,0,0,0.0340333333398018,61.237465432610485
0,0,0,1,0,0,1,0.028332293497130945,61.32527904094388
0,0,0,0,0,0,0,0.027370254292930284,61.410436106294966
0,0,0,2,0,0,2,0.026812346147096166,61.434689950181316
0,0,0,0,0,0,0,0.026982233522704815,61.51309818110617
0,0,0,1,0,0,1,0.02154992550601641,61.6069076089722
0,0,0,1,0,0,1,0.016062456836600358,61.669456437431876
0,0,0,0,0,0,0,0.019615814603165988,61.70074750466572
0,0,0,0,0,0,0,0.018059190273745418,61.77908484540945
0,0,0,0,0,0,0,0.025842780204558855,61.825912150393336
0,0,0,0,0,0,0,0.026708443842236498,61.867500667955014
1,0,0,0,0,0,1,0.026533665122124104,61.96142190123738
0,0,0,0,0,0,0,0.02713480045885963,61.99261739480231
0,0,0,1,0,0,1,0.021606930930604725,62.02392687158575
0,0,0,0,0,0,0,0.025839952835109935,62.102900679760864
1,0,0,0,0,0,1,0.03208356253218875,62.18033582327167
0,0,0,0,0,0,0,0.03210763159881321,62.2272587793173
0,0,0,0,0,0,0,0.027331162678850975,62.281164782736106
0,0,0,0,0,0,0,0.0312229552862862,62.37501950381338
0,0,0,1,0,0,1,0.027431072955661166,62.39927193087041
0,0,0,0,0,0,0,0.02345034747913446,62.46209806669221
0,0,0,0,0,0,0,0.026439148258597465,62.50877628909057
0,0,0,0,0,4,4,0.02659597398009875,62.60317286016495
0,0,0,2,0,0,2,0.015462144910163008,62.712603409390155
0,0,0,0,0,0,0,0.017100696663478222,62.74385988228419
0,0,0,1,0,0,1,0.015753169551599965,62.806413471563886
