throughput_KLONGTEI,throughput_KASEMRAT,throughput_NARANONG,throughput_SUNLAKAKHON,throughput_RAMA4, throughput_ATTHAKAVI_RAMA4,throughput,mean_speed,jamlength_percent,Backlog
0,0,0,0,0,0,0,7.841417690959361,0.013863418376537978,17
0,0,0,0,0,0,0,8.357546602692858,0.03191168924603467,40
0,0,0,0,0,1,1,9.427196943529145,0.05856460580884322,55
0,0,0,1,1,0,2,9.436909036976523,0.09641970212270316,83
0,0,1,0,1,0,2,9.916821722260716,0.10692876674664575,107
1,3,2,1,0,0,7,9.691232337813657,0.14359207464318152,136
3,8,1,0,2,0,14,9.703186086096615,0.20055612276693238,144
1,1,1,5,1,0,9,9.667965379638975,0.2545772260228171,178
5,5,1,1,1,0,13,9.283394143317787,0.31191714958335565,203
2,4,0,2,2,3,13,9.457884234697449,0.3395522985837776,224
5,2,1,0,0,3,11,8.779582333934329,0.4808192480058523,256
7,7,7,5,5,4,35,8.419707963629248,0.7578419322230459,280
1,12,3,7,5,3,31,8.222636002502217,0.7699187517665015,305
11,9,1,1,1,4,27,8.035406189880424,1.0000034761731524,319
8,9,0,1,6,7,31,7.4816737305236956,1.2313084610482223,340
6,7,0,0,3,4,20,6.941691033108569,1.6529085973656032,361
5,5,11,1,6,7,35,7.021709873431149,1.668289780457394,378
5,18,3,2,9,3,40,6.933118408315941,1.8107674877870206,401
11,4,1,16,5,7,44,6.731109835216525,1.8046919336402354,416
11,10,0,13,4,7,45,6.226075451587441,2.3216157713791246,437
6,6,12,2,15,8,49,6.5660877161342,2.2211648934621038,446
9,12,9,0,7,2,39,6.472798113187095,2.3378441556829466,466
10,6,13,1,6,3,39,5.7960722979982,2.750235861092025,492
8,5,9,2,3,4,31,5.182191273350543,3.5733226307357984,511
8,6,10,14,7,1,46,5.166293717637377,3.558983658628255,521
5,3,11,10,11,5,45,5.3373124536792895,3.5026147208956004,529
9,2,10,11,8,5,45,5.144190471237923,3.7062228017655627,549
10,6,8,1,4,3,32,4.637760101585194,4.438487701382466,577
6,10,7,4,23,5,55,4.996002463672227,4.025043468255742,587
10,7,7,2,26,3,55,5.196904724462095,4.182953880509281,634
13,17,5,2,20,8,65,5.147313291249171,4.239811244115869,653
7,17,8,2,6,7,47,4.968352652656885,4.74790095160256,674
10,10,6,2,19,12,59,5.369154169268685,4.721143348397966,702
11,11,5,3,10,14,54,4.570001702693948,5.273157778869466,707
10,7,15,6,8,15,61,4.5637581972805705,5.481765954206737,734
10,8,7,2,7,13,47,4.177666751776576,6.396872431749635,752
25,11,2,1,12,14,65,4.09581523855589,6.565814775661984,762
19,10,4,17,9,11,70,4.0286013839876595,6.520501256940665,753
5,7,9,21,4,10,56,4.234231394584357,6.242048848953851,767
7,6,5,17,0,6,41,4.00504144598371,6.932521461991255,786
7,6,2,3,12,6,36,3.93749151543112,7.104730731062907,804
13,12,2,14,3,7,51,3.8279852108437993,7.198692330143307,818
7,10,5,13,8,5,48,3.2323804377359564,7.929227622604627,830
11,1,2,9,7,1,31,2.866324582756611,8.859977594793637,852
13,2,10,2,17,0,44,2.6796219826559073,9.06931805127218,857
5,3,10,18,6,0,42,2.9345675017674906,9.064916318894516,882
5,0,11,20,1,3,40,2.872375231318227,8.915596022384563,879
8,25,10,22,5,4,74,2.995812536271296,8.52130687901234,874
3,28,10,9,9,2,61,3.3482917840455557,8.382612004716595,893
1,31,11,14,9,7,73,3.534437420732981,8.25701204800353,899
8,20,11,13,24,6,82,4.210335144319923,7.227786413980832,911
8,14,10,15,26,9,82,4.516583482058013,6.874734451798384,909
17,28,8,6,24,7,90,4.4495696081029825,6.922554485902857,923
9,25,7,17,17,8,83,4.373222647906858,7.147609561518986,928
11,16,8,13,7,8,63,4.019438259131186,7.603184664892235,942
8,9,7,4,24,9,61,3.9437351814455397,8.012096213688404,962
12,19,7,0,15,10,63,3.6757059213253864,8.458112539891935,984
12,12,5,10,10,10,59,3.2933620856469616,9.399370699898876,1007
8,9,8,1,10,10,46,3.051433121014759,9.942811404162407,1017
26,11,7,1,5,10,60,2.981536090037439,9.868947284257713,1029
17,21,8,1,6,10,63,2.955554217909769,10.116214734465798,1037
5,22,18,1,10,8,64,2.8916713202806092,10.079556717188499,1037
11,9,13,2,10,7,52,2.9624986461430995,10.468636242237197,1068
8,13,11,2,11,5,50,2.717993816764908,10.817806863186378,1078
10,11,10,0,6,3,40,2.5375125557915057,11.117902285430834,1085
4,15,12,18,10,8,67,2.5313967339629007,11.412704315622987,1089
10,7,9,20,7,8,61,2.435826477449026,11.139184445249578,1071
8,9,10,21,6,3,57,2.4970783905774323,11.059466892720325,1063
4,6,7,19,7,4,47,2.5014515725496653,11.307258330051077,1074
12,7,5,14,8,4,50,2.4705191629696586,11.51279854052923,1078
8,8,14,2,5,0,37,2.237472413029708,11.634557871743255,1080
6,3,11,3,4,4,31,2.2266645599219244,11.897670487458798,1095
6,4,5,1,17,4,37,2.3471513318913693,11.894499077304278,1111
5,5,5,2,12,6,35,2.24477798784322,12.115501797414343,1113
6,3,4,10,7,5,35,2.2376925710241893,12.353306081627498,1135
4,5,5,13,6,7,40,2.262248137223813,12.23102647490541,1151
1,3,5,13,6,1,29,2.248346851632713,12.655398769980748,1147
8,18,6,9,22,1,64,2.7163772033673825,11.597391730420233,1158
2,20,5,13,21,4,65,2.98279243016986,11.69988671746123,1178
11,16,5,7,19,4,62,2.8704313045168797,11.796243161843636,1201
13,7,6,7,18,5,56,2.579488783427299,12.733549635308602,1219
13,8,5,8,26,3,63,2.3964757984451133,13.148669303264999,1233
3,8,10,6,14,3,44,2.1121943085416444,13.941588691220618,1248
36,8,7,2,7,6,66,2.081003867992877,14.081916176021656,1253
11,16,7,2,17,3,56,2.0371901989407655,14.238776138433389,1273
15,9,9,3,5,15,56,2.1238769182594712,14.3380485970956,1288
13,9,5,4,8,14,53,2.1595930680724127,13.99041023407853,1300
14,11,11,7,8,17,68,2.3063857597850634,13.786955185653182,1307
5,8,8,0,7,18,46,2.209378530401789,13.925258825414067,1302
10,7,7,1,9,19,53,2.300364546037409,13.92178849920469,1312
9,6,7,2,12,16,52,2.1684944981984002,14.491382744963126,1327
3,8,15,12,6,12,56,2.228659498316613,14.230100721640845,1332
6,6,16,20,5,14,67,2.358711774126947,14.156331961326613,1342
7,21,8,20,6,11,73,2.514229346289609,14.051395349213283,1343
6,29,4,10,6,10,65,2.390805224004968,14.482519787171931,1332
5,22,14,3,5,11,60,2.346734793810217,14.11078039713457,1349
1,23,10,14,5,12,65,2.163002269276621,14.28353503860193,1341
9,20,7,14,7,11,68,1.9845765714111578,15.022319806881049,1340
9,9,8,9,6,13,54,1.8471345793761027,15.762939411608125,1341
5,17,9,8,7,11,57,1.8767255191116885,15.572372280566412,1349
10,24,6,4,9,11,64,2.078418768732019,15.58827454929577,1358
7,21,6,17,6,13,70,2.1489301628902444,15.407617206338259,1353
6,22,7,20,0,11,66,2.141385236940884,15.558340966344874,1345
0,9,6,22,15,14,66,2.4109508322988606,14.78564834805129,1340
1,19,5,20,16,7,68,2.322748665604949,14.391134090990091,1307
0,17,5,23,16,3,64,2.1698931960654653,14.451583447045172,1304
2,3,5,5,7,7,29,1.9914861376608473,14.897467815585197,1308
0,5,6,8,3,7,29,1.6861773922376242,15.423558896460932,1306
7,8,5,11,22,5,58,2.014546839576745,14.741924776790823,1311
5,12,7,8,26,10,68,2.1845134412936207,14.354607183859844,1321
7,7,5,3,28,8,58,2.113508620784934,14.676146933933229,1340
14,5,5,7,11,8,50,2.134789358112595,14.781846511272109,1364
15,5,8,5,16,9,58,2.1183456530451483,14.733313299480574,1385
7,14,7,16,9,11,64,2.1717874731447604,14.720545720570863,1389
10,24,14,18,8,8,82,2.405139407736995,13.612472522736965,1389
9,12,14,11,18,7,71,2.471253758582833,13.56147273658134,1407
8,7,13,13,20,5,66,2.382775329299137,14.04116033357003,1411
10,17,11,15,7,8,68,2.49195027659614,14.388356276280879,1417
10,10,12,12,12,8,64,2.4302697719692063,14.969520536060418,1442
26,10,10,11,8,9,74,2.2876878839067625,15.36186668564802,1445
34,7,12,10,9,6,78,2.2445896127732556,15.667883841798398,1427
13,12,9,2,6,8,50,2.1716114125191406,15.5328901733277,1439
8,14,6,5,10,7,50,2.102941183970317,15.716354998397735,1450
10,14,7,4,23,6,64,2.232866134084907,15.51708263611257,1469
1,15,8,2,15,7,48,2.06438186131291,16.509356372760713,1486
21,8,5,7,2,4,47,1.9214484267082508,17.1373360130137,1500
9,9,5,10,9,6,48,1.9697097456397723,17.342193339192885,1544
8,10,5,14,21,5,63,2.0751952183386946,17.279147208634942,1542
20,9,5,14,13,7,68,2.0824840297064044,17.392740082160284,1554
12,10,5,11,12,6,56,2.0820223858573805,17.778830931746995,1570
10,9,5,10,5,6,45,1.8863860435635726,18.20912753360298,1587
7,7,5,9,12,6,46,1.8271599250173858,18.547897471255844,1607
8,9,6,5,7,8,43,1.6247069628900395,19.193963808302417,1620
10,21,11,7,7,1,57,1.643679273565464,19.566575475070486,1635
8,32,5,13,9,0,67,1.739653711599258,18.99651782479348,1627
11,30,6,7,12,10,76,1.8310405229626037,18.803139017162557,1615
6,32,7,7,20,11,83,1.7020020370141444,18.832124047516672,1608
5,12,4,9,22,10,62,1.5239042069904905,19.410093225508273,1624
0,9,11,7,11,4,42,1.3655654882035295,20.28926109506995,1646
7,9,11,14,9,17,67,1.5293888611557656,19.358380409900406,1637
1,8,14,22,5,16,66,1.5478318401379452,19.409434314667784,1642
4,10,13,23,4,18,72,1.7118706702146402,19.007667849187694,1646
1,7,13,21,5,16,63,1.7374251870760247,18.791343163281386,1632
6,8,13,20,6,9,62,1.7624980607000826,19.23656382677164,1650
7,3,7,21,0,12,50,1.5360978341752072,19.78002408383717,1643
8,24,5,6,2,7,52,1.5244606712901498,19.66455485463099,1639
7,27,6,14,6,8,68,1.6835346397488866,18.929195345746603,1635
6,24,5,17,7,14,73,1.9774658089079635,18.13956160485329,1630
5,26,6,16,6,16,75,1.9395790250379543,17.9604684051859,1616
6,11,7,12,9,18,63,2.0426079964941817,17.6408734869068,1627
9,26,5,9,7,19,75,2.080124184412558,17.219738421575503,1616
11,28,7,12,12,16,86,2.3858937864768825,16.936345478362597,1621
0,27,6,13,9,16,71,2.2043619780862977,17.533059408479634,1635
29,20,5,7,0,12,73,2.2408648071807975,17.605455270100027,1649
18,9,5,2,15,14,63,2.251539179265387,17.150170509049207,1659
17,7,16,18,8,13,79,2.226290885078107,17.279042118723865,1666
16,10,12,20,9,10,77,2.0533256747043445,18.040125273459044,1675
14,7,10,3,8,15,57,1.8632264946112809,18.664898783409093,1693
15,5,12,2,3,7,44,1.7909530068869142,19.7162225917199,1717
14,3,12,3,4,6,42,1.7942996740852974,19.50747065113188,1729
13,2,11,3,4,9,42,1.6703549123681323,20.028569999782125,1751
10,1,14,2,5,10,42,1.560622487664004,20.955454867116043,1778
3,1,10,3,4,7,28,1.3822215841705696,21.5170182087548,1779
7,2,15,1,4,7,36,1.3545528734134802,22.36619019511989,1814
2,1,15,1,6,8,33,1.3502415726278125,22.483570577719924,1828
2,17,15,1,7,0,42,1.3485426679920172,22.680826293579496,1835
2,25,5,4,8,0,44,1.3952923536762296,22.875526327882053,1844
24,20,5,3,8,2,62,1.2945834739814812,23.05056576927242,1837
13,22,5,11,13,4,68,1.3509164869825987,22.542746351435262,1827
2,6,7,9,16,7,47,1.2172327455656227,22.645963641497293,1810
1,8,5,8,6,8,36,1.2661170223552403,21.97501835359468,1807
3,10,5,15,15,7,55,1.3946437540901073,21.736631101648584,1793
2,7,9,10,14,6,48,1.4220240783123106,21.59487187249317,1787
1,4,11,16,11,7,50,1.4891467967631027,21.307541939306684,1783
1,4,6,21,21,8,61,1.4833348023354682,21.18187671459588,1777
10,7,6,21,23,8,75,1.746677320030243,20.20355525014878,1775
17,10,2,22,14,6,71,1.801594275025488,20.42058325010704,1779
19,8,6,20,12,6,71,1.6750213872034556,20.35652143668775,1759
13,8,5,14,23,5,68,1.6544436055223823,20.71640323408243,1781
12,22,6,15,19,4,78,1.7671308652237983,20.49192855965166,1797
6,28,3,13,14,0,64,1.7856378110032396,20.599769971581516,1793
11,31,10,16,23,10,101,1.9682796187454812,20.680884036629188,1807
13,27,7,13,30,9,99,1.9093289549184604,20.513513475947867,1797
15,20,6,16,20,8,85,1.8397476349809623,20.092816774335457,1778
12,17,3,12,19,6,69,1.9387867891983308,20.28337879145363,1810
27,19,6,5,14,6,77,1.9522992423188303,19.754096570951603,1808
37,18,7,10,14,4,90,2.010807684170033,19.85233768371845,1792
30,17,11,4,15,5,82,2.064314882668949,19.49252771279802,1788
14,10,11,4,10,5,54,1.9225827105143838,19.98226041309581,1796
7,7,13,4,13,3,47,1.8971950869039877,20.007583400221147,1791
6,7,10,2,7,3,35,1.8060896685553927,20.3007739115402,1826
7,8,15,2,8,2,42,1.7194825874788862,21.483918194629275,1847
3,10,13,13,4,3,46,1.5807981923612495,22.038836784876867,1866
6,9,7,15,15,5,57,1.760106713616893,22.02220078573824,1883
10,11,10,13,14,6,64,1.708773832105619,21.865959557304453,1896
7,9,10,4,9,4,43,1.521723610134895,22.58230880687135,1910
4,7,10,2,5,17,45,1.448066887106248,22.984383660568675,1935
2,7,10,4,6,20,49,1.3693354731775433,23.050463975672105,1963
3,6,11,5,8,12,45,1.373955990678295,24.074082681147257,1984
3,7,11,7,6,12,46,1.2147853728482398,25.051832058359395,1990
2,7,9,7,7,8,40,1.163203910555048,25.38445401833344,2009
2,18,6,4,9,6,45,1.1208953331553568,25.88761312918924,2011
1,26,5,12,15,7,66,1.2154355524212195,25.3618723500375,1993
1,30,7,14,11,15,78,1.3283719883655902,25.216194598199888,1976
1,30,15,10,7,18,81,1.3384158694005321,24.813996385914304,1958
1,20,16,9,5,18,69,1.3095477442040435,23.87417200724773,1941
2,12,11,6,9,23,63,1.1626537502717926,24.06707869051473,1929
0,26,10,17,5,21,79,1.2543719200293209,24.35397832220768,1918
13,33,13,22,19,18,118,1.5965666724953544,23.173529958458804,1880
9,34,5,22,11,18,99,1.7504061586999853,22.16903664798092,1865
3,30,5,22,7,16,83,1.7178370343574534,23.161382260883528,1865
3,29,6,17,4,12,71,1.56412819280883,22.985149714363565,1856
0,26,6,20,19,14,85,1.601268559855024,22.893322339556683,1851
6,25,5,5,20,15,76,1.5566314484613302,23.065725694112526,1857
5,20,6,6,12,16,65,1.4323431528460544,23.84338390654023,1869
6,24,6,5,7,9,57,1.222900341232997,24.519676654118427,1884
8,18,6,3,3,12,50,1.106877378442766,25.17157602260141,1900
7,16,13,4,4,10,54,0.9724638666882507,25.6730547900282,1905
5,9,15,3,2,6,40,0.9122187270268967,26.20684985733638,1922
5,7,15,17,1,8,53,1.009975759946999,26.040693511483916,1934
29,17,15,16,23,5,105,1.4689060407212737,24.217115562899963,1926
37,17,10,14,24,8,110,1.78177937896095,22.73305232232484,1900
1,12,11,10,15,8,57,1.6298103594619635,23.157756163412955,1914
33,8,10,12,8,3,74,1.655899032997182,22.663117357720168,1889
26,6,10,12,8,6,68,1.7500814059838123,21.860254863654124,1884
6,5,10,13,9,4,47,1.6542525450814185,22.182561369649832,1891
14,9,11,5,12,7,58,1.5063362688949746,22.52133492537839,1890
11,11,8,6,14,4,54,1.4668129957626086,22.92222244907838,1907
16,12,5,4,6,7,50,1.2839240085966792,22.99365304592467,1909
4,6,5,3,10,5,33,1.312417792744639,23.555857189939832,1926
4,12,5,6,9,5,41,1.364468996978356,24.022808680111936,1953
1,8,10,1,12,7,39,1.5142033386285936,23.121807147142658,1977
10,10,11,15,17,5,68,1.6790297430216707,22.91494873596201,1982
13,7,6,11,27,4,68,1.8348664055552828,22.90353402767993,2006
9,7,5,12,27,5,65,1.7303849213741425,23.497285591017192,2012
6,6,5,6,10,5,38,1.5951802839644151,24.56817419280178,2035
12,2,6,3,5,6,34,1.464576386460398,24.832157860880482,2044
6,3,1,0,0,7,17,1.133104906629124,26.500605348955887,2073
11,3,5,2,0,10,31,1.0270839003169219,26.877491154713155,2096
0,2,5,1,0,10,18,0.9309776630092165,27.522711203260393,2120
6,2,5,5,17,9,44,0.9087561991541917,27.968666795749037,2121
6,18,5,7,16,4,56,0.9452230241401361,28.029710826306363,2112
5,21,4,7,4,2,43,0.8996464266390489,28.001664814213303,2104
1,21,6,14,1,6,49,0.8875421746583247,28.016771994372057,2107
5,19,5,15,3,8,55,0.8911479121137906,27.941325218645645,2114
0,0,5,16,6,8,35,0.85763532555438,28.004266378289522,2123
2,1,5,3,6,7,24,0.8965116716390881,28.21994114026855,2147
5,0,5,16,6,8,40,0.8548056044947272,28.580691908547756,2160
8,1,10,23,21,6,69,0.8885317855498988,28.439267557104827,2164
8,2,6,19,21,7,63,1.0285787542807434,28.06042467518572,2168
9,3,5,20,5,7,49,1.1521431180058945,27.244114791809295,2163
3,11,7,21,4,6,52,1.0886986184522447,28.007522892562545,2185
11,13,6,17,22,8,77,1.1097092901061951,28.19421951566666,2182
15,23,6,8,22,3,77,1.160820366914534,27.99366012234015,2190
9,24,10,5,22,3,73,1.2488481854420326,27.39594609756374,2182
8,24,15,7,11,2,67,1.4197879308994594,26.381265697886057,2193
11,14,16,10,7,6,64,1.4501946742079264,26.281491936210745,2197
13,17,12,13,7,7,69,1.5056443522002456,25.593538459537246,2177
12,13,13,14,9,6,67,1.4716699942257117,25.111013016646552,2173
8,7,10,11,8,4,48,1.4195034679815641,26.148967548186565,2206
31,9,10,8,20,3,81,1.3547556598559454,26.7222101485236,2198
33,6,7,7,20,2,75,1.3261924762200359,26.86267435789076,2200
29,9,11,7,23,3,82,1.344619502803877,27.028584586499502,2187
27,8,11,6,21,7,80,1.260387247709824,27.08633437888426,2167
10,8,9,5,23,1,56,1.2117625513354204,27.518301203006363,2194
0,7,8,2,8,6,31,1.0665289474545054,28.563211075393063,2215
23,11,5,5,3,6,53,1.0249178847264608,28.984352986764485,2229
7,9,6,2,9,2,35,1.0139314685699035,29.249480365703704,2244
10,8,5,11,5,2,41,1.0026299582522555,29.503308584294597,2246
11,11,5,15,8,4,54,1.0779946801496334,29.182844618907048,2263
8,11,5,13,9,6,52,1.018021503672184,30.05225356302749,2272
10,21,5,6,20,2,64,1.1109310868564422,29.52054607172565,2269
15,24,5,6,18,3,71,1.066883760292607,29.96478084586272,2259
13,27,5,8,6,1,60,1.06572386159707,30.035068732013087,2252
11,25,5,3,7,0,51,1.044770764580392,29.840341603296192,2245
11,14,9,8,18,0,60,1.1635113399977453,29.550329682243003,2250
7,17,11,6,13,0,54,1.1659404592024794,29.375829054683717,2253
8,14,12,5,3,6,48,1.1992830792883875,29.290586825235856,2259
11,18,6,5,7,6,53,1.144769415537898,29.206302411644188,2267
1,19,11,7,8,7,53,1.0573278972995843,29.310409374071792,2271
9,16,9,8,18,6,66,1.144293621153432,28.488731781719693,2268
23,6,12,6,19,6,72,1.0585115146538513,28.662436870833393,2250
23,11,11,16,7,7,75,1.0382853091920181,28.3681607440984,2239
3,6,12,20,6,6,53,0.9982579047230629,28.783104513090905,2231
2,15,6,22,19,7,71,1.1001369862175763,28.615927094178463,2219
5,18,5,19,5,9,61,1.069731435591231,28.646362416735833,2227
2,15,5,2,4,20,48,1.069967621740605,28.520771925946345,2221
2,19,5,9,0,19,54,1.0949707930941939,28.621020947842247,2216
0,14,5,10,14,18,61,1.1253929755748522,28.767521732813773,2220
6,17,5,13,11,19,71,1.0688919655980005,28.843599433744018,2202
6,21,5,12,14,15,73,1.0405946557795074,29.244319100397327,2199
6,14,6,9,9,11,55,0.9572090025890733,29.563038898380395,2192
0,15,5,6,2,14,42,0.8570861279305836,30.049212635505768,2195
1,11,5,4,0,15,36,0.8073438479983086,30.39836157291587,2204
8,15,6,1,0,16,46,0.7699693339284147,30.4984242323062,2200
0,18,5,13,0,18,54,0.810906002301752,30.432218006329578,2214
0,13,5,15,12,16,61,0.8771683626489991,30.147663817824082,2205
16,14,4,12,8,18,72,0.9577229731339797,29.62461518961396,2192
7,15,7,13,8,18,68,0.9126548867802066,29.52876394648564,2185
6,10,7,14,7,14,58,0.9056953074465383,29.70919299771611,2192
2,11,5,12,15,4,49,0.9335334273774645,29.958086193644153,2202
1,13,4,9,2,9,38,0.9456306035606213,30.071894900110138,2216
1,14,0,9,2,7,33,0.9166684020575415,30.429515824571766,2244
3,7,1,6,4,6,27,0.9531591530999838,30.231629158593396,2265
3,4,1,6,14,3,31,0.9101979966564108,30.632569373893887,2278
12,1,2,6,13,6,40,0.8636795946621579,30.916190946410513,2281
7,19,4,5,16,6,57,0.8687808629288014,31.08613733923015,2282
0,24,1,4,16,2,47,0.8181425716720473,31.31159416426598,2294
12,22,1,14,19,2,70,0.905149360480753,30.80563843909727,2287
0,22,2,19,17,6,66,1.1229906971970613,29.75021896689076,2275
0,3,16,16,16,8,59,1.0871398808700352,29.64152231531233,2277
1,1,16,15,17,7,57,1.0255132525306534,30.081194731675687,2275
4,2,15,8,10,8,47,0.9386318001985896,30.9988104645599,2291
1,3,14,5,11,9,43,0.8347854161091205,31.213415742204774,2284
1,4,13,2,9,8,37,0.761464112546267,31.571131967814676,2293
1,6,13,1,6,8,35,0.6398858785134952,32.06164814014707,2295
2,6,6,1,8,9,32,0.5953128299486663,32.30095527730501,2315
4,6,8,4,9,8,39,0.6139072110436412,32.34187738782355,2315
5,10,9,3,10,4,41,0.8753049867625315,30.466081127806255,2342
6,15,7,2,1,4,35,0.8739682856913469,30.797117994067616,2371
5,22,5,2,0,0,34,0.9193330327025405,30.81542277272571,2390
2,23,5,8,0,5,43,0.9006642658393268,30.927870830957804,2403
11,23,5,7,11,7,64,0.834993680810152,31.887810730240584,2404
6,11,5,8,8,10,48,0.6990629089299066,32.12056508586349,2418
3,12,8,10,8,9,50,0.7375078835820017,32.112696431605116,2411
10,9,5,13,12,9,58,0.9690014569710191,30.455306988684946,2400
10,8,9,15,12,8,62,1.036390019708578,30.620552080820545,2407
11,7,5,11,7,7,48,1.0730536951743812,30.459354906017793,2414
5,9,6,11,7,5,43,1.1147507599142303,30.29599810728761,2429
10,7,9,5,1,6,38,1.1038672156778768,29.732883852624255,2421
5,7,7,18,10,7,54,1.1073325433837937,29.485919704048268,2425
6,21,6,20,12,2,67,1.080814817950235,29.38429692159812,2407
5,28,5,21,11,0,70,1.0542383544182046,29.14305328814561,2391
6,27,6,15,12,9,75,1.0769845273697762,28.337842194970506,2360
5,30,6,13,5,10,69,1.0316959381793227,28.60843214702928,2329
7,15,7,15,0,8,52,0.9761218484375744,29.11119157013361,2324
18,20,5,13,5,6,67,1.1070523691693372,28.465352206507973,2314
8,21,5,11,4,8,57,1.1500836946354869,28.077072660819173,2303
13,19,5,12,9,6,64,1.3144019434362881,27.35086223819211,2282
12,18,8,11,11,8,68,1.440076687922892,26.496794734898547,2276
14,22,7,10,6,8,67,1.5073983998442888,26.056081966966456,2261
14,20,8,11,8,8,69,1.5045596244377522,25.272117234290256,2272
10,17,7,7,6,6,53,1.3683228471769837,26.153146435615223,2279
14,7,6,14,7,7,55,1.4044289113213855,25.646875376503015,2262
8,9,3,13,6,6,45,1.636517397535546,24.960288240044722,2297
5,6,6,13,6,5,41,1.6024174289462985,25.12270664234821,2318
3,5,8,12,15,1,44,1.6825193330787669,24.894648329947415,2332
3,3,3,13,20,2,44,1.741706036834395,24.47566856954515,2331
8,3,4,7,21,6,49,1.7909540641782347,24.880471560501682,2358
2,24,5,5,10,6,52,1.5121898557498732,25.770286770006273,2366
30,20,7,4,11,6,78,1.4687969067182935,26.54568391897064,2373
14,11,6,7,5,4,47,1.3559170001135912,27.8482169522533,2406
8,9,14,2,5,2,40,1.2980071066591983,28.011017547206713,2413
7,9,11,6,6,4,43,1.2147261774309996,29.235513555273194,2425
10,8,13,10,22,4,67,1.361438207557095,28.606571025252,2444
9,9,9,4,5,0,36,1.319578399892399,29.884178442733308,2477
10,9,9,11,3,2,44,1.2259458772357603,29.96706006717046,2500
5,11,12,9,4,4,45,1.2483602585743634,30.26277507747775,2519
5,12,9,10,5,2,43,1.103873497706854,31.70085867922365,2528
3,7,13,11,6,7,47,1.1032449504444832,33.0143731100579,2555
5,5,7,14,6,6,43,0.9791578968939294,33.9197841644063,2571
6,11,5,10,5,5,42,0.8260205417202955,35.444537930793814,2595
3,7,5,9,16,4,44,0.7709297014823493,35.97391038715713,2612
10,7,5,1,10,3,36,0.7079589518036731,36.4224129439148,2642
16,10,5,15,6,2,54,0.6885056420654931,36.67174904874768,2637
3,8,5,6,5,4,31,0.5853199526258261,37.58996858723994,2657
2,22,5,6,9,4,48,0.6254889364866609,37.68061957504969,2645
4,26,13,7,5,5,60,0.6519226686653108,37.82068023946081,2623
2,18,13,13,4,6,56,0.6953856274433404,36.61192351938157,2622
1,19,8,9,6,7,50,0.5926939163347518,37.67434087652903,2630
1,8,7,9,7,1,33,0.5768555026004273,38.1133195002676,2647
0,5,8,8,0,8,29,0.5507242893688269,37.597722275412714,2643
0,7,6,9,0,5,27,0.5228572296383306,37.551870323252224,2657
0,9,8,16,0,2,35,0.5811316543247106,36.971264420590266,2661
0,5,8,19,10,4,46,0.6647546210061865,36.835742852634034,2660
0,6,15,13,8,3,45,0.6651358492827611,35.97605630818098,2641
1,4,8,16,6,3,38,0.8716863512060131,34.30722233043074,2638
3,7,11,14,7,5,47,0.8903215036287747,34.401857445215335,2647
16,1,11,12,3,6,49,0.7848160052114268,35.19825664651783,2645
0,15,9,8,0,4,36,0.7474446082316208,35.18485286468261,2648
0,13,5,2,0,2,22,0.7093821767009749,35.813503254241,2667
0,10,6,0,0,7,23,0.677469610981216,36.51140323928509,2684
0,10,5,9,11,7,42,0.6400198219660124,36.71424861799046,2676
0,11,6,9,11,5,42,0.6221212714572815,37.467518663681794,2681
2,10,9,9,8,5,43,0.6830091006757617,37.012637116854684,2686
0,9,7,8,4,7,35,0.6677894744765145,37.4687735640858,2701
0,7,6,4,0,4,21,0.634438355368618,37.73257347813046,2701
0,8,14,8,0,2,32,0.6263937813908362,37.92626523156765,2712
1,5,7,7,0,4,24,0.7759620019629768,37.118962926897034,2740
1,9,5,2,1,2,20,0.8012838830205249,36.75730347458266,2741
0,6,6,5,8,2,27,0.7844723824129479,37.04217250711025,2752
0,3,3,7,10,5,28,0.8147895442425674,37.07658159749842,2767
17,2,1,8,4,4,36,0.7609363279878139,37.35852466538383,2767
2,5,1,8,7,5,28,0.7092061166663841,37.78484722650881,2775
4,5,1,5,13,2,30,0.7038204782295109,38.30802108594533,2777
0,1,0,8,8,5,22,0.6053717222597386,39.14824427717611,2793
0,3,1,8,10,18,40,0.6878924596004764,38.97122683449362,2803
3,8,5,6,16,20,58,0.718875626820372,38.3965547002749,2802
1,7,7,8,15,19,57,0.7757675963782382,38.08137228021742,2807
2,10,9,17,15,17,70,0.7642197425103243,38.05802927761078,2791
1,7,13,19,7,12,59,0.7822665027428071,37.70808694324994,2779
1,10,15,9,5,14,54,0.7974841125522315,37.94280943558884,2769
4,6,15,14,1,12,52,0.8251160026986613,38.4882982744381,2769
7,6,13,7,0,9,42,0.7357142156418616,38.33267341749826,2757
4,6,13,4,3,5,35,0.6339333577022692,39.15914641663904,2771
0,12,8,2,3,3,28,0.5427027005711473,40.009162938280554,2776
3,23,5,1,16,1,49,0.6072228095920433,39.730126978235894,2773
5,21,8,11,15,10,70,0.6554751825487156,39.164496079418925,2755
5,23,6,10,10,14,68,0.6021095087224924,39.45767398318632,2757
5,20,5,5,10,15,60,0.6119552339181137,39.19144437012091,2746
15,17,9,7,4,14,66,0.6763734454845957,40.21596466997666,2745
16,17,8,7,9,15,72,0.7256502959354363,40.228653789325755,2736
13,14,5,11,10,19,72,0.8116059532488051,39.66772182172517,2734
11,14,5,20,8,20,78,0.7002576172459445,39.59141098313493,2720
10,15,6,11,4,16,62,0.7918530790521106,39.414715582738545,2725
15,13,4,6,3,12,53,0.7163684314382928,40.327103669493674,2737
37,11,6,4,16,12,86,0.7069655425377921,39.990577914671185,2728
39,8,5,6,11,11,80,0.6634784071227435,39.904822995825725,2717
21,10,5,5,17,17,75,0.7500834590872291,38.31188050933267,2697
2,6,5,6,9,12,40,0.6643363820599925,38.91379978554931,2697
28,5,5,11,4,8,61,0.625788662199589,39.32425782633904,2686
7,5,5,14,12,9,52,0.765426791133089,38.00213186013703,2680
5,4,10,15,10,11,55,0.9240605625792634,38.42210638857639,2671
2,5,7,14,17,9,54,0.9800217308218178,36.82230154589844,2663
5,8,9,15,9,5,51,0.9652826305970024,36.136812476633814,2665
5,5,6,13,12,6,47,0.9371514436507016,36.43981794980527,2664
11,2,8,11,21,5,58,1.0503253314567926,35.49744284821149,2662
15,10,5,13,30,5,78,1.099215158089548,34.05264127915374,2651
17,7,5,12,27,5,73,1.0127523175425541,34.139104189562005,2638
16,5,5,4,20,3,53,1.0496183115843176,33.74466540159157,2641
7,10,5,3,13,4,42,0.9703098368750345,34.73272883860322,2644
5,9,5,2,4,8,33,0.8814983446901427,34.51199764137608,2638
8,13,5,1,2,11,40,0.9112144363831749,34.399537789306976,2626
5,14,5,16,6,13,59,0.9484197990492781,34.433015822635795,2633
20,20,5,15,8,11,79,0.9875926601148386,34.6440108192809,2652
8,18,5,12,13,11,67,0.9627096626222352,34.641267665827634,2653
11,16,10,8,6,11,62,0.859250797955605,35.17016747450154,2649
10,18,9,8,10,14,69,0.8795370479293647,35.2750336486339,2664
10,15,6,7,20,10,68,0.8960115145209464,34.766567603822885,2657
6,5,0,8,21,9,49,0.9034576777277148,35.133137889399556,2678
6,5,5,5,5,6,32,0.9654639866441532,34.85760879162047,2684
10,13,5,5,2,7,42,1.1123185121943207,33.85522194248502,2711
8,8,7,5,6,7,41,1.1225263991733725,34.082302934489384,2719
5,10,5,7,7,9,43,1.218865649191172,33.516648036084156,2753
10,9,8,4,11,7,49,1.2991800203669293,33.77106192583119,2776
12,11,7,2,12,9,53,1.3111823671497644,32.982609642851074,2776
10,11,9,14,13,8,65,1.242461285898862,33.89792739281687,2799
1,7,10,6,7,9,40,1.09187281245094,34.825688362984835,2810
34,1,7,3,0,5,50,1.0964276668470785,35.26027373448739,2849
17,3,10,6,13,8,57,1.0726482545757843,35.652221953133306,2852
9,2,10,2,7,9,39,1.0565385926296689,35.91742850264302,2879
11,0,8,0,6,8,33,0.9005630314021995,37.30481662979243,2925
6,2,7,0,7,7,29,0.793701423629023,38.71581596291026,2944
2,2,5,0,5,6,20,0.7079148462059949,39.64573386026027,2966
8,4,5,6,13,5,41,0.7199474520787765,40.332809770746515,2970
4,14,5,1,14,7,45,0.7216673278068851,40.66780292610237,2973
6,15,14,0,7,2,44,0.7628812100468607,39.90149291771634,2978
3,15,11,0,8,0,37,0.7432945261816712,40.366428302443836,2987
2,3,14,11,4,0,34,0.6917018327752466,40.396915909413785,2984
0,10,10,13,3,0,36,0.6370943219125518,40.945006903177706,2991
1,8,11,16,21,0,57,0.7535754657660042,40.992758233652445,2985
5,9,13,16,23,0,66,0.8701865051972535,39.82181330672282,2967
7,7,9,14,11,0,48,0.7720234891934925,40.62295878904888,2978
9,3,10,13,7,0,42,0.7299168969414598,40.814043445812935,2985
7,2,9,13,4,0,35,0.5911953675079961,41.487642453594766,2974
6,1,9,12,13,0,41,0.63679740382842,40.79096591294129,2961
6,3,4,9,14,0,36,0.5765855238981673,40.95483323331852,2954
6,1,5,10,11,0,33,0.5706083993185173,40.84017935080064,2950
9,1,5,5,6,0,26,0.5617810082516751,41.184116179869264,2947
13,1,5,3,9,0,31,0.6014660702740638,41.31434796643345,2962
10,2,5,4,5,0,26,0.5663794509074829,41.719727500981065,2965
9,0,5,17,2,0,33,0.5553145638020279,41.584938211835194,2976
13,2,5,16,4,0,40,0.5891252842304199,41.333050661153884,2974
38,0,5,12,19,0,74,0.6648434946368084,41.098862118576974,2968
25,0,5,10,16,0,56,0.5995616149290585,41.013782901037345,2945
2,8,5,11,7,0,33,0.5574519523778595,41.140503067572645,2939
17,7,6,12,13,0,55,0.5747417607075855,41.70884450082025,2946
5,7,15,6,22,0,55,0.6551986449377766,40.7219157102587,2944
9,6,12,6,12,0,45,0.7050412686508748,40.51030697511846,2955
9,0,12,9,9,0,39,0.6733794407624137,40.76914146077842,2964
6,0,12,6,8,0,32,0.6626711988599454,41.68533356934967,2996
9,0,7,10,16,0,42,0.7070501270270397,41.495508966597555,2993
18,0,6,6,14,0,44,0.6155809782815431,42.17804806225151,2996
6,7,5,3,9,0,30,0.5603412833903699,42.25752730705311,2985
4,1,7,9,9,0,30,0.5515819948620845,41.991925768288304,2989
1,1,6,8,19,0,35,0.5790732995491942,42.12171902238207,3011
1,0,6,4,4,0,15,0.5030514231162219,42.600479926885974,3028
0,0,3,4,1,0,8,0.4387589684873272,43.069338878369514,3040
1,1,5,1,0,0,8,0.4144844851791867,43.1618381630902,3043
0,4,5,6,17,0,32,0.4939686327254554,43.169744670876625,3057
10,3,5,6,14,0,38,0.466169065379544,43.1945117409605,3059
6,6,5,1,12,0,30,0.4486227179564311,44.49977212013263,3080
9,6,5,0,14,0,34,0.45035879008226254,44.570750468045816,3088
0,6,5,1,3,0,15,0.4520500342676021,45.05543931828967,3124
0,4,5,5,0,0,14,0.40645104680443905,45.71494802780825,3150
0,7,5,2,0,0,14,0.39942606556473376,46.05922632262135,3169
0,11,5,3,0,0,19,0.44016789216047403,45.757934645078315,3178
7,10,6,6,21,5,55,0.49203231377902595,45.097883890830204,3165
18,15,5,7,28,7,80,0.5086973840482325,44.53634695920752,3147
20,0,5,6,18,9,58,0.39838673514893186,45.119673559292174,3138
11,0,14,6,10,8,49,0.3627479451910351,44.56378408972635,3110
3,0,11,7,0,8,29,0.3097642525784714,44.6499787073532,3116
2,0,8,6,2,9,27,0.3509308466798609,44.4791308405112,3125
0,0,8,5,2,9,24,0.3515758624161484,44.57878574645153,3138
10,0,7,7,0,14,38,0.42587011716975215,44.14036971257917,3136
5,3,10,5,16,9,48,0.4349604917795828,43.64656760007684,3123
15,10,5,6,6,11,53,0.5022966905955545,42.77072839140345,3100
0,9,9,7,8,9,42,0.5163888371263674,42.315811914127806,3089
0,6,7,6,6,3,28,0.5033410350362056,42.53509046285683,3081
0,20,4,17,16,6,63,0.5702434125588263,41.7649859618682,3054
0,18,0,19,18,2,57,0.6135026258436258,41.30928632730203,3040
2,19,2,8,18,1,50,0.5549530285410426,41.68729580174766,3026
1,19,6,4,14,6,50,0.5442760112144773,41.9809190021799,3011
0,7,10,8,13,7,45,0.5207998112426632,42.634935753329465,3011
2,6,15,6,13,9,51,0.47184485242293267,42.6094656884919,2998
0,5,15,8,8,11,47,0.4800935368538563,42.25708890366178,2985
2,3,15,2,5,6,33,0.49929348650574423,42.1931820399945,2982
0,0,15,6,6,6,33,0.4309195928683451,42.61052927074294,2982
3,0,16,2,8,6,35,0.35594043257180696,43.001303393583726,2984
4,19,15,2,14,5,59,0.41003800749082403,42.74690623160816,2981
7,19,6,0,0,0,32,0.40716956209907895,42.517779556957656,2975
5,19,6,1,1,0,32,0.5156769259155727,41.91386911206948,2979
5,20,5,12,3,3,48,0.5616369622274073,41.250823169758775,2971
7,1,5,14,3,5,35,0.5029084928647954,41.44193471782073,2976
13,1,5,15,10,6,50,0.5723977694605846,40.809598189153135,2958
10,8,6,9,9,8,50,0.64391993611607,40.31217281910145,2951
8,5,8,7,7,8,43,0.6762063345941303,39.94247509502173,2941
11,6,6,8,8,6,45,0.7707419174206337,39.10865597106974,2937
14,7,6,2,17,5,51,0.7703332095521191,39.05903388600917,2935
11,6,12,6,15,4,54,0.7456287248867637,39.43937161070928,2940
13,9,9,10,8,10,59,0.716533025682367,39.408783718670705,2946
2,6,7,12,10,6,43,0.7455275555925227,39.18715304074824,2960
28,6,5,10,9,7,65,0.8292061690443424,38.753025966393274,2947
12,1,12,4,8,6,43,0.7732794817105353,38.57476459055653,2933
8,4,8,3,7,7,37,0.7614187470613127,37.657026571822534,2919
4,4,9,3,6,7,33,0.8022328977558226,37.92172849953742,2918
12,23,0,4,14,7,60,0.8820627822394195,37.61419292327729,2913
7,23,6,1,20,7,64,0.8737388060660145,37.638194269292576,2920
9,22,5,0,2,8,46,0.9141532291340433,36.45417597416546,2917
10,17,5,6,4,7,49,0.9688955014019657,36.90522292855022,2927
7,5,5,9,6,7,39,0.9304174329905972,37.35735558534134,2944
6,6,5,8,2,7,34,0.8299632694410084,37.86620742091627,2942
5,6,0,1,2,7,21,0.7536640330612076,38.45047302562605,2950
10,10,6,2,11,7,46,0.7879702210447588,38.659581966463364,2966
13,7,6,4,10,6,46,0.8302715029503256,38.246022710694376,2975
6,7,10,7,8,6,44,0.8565186302852797,38.19361878955997,2978
21,0,7,5,7,2,42,0.9210847633534285,37.98977550600084,3001
10,7,7,3,18,2,47,0.9209706261912709,38.47726329375457,3038
11,4,7,10,4,0,36,0.848808971440829,38.75175797106301,3048
11,11,6,5,7,0,40,0.847120416203381,39.65747483448607,3086
8,20,5,7,6,0,46,0.7084432428103902,40.54797383324106,3092
10,21,7,6,4,4,52,0.7390729338747203,41.052307238063236,3097
8,21,6,7,12,7,61,0.7630522047826597,40.67279939742546,3106
12,0,11,6,4,6,39,0.672876240854279,40.945761401919256,3112
12,0,8,7,7,10,44,0.7036108918904858,41.188622851162464,3118
13,0,5,7,7,9,41,0.6548578763706245,42.01766705185904,3119
11,0,5,8,18,8,50,0.698840075455767,41.868308936109244,3111
3,0,5,6,14,9,37,0.7191482000153915,41.26008500284396,3116
5,0,5,17,0,7,34,0.6797074037636316,41.8305084318257,3112
1,0,5,17,4,10,37,0.6418605546546297,41.950406871469866,3111
32,0,5,16,9,12,74,0.7350502662718122,41.08236690129027,3081
11,15,15,13,6,2,62,0.7590168655260466,40.22808815823704,3055
8,21,13,18,11,1,72,0.802546337801647,39.36932018737385,3041
10,22,9,21,4,13,79,0.8231322683615593,38.97400846123548,3013
5,25,8,19,5,20,82,0.903173567145191,38.26384034097587,2995
8,5,5,13,4,16,51,0.8934710699920092,37.286509806895516,2970
3,8,8,11,17,18,65,0.9041067302216301,37.09646873357995,2961
3,8,7,11,13,14,56,0.8503219757036421,38.25286882797756,2969
4,4,9,12,3,11,43,0.7802009676913825,38.40817358017627,2966
4,6,10,8,3,12,43,0.7694376549572075,38.8889823700243,2973
1,6,10,8,9,9,43,0.6931270155285659,39.30591576147279,2965
0,24,14,9,5,7,59,0.7069991367366382,38.50763846511759,2951
0,27,10,7,6,0,50,0.7407425091109466,38.43122385565259,2939
1,29,5,3,3,10,51,0.7376235241794823,38.66738081965431,2932
13,20,16,13,13,8,83,0.7255293239276094,38.511279698490355,2908
1,12,15,12,15,14,69,0.7715788035897941,38.690386213466255,2891
1,13,15,16,18,16,79,0.7982355543165699,37.36911226952927,2857
1,19,15,12,10,14,71,0.9465181561808343,36.69276821114397,2843
1,25,5,7,7,14,59,0.9830934179131116,36.56610118248816,2849
0,22,7,9,6,17,61,0.9827849493531339,36.75260533758983,2836
0,27,5,9,5,5,51,0.9126235036532944,37.208027316003324,2845
4,22,5,9,5,8,53,0.8318883234837837,37.57535206349326,2839
5,14,5,5,0,11,40,0.8284572142082294,37.9845870736598,2858
7,10,5,5,0,7,34,0.7542361896918155,38.15887055627662,2871
7,9,9,4,0,9,38,0.7259827012482876,38.58226493767401,2887
7,7,5,5,3,10,37,0.7159953602897879,38.78376802378385,2913
9,6,5,6,3,9,38,0.7388902687265129,39.14542571468631,2935
2,6,5,2,16,8,39,0.8245304762641914,39.10250977184999,2974
24,7,7,0,14,8,60,0.8542447158389941,38.78748971169435,2970
13,10,5,1,26,7,62,0.8628095963470059,38.57952068009453,2980
12,10,3,0,17,4,46,0.9416831425191059,38.191163029265056,2988
32,10,2,0,16,7,67,0.9759559243396201,38.23127103114614,2999
33,15,2,15,18,7,90,0.9203548212985933,38.29766733845756,2993
18,10,3,11,25,5,72,0.9387986968295939,38.333356083131534,3003
19,9,6,8,18,7,67,0.9402052483603286,38.37683150060342,2997
12,9,6,6,23,7,63,1.0194932449442993,38.20268351507554,3009
14,12,5,6,31,6,74,1.063575050938892,37.92990655778208,2997
14,13,6,6,27,2,68,1.0044710733921833,38.27803429136286,3004
14,22,6,7,11,0,60,0.9949795814969649,38.35192423336305,3016
11,23,5,6,10,5,60,0.9287291116267431,38.989503238173874,3013
22,18,7,14,14,12,87,1.0177208305850698,38.393222895300994,2992
1,9,10,13,18,9,60,0.8557393787789399,38.80393506435328,2987
28,7,11,14,14,8,82,0.856290961918364,38.77422788175474,2966
20,9,10,12,9,6,66,0.7498585573620441,39.27924604633508,2953
11,6,10,16,16,6,65,0.7763397696328372,38.7143577665303,2926
8,8,10,16,10,5,57,0.783289348668152,38.56016980431551,2935
8,5,10,22,5,17,67,0.7465856874341551,38.719229867768085,2926
2,2,10,22,5,9,50,0.6014232234559318,39.34389557178207,2924
9,11,4,21,20,5,70,0.737106031187408,38.413122762271584,2894
21,14,5,19,18,0,77,0.724218368648319,38.25682867184366,2853
16,19,5,17,6,8,71,0.6967259736704584,37.834765188492995,2819
2,24,5,13,8,19,71,0.70963197853127,37.49288771732206,2796
4,21,6,13,6,12,62,0.7140273623618253,37.295895943999895,2773
3,19,6,18,8,17,71,0.7296412338704354,37.17290169342342,2750
3,19,6,15,12,17,72,0.8141495769329902,36.194812884692965,2740
10,20,7,15,13,19,84,0.8951352835315074,36.0956600458446,2729
8,17,10,12,14,19,80,0.9494139349483312,35.371686830302245,2713
1,15,8,13,14,17,68,0.8520318523435392,35.87382732519833,2711
0,11,6,12,1,19,49,0.7784991483973224,36.9744113219286,2724
0,15,3,11,0,17,46,0.7077899721634887,37.29842878304551,2722
1,15,5,15,6,17,59,0.6710986085584179,37.85264396839509,2713
1,18,5,11,11,17,63,0.7654633780065306,37.78977090560277,2720
1,23,6,10,5,15,60,0.8469584485342577,37.803468460463904,2726
0,22,7,10,8,12,59,0.9204220630067148,37.50032062830855,2723
0,25,7,9,6,17,64,0.984563065369959,37.434991992004136,2720
0,23,5,6,4,17,55,0.9102498397839296,37.52581791747869,2736
0,23,5,7,0,12,47,0.909489289051652,37.49578952202682,2746
0,24,5,7,2,9,47,0.8208734359502393,37.865571140822766,2754
0,11,6,8,12,7,44,0.7892584696926883,38.05302179124652,2760
5,8,6,2,7,6,34,0.8444925624937053,37.88032249952974,2761
20,6,6,3,8,9,52,0.8236026102766375,37.491232911714015,2760
2,6,5,5,7,9,34,0.8181895344369535,37.13024546569645,2766
0,7,9,7,5,5,33,0.8568882996612313,36.45272035433738,2796
1,6,7,16,0,6,36,0.7791834235267308,38.22811749479937,2801
0,1,6,12,0,7,26,0.7714218311636993,37.91603639271273,2824
0,19,6,14,0,6,45,0.8200592038400852,37.83485733134907,2853
0,17,6,7,11,0,41,0.8532333180382207,37.18676464196023,2890
0,23,6,8,9,1,47,0.8637743415310964,37.52269674968561,2923
1,17,11,8,6,2,45,0.8192637060532134,38.07433374712026,2942
0,5,7,5,6,6,29,0.7319604832301684,39.15242161207947,2978
0,6,10,5,0,6,27,0.6551961132469413,39.65773461931473,2995
0,6,3,2,0,7,18,0.6197929449774475,40.169055705526326,3019
0,7,5,3,0,7,22,0.523881617089964,40.76941004968798,3039
1,5,5,3,0,3,17,0.5571681394851298,40.713860321707365,3046
11,5,5,11,8,3,43,0.6122919810828922,40.94433392663769,3032
2,9,7,5,8,4,35,0.6347894922257253,40.94643746052859,3044
2,6,7,6,6,3,30,0.6532733013033135,41.32091145103137,3065
2,6,6,7,7,2,30,0.6330742207112192,42.017934188762226,3076
2,5,5,5,11,0,28,0.5789969894782664,41.416842527434994,3071
1,8,7,7,19,0,42,0.6102787253376852,41.71509523157318,3065
0,7,12,7,16,0,42,0.6201776171390121,41.66594628610906,3047
2,5,13,6,17,0,43,0.5748718835914659,41.79035286247409,3038
3,24,9,8,9,0,53,0.5817343531725265,41.665704785613215,3030
0,22,15,10,0,0,47,0.6039193321857182,41.35082316447664,3011
0,18,8,16,0,0,42,0.5954746173320362,41.51733177784223,3006
0,18,10,7,0,0,35,0.5025215721174477,41.62226086290784,2994
0,16,6,4,0,0,26,0.49372864382829773,41.47914770460013,3001
0,16,7,18,10,0,51,0.5255914610889784,41.85518496440344,3001
13,13,6,18,13,0,63,0.5553053031834417,41.67496258526338,2975
1,9,8,20,7,0,45,0.6930990100667334,40.17336575150327,2954
0,1,11,21,6,0,39,0.9097397897981818,39.45530532551163,2958
0,6,10,22,0,0,38,0.8953781324246421,39.85959535577205,2947
0,6,8,22,1,1,38,0.9010416641998258,39.06964721933506,2941
0,6,15,13,0,0,34,0.8087320785054206,39.63797504122936,2947
4,6,15,15,0,0,40,0.6679025352588644,40.23551428819972,2967
17,13,16,14,18,0,78,0.7240703277352905,40.5395836857742,2946
13,12,15,15,12,0,67,0.7098635379793119,40.240668082794,2916
7,10,15,8,10,4,54,0.6469081680622569,40.58606394051746,2921
6,7,14,8,8,7,50,0.5621025798547983,41.60366667050073,2926
4,7,9,8,0,8,36,0.5331960844249046,41.78378611846543,2938
5,8,5,15,0,10,43,0.5886621208468518,41.7548919134676,2941
2,17,7,13,0,9,48,0.6018956191400242,41.99706689893443,2947
9,13,7,14,0,9,52,0.6553023156294031,41.95337030816634,2940
1,17,5,12,19,10,64,0.7507458117346358,41.658803336831085,2936
23,11,4,11,17,8,74,0.7583795603233974,41.24258785178535,2909
18,11,10,7,12,9,67,0.900878207793236,39.27311618717961,2901
12,9,7,18,12,8,66,1.0136394514068303,37.97393344078721,2903
7,17,8,22,20,7,81,1.1259586787798392,37.56286875262186,2901
9,19,6,14,5,7,60,1.1922721390856967,36.39020733503933,2893
15,20,8,14,5,6,68,1.170034541882409,36.63905208514871,2883
13,9,5,15,10,4,56,1.0414611103984561,36.631563130387505,2905
14,15,5,8,9,5,56,1.0120629185461412,36.67416680545378,2890
14,14,5,6,13,8,60,1.0289879275035203,36.91487329713998,2897
10,12,5,6,8,6,47,0.9621965741283586,38.00364218714324,2900
11,15,5,5,2,7,45,0.9485715264022596,38.5861648677924,2916
5,13,5,5,15,5,48,0.899891163110966,39.169796388208994,2925
20,12,7,6,20,6,71,0.9054983072476922,38.7061972701108,2917
26,12,5,3,19,7,72,0.7802777831837394,39.195244292979574,2896
22,7,5,5,17,8,64,0.742207223315389,40.128861297885585,2889
6,7,5,6,19,9,52,0.7666834206584517,39.92936306895527,2908
6,3,5,5,15,6,40,0.7494150427531425,40.37359299891204,2919
13,1,5,1,1,7,28,0.6602963743431324,40.383791607533034,2918
10,23,6,0,6,4,49,0.7117046360151321,40.17285731338741,2906
18,29,0,8,24,2,81,0.7992877599839079,39.3769324739279,2888
23,31,6,1,22,5,88,0.8753199943753426,39.1819735341064,2864
22,26,5,0,7,10,70,0.7476905955656648,39.4888362963195,2849
6,8,10,0,8,7,39,0.7005184779940342,39.9081388809752,2853
8,17,9,11,19,8,72,0.80926546234746,39.38684592841175,2857
10,19,9,12,6,6,62,0.8507542556311499,39.07196099277118,2863
0,21,11,15,4,6,57,0.8448689766856937,37.960822364390495,2827
15,19,10,17,0,6,67,0.9858859579119298,38.08892728313356,2831
7,21,11,18,12,7,76,0.9600238143439657,38.270785853887716,2814
11,21,12,9,9,6,68,0.9802239321180477,37.3098668774455,2808
6,19,12,6,9,5,57,0.9530060832222972,37.18573474637901,2785
7,17,10,6,10,7,57,0.9738283178424015,37.39922896980133,2777
12,11,10,6,15,7,61,1.027969922772881,36.40970660920424,2768
3,20,7,0,13,6,49,1.0323438089573498,36.36525612336563,2770
3,21,5,0,16,8,53,1.0530658815379925,36.19527689834697,2756
2,17,6,15,12,9,61,1.2110973318345024,35.69496973346338,2756
6,18,6,16,13,6,65,1.2908767672353796,35.68800653391939,2750
3,18,6,15,13,7,62,1.237881991716265,35.42209012114545,2752
3,22,11,12,6,6,60,1.2215395539724103,35.91202644855356,2771
0,18,15,9,7,6,55,1.1819397983391426,36.736542092881635,2771
1,14,15,13,4,6,53,1.0113099160803014,37.834223326293035,2783
3,7,3,5,8,10,36,0.8944091451599655,39.338498534049805,2820
5,15,11,18,8,8,65,0.8532597529318556,39.282104359485395,2830
4,15,11,16,13,8,67,0.9246465030124706,37.94632607576223,2830
3,27,6,15,14,5,70,0.9360938779592668,38.313248074229996,2855
1,24,5,12,8,19,69,0.8582852523922198,38.20630331584076,2855
6,14,5,16,1,20,62,0.8006664699500924,38.56246594853968,2861
7,14,11,14,2,19,67,0.8590490014058738,37.53295311455174,2847
8,13,3,7,0,15,46,0.8291559168843822,38.32796481160907,2872
10,13,1,5,0,11,40,0.7046845178291593,39.05469466029795,2876
6,13,5,3,0,13,40,0.6583393061288367,39.73590633527518,2883
7,6,5,6,10,5,39,0.6057091033689835,40.74379181787801,2908
5,2,5,3,3,13,31,0.5694144650739258,40.68548119669241,2938
4,18,5,6,2,3,38,0.5727824243917671,40.82736756427396,2941
5,21,5,3,6,4,44,0.5652394984672214,40.639403720684044,2942
2,20,5,0,6,5,38,0.6564824997401285,40.700082576084924,2955
6,22,5,3,9,9,54,0.6555472810501011,40.422177694233895,2943
9,21,5,0,9,10,54,0.6854222917402057,40.35375505488375,2937
7,19,5,0,6,8,45,0.6341402141800951,40.29824920233293,2928
6,19,8,0,8,6,47,0.7078501212272247,39.510723794496066,2924
10,19,7,0,5,7,48,0.6646781874924602,40.536272904102844,2925
5,17,5,11,7,5,50,0.742830613267408,40.33492979708679,2913
4,19,6,13,19,7,68,0.8689070358225297,38.373269759562724,2896
4,10,4,14,17,6,55,0.9207554651733842,37.57775324105295,2887
1,5,10,13,14,5,48,0.9829747743375723,36.661919034559936,2882
1,5,6,15,20,6,53,1.0657129730223394,35.90455478468736,2887
2,6,6,12,19,5,50,1.0410535743754086,36.44696575337142,2869
3,2,6,11,5,7,34,0.8935890028727471,36.99141684663956,2882
1,3,5,2,3,5,19,0.757283675098456,38.151570326834715,2888
13,4,5,1,11,6,40,0.6778561749759168,38.87988563009748,2891
0,3,6,0,10,6,25,0.7722925657698264,37.72723953434242,2908
0,3,11,5,7,7,33,0.7984629465749692,38.230395688655385,2947
0,6,6,0,4,6,22,0.7329206616693107,39.11817752515049,2959
0,17,6,0,11,5,39,0.7649518438093261,38.84413519636685,2962
0,15,5,0,7,17,44,0.8692366818298205,38.74764164605663,2981
0,19,7,0,0,17,43,0.8819929574133514,38.708586523940056,2988
0,14,6,1,0,15,36,0.9385460360410518,37.59184199190442,2989
0,9,10,15,6,18,58,1.0078730825527693,37.18713190301103,2994
0,7,11,17,7,19,61,0.9615892341228542,39.27779064712484,3005
1,10,8,15,1,15,50,0.9445935543213652,38.879301244418684,3018
0,10,5,13,0,13,41,0.837938039386315,39.62140806901111,3029
0,11,7,12,11,14,55,0.8484932788758648,39.830768667220845,3042
1,7,7,15,13,14,57,0.8436438564259682,40.48287152441322,3061
2,7,5,10,10,10,44,0.7174833710846709,41.79660695712129,3085
0,8,8,13,9,6,44,0.5644658905990035,42.93390367426625,3104
0,6,7,11,12,7,43,0.5229717780635594,44.06532715998364,3111
0,7,7,10,9,11,44,0.5278718852462017,44.83599121784978,3117
0,4,8,14,8,11,45,0.5433005161851204,45.21834360114725,3134
0,0,14,15,5,6,40,0.5049797555620368,46.28550190526542,3148
0,0,15,10,2,8,35,0.5264352976760794,46.378927149696835,3162
0,0,6,7,3,7,23,0.48920596471546157,47.17094745901397,3187
0,1,0,2,2,7,12,0.424968607454323,47.71990437255109,3208
0,0,10,6,0,7,23,0.4348111357377203,47.9906440744082,3227
0,0,10,10,3,8,31,0.4586465080319059,47.8140315926108,3237
0,16,8,3,0,3,30,0.4406874307241627,48.089031971651764,3263
0,18,6,4,0,0,28,0.4635721882745718,48.24526432878728,3269
0,24,6,8,0,3,41,0.4812011308967517,48.13113054979901,3275
0,18,5,6,6,3,38,0.46556550351067394,47.864592691672165,3271
0,1,6,8,2,8,25,0.40551757720320325,48.227318495247665,3283
0,7,8,9,0,7,31,0.3775635763243069,48.80848648546269,3300
0,7,7,8,0,8,30,0.3963432662072044,48.70368188733834,3309
0,7,5,8,0,7,27,0.38173997879463006,48.97586573300881,3316
0,9,5,6,0,6,26,0.34723202295701233,49.23768035518515,3319
0,6,5,7,0,7,25,0.28851292264587447,49.688221725114,3320
0,5,5,9,0,6,25,0.29676991216190507,49.50738588871656,3325
1,5,5,7,5,5,28,0.32218252799958197,49.71175060612617,3337
0,6,5,4,0,3,18,0.32378014682162876,47.33421820772838,3332
0,5,5,5,0,3,18,0.32320850615401675,49.941837024692255,3348
0,7,0,7,0,2,16,0.2910555251569758,49.46093994543117,3350
0,17,7,7,0,4,35,0.29869771520935046,48.30599568763345,3338
1,25,6,13,0,2,47,0.40273468434868837,47.405030838759764,3329
0,27,8,13,0,6,54,0.42016126598944176,47.34337279694912,3312
0,25,6,15,0,5,51,0.37750674201431095,47.247716446947344,3295
1,12,15,14,0,8,50,0.4082967136864913,47.76554548173882,3293
0,9,10,13,0,8,40,0.4048083402752532,47.70176762087939,3282
0,11,13,13,0,7,44,0.43011628903298665,47.06585514364222,3264
0,17,12,12,0,7,48,0.45207373396043143,46.958408680005306,3239
0,10,8,12,0,7,37,0.49105479984584405,46.8300119629431,3231
0,24,11,12,0,6,53,0.484566018474852,46.61185432619923,3204
0,16,8,13,0,5,42,0.4952023966920805,46.296423316944136,3187
0,13,6,12,0,6,37,0.49784327956412167,46.0614915873024,3179
0,9,8,11,0,5,33,0.4715574290381048,46.27293633076961,3188
0,10,6,6,0,8,30,0.4776050636989387,46.428288595231265,3192
0,10,8,15,0,7,40,0.5188225930998522,46.48799299958616,3193
0,11,7,14,0,5,37,0.5663507114519378,46.4701435009828,3202
0,9,5,17,0,6,37,0.5605088620837879,46.54952860646362,3194
0,11,0,11,0,6,28,0.572384781242695,46.66073810439035,3196
0,12,0,10,0,6,28,0.5161509122645829,46.69099080856164,3187
0,10,0,7,0,10,27,0.4915122689952618,47.01528673016256,3198
0,13,0,11,0,7,31,0.46193684463311874,47.4507753622209,3203
0,13,10,3,0,7,33,0.5072454203544962,47.37319319210778,3208
0,9,9,7,0,7,32,0.509585435638244,47.44232376088695,3228
1,7,5,7,0,6,26,0.4545017660168507,47.68265544906355,3222
0,3,3,4,6,7,23,0.4798057265374264,48.043538545503154,3247
0,2,6,3,0,4,15,0.4338612348507052,48.341444166116936,3255
0,3,1,5,0,1,10,0.41984712299057114,48.85968424138666,3272
0,6,1,14,0,3,24,0.44651837217274326,48.73395585297425,3272
0,6,0,13,0,1,20,0.4675892254624449,49.004982539717986,3277
0,24,6,11,0,3,44,0.4863893878558876,49.18094309817684,3297
0,24,2,7,0,1,34,0.5266931940963004,48.73816900672347,3292
0,27,5,13,0,6,51,0.4799515292828086,49.02227256309324,3300
0,14,5,8,0,10,37,0.37410659325157547,49.95974737702093,3323
0,8,5,7,0,7,27,0.32588860649108187,50.66054460450152,3350
0,7,6,7,0,7,27,0.30495246247365737,51.010269505386766,3366
0,10,9,12,0,10,41,0.3059163932782291,51.16020229845457,3377
0,9,5,14,0,8,36,0.3096846685586036,51.31622166065662,3377
0,6,5,14,0,6,31,0.28929202845344926,50.98564861528095,3371
0,4,4,13,0,5,26,0.31249148547587713,50.627930723003196,3367
1,3,2,13,0,5,24,0.32098935283604146,50.64931096287189,3369
0,4,1,13,0,6,24,0.3028586403258786,50.91204346885458,3379
0,3,1,8,0,7,19,0.297555602776949,51.48970742139608,3389
0,5,0,9,0,5,19,0.2782595092938146,51.68512313240068,3392
0,2,0,12,0,5,19,0.24260108929973487,52.02123216533519,3388
0,3,0,9,0,6,18,0.21815854724369915,52.221571597386934,3395
0,5,1,5,0,5,16,0.20882346513365704,52.28151363655204,3401
0,4,0,4,0,6,14,0.21828842186060152,52.33615469512966,3410
0,5,0,0,0,8,13,0.20817898347236805,52.558702441220575,3419
0,2,0,0,0,7,9,0.21447891592948046,52.728609850323664,3431
0,6,0,0,0,4,10,0.20293493284080286,52.925574417149996,3438
0,8,0,1,0,7,16,0.21989342436848971,52.84917819471288,3446
0,11,0,2,0,7,20,0.23571175018295493,52.83292802257825,3447
0,13,4,0,0,6,23,0.24274576924346944,52.86531707812782,3446
0,8,0,3,1,6,18,0.26823092328855425,52.801285545493045,3451
0,11,0,7,0,5,23,0.25113782710539506,52.86698894584798,3448
0,8,0,7,0,6,21,0.2512860975749185,52.99759277711615,3448
0,4,0,6,0,5,15,0.2367855826729337,53.08633192688526,3457
0,5,0,5,0,8,18,0.22286208221767315,53.203251707549974,3456
1,4,1,5,0,5,16,0.1790832159736638,53.274178197999376,3448
0,5,0,1,0,10,16,0.18181352900249542,53.449142528840966,3458
0,3,1,5,0,7,16,0.16727903075832437,53.4381034245839,3462
0,3,5,0,0,4,12,0.19793995374269693,53.10311612053187,3463
0,4,5,0,0,6,15,0.16385700322252483,53.35261782150543,3460
0,3,5,0,0,7,15,0.15902999310985613,53.21062997969007,3455
0,2,5,6,0,8,21,0.1878636084241695,52.965785780333405,3452
1,5,0,0,0,5,11,0.19321005831477728,53.25754923008449,3459
1,6,1,0,0,6,14,0.1801975737675578,53.18033002445157,3465
0,5,0,0,0,6,11,0.17528249120637324,53.55441868732664,3473
0,4,1,0,0,5,10,0.17463542120042352,53.77104357776221,3481
0,9,0,0,0,5,14,0.16985474288269625,53.76554920630667,3477
0,13,0,0,0,6,19,0.21100373369122027,53.664230487987176,3488
0,11,0,0,0,7,18,0.23069714948423142,53.80016253388748,3494
0,10,0,0,0,6,16,0.24864558678563706,54.22379578383723,3506
0,10,0,8,0,7,25,0.21550999168515905,54.3407809116,3496
0,7,0,1,0,6,14,0.20871394586286565,54.340278607144676,3501
0,8,0,0,0,8,16,0.20176791591072388,54.49718880373376,3503
0,8,0,0,0,5,13,0.18238409132945999,54.635622475031134,3499
0,6,0,0,0,7,13,0.15236776011938252,54.67712315570953,3501
0,2,1,0,0,7,10,0.15851596979871613,54.897707990621974,3511
0,3,0,0,0,6,9,0.13828461666478073,55.064966423070075,3516
0,1,1,0,0,7,9,0.1449397991718765,55.20586678229887,3524
0,5,0,0,0,7,12,0.12727183023833236,55.31549995427745,3528
0,4,1,0,0,8,13,0.12187743164649137,55.46666328185421,3532
0,2,1,0,0,7,10,0.10284450762884612,55.579884428603386,3537
0,3,0,0,0,6,9,0.11880011799859887,55.667418083721294,3546
0,0,0,0,0,2,2,0.10263459235505024,55.8287849000212,3549
0,2,0,0,0,1,3,0.0786337365354878,56.006671025418335,3553
0,2,0,0,0,0,2,0.09371154318465057,56.11832166076917,3564
0,0,1,0,0,3,4,0.09730537664342383,56.1190006355753,3567
0,2,0,0,0,4,6,0.0786437584410494,56.243469776487835,3567
0,7,0,0,0,0,7,0.10199719904083766,56.2035733717428,3574
0,7,6,0,0,0,13,0.13044584868300974,55.8239746710814,3572
0,7,5,0,0,6,18,0.17902627171663124,55.5484746350298,3581
0,7,5,0,0,4,16,0.1863384425979934,55.31296136379272,3580
0,7,5,0,0,7,19,0.1903170694617795,55.31421732789173,3583
0,7,0,0,0,6,13,0.18157820115112783,55.362329442959684,3581
0,2,0,0,0,8,10,0.15302715515648066,55.57980794290342,3586
0,1,0,0,0,9,10,0.13382268264336808,55.954609213103325,3599
0,4,0,0,0,7,11,0.14368209655627484,55.97607146372816,3600
0,2,0,0,0,2,4,0.1342043611599138,56.15187646306207,3599
0,3,0,0,0,3,6,0.11756725774057286,56.06222611102616,3604
0,1,0,0,0,3,4,0.09683927518167361,56.826991108699104,3617
2,3,1,0,0,4,10,0.11061837802312623,56.89311479382622,3626
0,0,0,0,0,4,4,0.09974792241045385,56.90820299811643,3626
0,0,1,0,0,1,2,0.10742463459523983,57.121916964936034,3639
0,0,0,0,0,3,3,0.09791774030039076,57.21547798023864,3643
0,0,0,0,0,2,2,0.07961730265623808,57.40130213116505,3648
0,0,0,0,0,2,2,0.08392363474437108,57.49176118033879,3654
0,0,0,0,0,0,0,0.07487381552031434,57.49886140349578,3657
0,0,0,0,0,0,0,0.05732421306898797,57.57683169338842,3655
0,0,0,0,0,0,0,0.06407231986151489,57.63959121149328,3659
0,0,0,0,13,1,14,0.09200397511882981,57.40496221713616,3659
0,0,2,0,11,0,13,0.08951400010445144,57.13041514956485,3650
0,0,8,0,13,0,21,0.1360284496236036,56.713353112790266,3643
0,0,8,0,10,1,19,0.16235934220271955,56.46360960417358,3644
0,0,9,0,15,0,24,0.193436326908692,56.340478363112595,3640
0,0,3,0,14,0,17,0.17251848280552481,56.28783111931522,3646
0,0,9,0,11,1,21,0.17403201928384485,56.039758013563805,3631
0,0,7,0,8,0,15,0.197300199447952,55.85916041811439,3630
0,0,5,0,8,0,13,0.1984335754023404,55.7557189604029,3623
0,0,4,0,3,0,7,0.1643991635701701,55.93313531401316,3625
0,0,0,0,0,1,1,0.14742930505355487,56.18081374111761,3638
0,0,5,0,0,0,5,0.142125436213152,56.07682012394244,3645
0,0,5,0,0,0,5,0.14825556857504757,56.16069027433453,3654
0,0,6,0,0,1,7,0.1614760454921433,55.955417942871335,3655
0,0,5,0,0,1,6,0.1641741303236887,56.19786539332801,3663
0,0,8,0,0,0,8,0.15620975402430715,56.28068611215078,3669
2,0,3,2,0,0,7,0.14549303652478712,56.42941590426475,3685
0,0,5,0,0,0,5,0.1739938364574109,56.6492893174995,3704
0,0,12,1,0,0,13,0.19594031921130536,56.312497163754365,3692
0,0,10,0,0,0,10,0.19501081700279785,56.05898380707152,3684
0,0,13,0,0,0,13,0.18591221128279892,56.23349120838045,3681
0,0,12,0,0,0,12,0.159711205581813,56.493209014027244,3686
0,0,12,0,0,0,12,0.14623696960365803,57.00486242182028,3692
0,0,5,0,0,0,5,0.12455985692199241,57.37227407303777,3698
1,0,6,0,0,0,7,0.13495986772253446,57.47964889831646,3704
0,0,5,0,0,0,5,0.1376427649919638,57.51776622091286,3709
0,0,6,0,0,0,6,0.1240861532422092,57.59138724818439,3711
0,0,7,0,0,0,7,0.11710601198495768,57.55971685276703,3715
0,0,1,0,0,0,1,0.1291894508820665,57.7961393061729,3728
0,0,0,1,0,0,1,0.08460538687060182,58.25358555901698,3733
0,0,0,0,0,0,0,0.08722641657064766,58.48657337266485,3744
0,0,0,0,0,0,0,0.06277256352645955,58.6613446704166,3747
1,0,6,0,0,0,7,0.08436884432585785,58.56610737387196,3749
1,0,2,0,0,0,3,0.0695026070420637,58.863180137347186,3759
0,0,0,0,0,0,0,0.03902512520269247,59.26283093951687,3763
0,0,0,0,0,1,1,0.026215304950187892,59.46379052554696,3768
0,0,0,0,0,0,0,0.030868156407820164,59.507364500566666,3776
0,0,0,0,0,0,0,0.04498959441241317,59.632556780940114,3785
0,0,0,0,0,0,0,0.034594712026145266,59.75716763223453,3790
0,0,0,0,0,1,1,0.032233404436441154,59.8298097790336,3795
0,0,0,0,0,0,0,0.02941360337831018,59.98706523250896,3803
0,0,0,0,0,0,0,0.030233676062192856,60.002107505952836,3808
0,0,0,0,0,1,1,0.0432094157144928,60.095532059778805,3815
0,0,0,0,0,0,0,0.025247362858013243,60.22173740924588,3817
1,0,0,0,0,0,1,0.030238614591116833,60.29431162757101,3823
0,0,4,0,0,0,4,0.03552947612511149,60.325132236337716,3825
0,0,0,3,0,0,3,0.02874902458410106,60.34450782407512,3830
0,0,0,0,0,0,0,0.038280276344855826,60.37949642197612,3835
0,0,0,0,0,0,0,0.04054841396600852,60.41846887833855,3834
0,0,0,0,0,0,0,0.036768933129325006,60.36864357089727,3836
0,0,0,0,0,0,0,0.04055656300599854,60.58781640979603,3845
0,0,0,0,0,0,0,0.050207325458331946,60.595130113250356,3849
0,0,0,0,0,2,2,0.05287513654108738,60.732224235061125,3859
1,0,0,0,0,0,1,0.048778181005435135,60.78809994028133,3863
0,0,0,0,0,0,0,0.040531292665328844,60.865642386358424,3865
0,0,0,0,0,0,0,0.031497869552779376,60.99059170934841,3870
0,0,0,0,0,0,0,0.015595955945978407,61.11762073563715,3873
0,0,0,0,0,1,1,0.01712659359560492,61.17782922953214,3877
0,0,0,0,0,0,0,0.025177766892652588,61.22471294650331,3883
0,0,0,0,0,0,0,0.042875114923397566,61.22450082870303,3887
1,0,0,0,0,0,1,0.03184396754546085,61.286859398576055,3889
0,0,0,0,0,0,0,0.0393051699800645,61.35962756251452,3897
0,0,0,0,0,0,0,0.040279003017379675,61.46891867845608,3903
0,0,0,0,0,0,0,0.029984081972916344,61.55294505871916,3905
0,0,0,0,0,0,0,0.03443984497310766,61.63110717450929,3912
0,0,0,0,0,0,0,0.022314690866162005,61.71949852798337,3915
0,0,0,0,0,0,0,0.0321038330555506,61.781928856583924,3922
