throughput_KLONGTEI,throughput_KASEMRAT,throughput_NARANONG,throughput_SUNLAKAKHON,throughput_RAMA4, throughput_ATTHAKAVI_RAMA4,throughput,mean_speed,jamlength_percent,Backlog
0,0,0,0,0,0,0,8.566167694248364,0.0,11
0,0,0,0,0,0,0,9.744249673541255,0.0,29
0,0,0,0,0,0,0,9.115979635077261,0.036308106150004314,54
0,0,0,0,0,0,0,9.45625843145906,0.07464246215551719,79
0,0,2,0,0,1,3,9.484667608412451,0.11755870054471994,101
1,1,1,0,0,0,3,9.415501918052774,0.16725700949853947,128
2,3,1,0,0,0,6,9.628168001316487,0.2106902738588382,152
0,8,1,10,2,1,22,10.030367599040433,0.1616501881814185,177
2,7,3,4,0,1,17,9.793498842212408,0.20865230043994026,209
5,5,1,3,3,1,18,9.509639620746649,0.35139002399955366,235
4,4,2,5,4,1,20,9.133353778299712,0.4809693718928902,276
3,2,0,5,5,5,20,8.618992047935622,0.716721495482505,295
2,15,1,4,4,0,26,8.178442190672364,0.8923206769498618,324
18,1,2,6,2,3,32,7.777766039645497,1.143953836876145,339
7,3,0,3,8,5,26,7.0260127854834185,1.5614969934962133,363
6,6,0,0,6,4,22,6.3224069039623965,1.9659789631311602,384
5,11,7,1,8,4,36,6.3039538926429595,2.222959830880467,399
4,5,1,1,7,3,21,5.786184960870204,2.6630847025314526,426
11,5,1,1,2,8,28,5.253170048078801,3.0036810504596874,445
9,10,1,18,11,2,51,5.2197072333703325,3.02645799508352,460
9,4,3,0,5,1,22,5.367341519576045,3.2686806024799107,502
6,7,13,2,6,1,35,5.198184613642715,3.57659742323013,524
9,3,11,2,9,3,37,4.961200925914028,3.8558674060447866,537
12,8,10,2,9,4,45,4.72199069424496,4.29501279934433,562
5,6,10,13,7,8,49,4.769723646033537,4.4725142550360575,582
6,9,13,13,3,3,47,5.094880558022572,4.173069381922123,608
5,7,6,13,4,5,40,5.185801389617397,4.461410330617757,625
4,6,8,10,23,3,54,5.252122634272297,4.152712090418753,633
14,4,7,4,26,3,58,5.5739732770959804,4.03582742052057,655
14,18,8,4,22,5,71,5.6670480245237025,4.0498192689449475,676
10,8,6,2,14,6,46,5.124313999691516,4.7135183963865375,696
10,3,18,3,22,10,66,5.193556067793277,4.71229977193777,717
9,7,10,3,9,15,53,4.789746292133789,5.114403963968844,743
11,7,10,3,4,14,49,4.291696740848412,5.722610444958439,756
10,7,10,1,9,12,49,4.111439808428205,6.297695990426771,771
28,6,7,4,11,16,72,4.127102207621809,6.525481555654399,783
15,11,7,4,9,13,59,3.669972050180691,7.000533247315677,779
10,8,10,17,6,12,63,3.7027076389136737,7.136266382067893,788
5,8,10,22,1,10,56,3.74634076072164,7.552912512888321,813
3,5,0,11,10,6,35,3.486967191858482,7.76531783166638,832
7,8,2,0,3,6,26,3.3561984171433323,8.031033222081483,853
13,9,11,13,5,4,55,3.4052447432728417,8.019297043467754,871
9,7,8,11,6,5,46,3.109646660819982,8.590314446913178,892
14,1,5,6,15,1,42,2.7739208310857477,9.516226182999961,904
5,0,1,0,7,0,13,2.546890570060514,10.431212903588593,939
3,3,10,3,3,5,27,2.4786797044541626,10.499022708436575,956
2,23,10,4,0,3,42,2.632554372619841,10.014846979297019,963
1,21,10,2,2,0,36,2.6968741567755665,9.980453225605272,975
1,20,11,1,8,5,46,2.800720698936974,10.018257706751259,984
0,17,10,1,9,6,43,2.6452157747848917,10.279877694926558,994
2,12,11,17,9,8,59,2.7245811801896935,9.899760772389351,985
3,10,10,22,7,11,63,2.8950663116777635,9.782142558376266,981
1,10,12,22,3,10,58,2.7980030674656398,9.921437569877321,983
10,11,11,2,21,10,65,3.0536230767915877,9.321597368770059,997
12,14,9,6,26,9,76,3.1544565911746907,9.21240418243171,1002
18,12,11,5,21,9,76,3.201706699893426,9.467244537133558,1021
16,13,11,6,19,9,74,3.2577312816485007,9.399694663769942,1044
14,16,18,3,12,9,72,3.2470674216496542,9.345209638812172,1054
15,15,14,6,11,10,71,3.275130534365306,9.602033043561617,1071
16,21,11,8,28,10,94,3.538921191594185,9.377328615240605,1078
12,20,12,4,12,9,69,3.303226858065854,9.871190151788227,1088
13,19,9,1,9,8,59,3.1186010640059947,10.547862569968565,1122
11,17,10,2,7,12,59,2.794240385255042,11.594140085435962,1131
26,21,5,15,11,8,86,2.786533647720241,11.528026185833296,1151
17,16,2,14,10,5,64,2.875290561347928,11.732622284937706,1159
10,10,8,13,14,4,59,2.9404582530922845,11.477444960722949,1172
12,20,11,12,15,6,76,2.9856619370090915,11.428576950710116,1169
11,20,5,11,11,2,60,2.9118069311827797,11.751340249639414,1173
13,26,4,14,10,6,73,3.112300860280706,11.980407277603573,1203
6,18,10,7,9,1,51,2.8908255705088273,12.42703085407311,1230
18,9,11,4,6,3,51,2.5789676325943045,13.02307791969369,1232
8,8,13,2,6,3,40,2.417802749923101,13.337187562255682,1245
6,5,10,3,8,3,35,2.0902314487548397,14.076881623838096,1258
7,5,5,16,6,5,44,2.0844502241310936,14.031394212886186,1283
3,7,7,19,5,5,46,2.151410582691674,14.142729911080758,1295
4,4,5,17,6,4,40,2.3157400582502614,14.331387825817629,1316
8,7,5,9,12,3,44,2.23555709816726,14.611981687887216,1327
5,4,5,4,12,6,36,2.296779281081401,14.53712246105843,1329
5,3,6,3,11,2,30,1.9372735012477034,15.096559453651574,1337
1,5,10,1,7,4,28,1.841988017710207,15.640168616719748,1362
6,5,6,13,8,8,46,1.8442204898721732,15.650505129644685,1371
4,5,6,18,5,4,42,1.6938696861199647,16.014540510026915,1368
6,5,5,13,22,4,55,1.6733966554128392,15.810511581010774,1360
5,8,1,3,21,3,41,1.6885351016347592,16.375782949105968,1375
9,12,4,17,17,16,75,1.8255867588665013,15.900863337808635,1380
10,22,6,20,9,11,78,2.136585243271562,14.839053221474328,1379
8,26,11,21,29,10,105,2.5313181765998123,13.867244060736699,1364
13,12,10,20,26,6,87,2.4294126146165964,13.944510427081603,1370
14,15,7,5,8,7,56,2.2829959444988517,14.194588764963108,1381
8,15,7,2,12,10,54,2.265799928072378,13.758257933634415,1391
29,9,12,2,9,12,73,2.443368461934715,13.475369276884127,1390
33,19,11,2,6,10,81,2.342002504980637,13.320015391552289,1360
13,10,12,12,9,13,69,2.336186348054023,13.995023451186613,1361
8,12,7,15,11,12,65,2.429049584287682,14.02341594203571,1372
9,23,6,16,17,2,73,2.657451464061313,13.487816266897985,1390
15,21,7,16,16,8,83,2.655720097497096,13.801205444492092,1392
9,20,9,14,14,9,75,2.50430644842943,14.473173527925892,1420
3,17,11,14,7,18,70,2.4189007043197255,14.890035624533581,1438
18,8,12,10,15,6,69,2.0795327622466924,15.829845456954477,1443
13,10,6,3,9,20,61,1.9221673673134587,16.619260453965154,1468
14,3,5,1,9,4,36,1.8234937628882675,16.804998847026905,1487
13,1,5,3,8,10,40,1.6785532211178025,17.501349878284127,1497
5,1,5,3,9,9,32,1.5710558328932194,18.23528990808943,1515
2,4,5,4,11,10,36,1.4486777898795122,18.931413584077,1525
2,0,12,0,8,9,31,1.3522279902249126,19.739120642675555,1549
6,0,8,11,6,5,36,1.4219943395588752,19.588128437789777,1571
2,5,6,15,11,4,43,1.5573394448833746,19.439922998833534,1592
4,5,7,9,8,6,39,1.6082026560991685,19.374832194904794,1618
5,18,10,2,7,2,44,1.649770506393151,19.22322227841204,1625
3,27,9,2,5,3,49,1.5234794018524198,19.793752845641187,1627
5,23,12,2,4,9,55,1.5884417066421155,19.86710506401126,1645
3,25,14,11,14,7,74,1.5007769297728573,20.215408921154882,1643
8,6,11,8,20,6,59,1.4659802284077301,20.616994804237237,1666
6,5,15,8,18,6,58,1.3658979663686994,21.156294014008957,1678
5,8,13,6,12,11,55,1.337734003991779,21.022174125054185,1696
7,7,4,16,7,15,56,1.4013683057461062,20.926023397847413,1709
8,11,3,21,7,14,64,1.5742542125462946,20.263112460772472,1717
11,10,11,22,7,16,77,1.7014140974902403,19.817194409359825,1707
15,2,10,21,6,12,66,1.952029916789032,18.51734086191564,1713
14,2,7,21,12,2,58,1.8097477717332924,18.98380694604375,1701
11,6,1,13,14,0,45,1.6571201102689461,19.820964168773436,1717
12,9,0,14,4,0,39,1.428141674188646,20.478126850753416,1718
11,20,0,6,3,6,46,1.414404639602092,20.56653205007164,1718
12,16,4,11,10,15,68,1.6877102376359718,20.093332411853623,1732
12,6,7,9,11,11,56,1.6691366877869511,19.94730945559711,1748
8,7,12,10,8,15,60,1.8850444076874548,19.741430392713497,1765
34,6,8,12,9,7,76,1.856292777707989,20.14245650494435,1780
18,5,5,7,17,4,56,1.8115068616091687,20.685217510816376,1782
3,14,6,6,13,2,44,1.8043528407390352,20.94184017149645,1785
3,13,5,0,15,1,37,1.715254234321749,21.29983678648625,1778
1,11,6,2,19,0,39,1.5881701985420575,21.942628976796588,1781
2,10,6,2,13,2,35,1.4657354284136905,22.502816058512558,1779
0,2,7,0,12,7,28,1.326278555508105,23.069144455163695,1802
2,2,5,1,22,6,38,1.2424028317881521,23.25949744713356,1815
4,5,6,1,14,14,44,1.290072648353151,23.210022999668507,1836
6,8,9,0,19,13,55,1.3853351658766322,22.460666950291,1850
7,4,7,11,15,7,51,1.3121319744158446,23.124624960055435,1875
8,13,13,13,12,1,60,1.3102679077088637,23.484904895306894,1896
9,20,9,10,4,0,52,1.4483597136081923,23.106101347855887,1893
2,19,9,4,6,1,41,1.523999498784268,23.228279361206752,1915
11,19,3,5,18,6,62,1.6974062846913336,21.81910926682714,1927
14,2,5,3,27,6,57,1.490851066849116,23.060318613462936,1943
15,3,5,1,17,11,52,1.3887068467789059,23.272266187032482,1960
15,2,5,16,15,8,61,1.2513912130344282,23.978919967703224,1964
11,3,5,16,8,14,57,1.2964196231335587,24.109974570636876,1977
13,2,5,7,4,5,36,1.2284601109492757,25.029051319587865,2009
14,1,5,8,5,16,49,1.16139143256248,25.125418507514933,2017
15,2,5,4,8,5,39,1.095096156463984,25.882093704972647,2016
15,13,12,17,8,8,73,1.163203535169593,24.57427690471979,2004
13,19,11,20,9,1,73,1.295195230318048,24.353212271866894,1998
9,16,12,21,9,8,75,1.313421696582658,24.833273799076878,1993
11,15,11,21,4,3,65,1.226634777368475,25.50799056183786,1986
13,2,11,13,9,10,58,1.0558427059139666,25.816620769170846,1983
0,0,12,10,5,2,29,0.939399141177189,26.80203082868365,1994
38,0,5,6,0,10,59,0.9604457423178212,26.712962951860913,1978
36,1,5,3,9,4,58,0.9727716471571946,26.66673336857604,1970
19,1,5,1,0,10,36,0.8851793978675893,26.966678840683517,1982
6,2,5,2,0,2,17,0.8680117470021291,27.28033645861936,2006
7,14,5,0,0,5,31,0.8034269554451576,27.850572323527842,2013
1,9,5,0,7,1,23,0.8535450057592082,28.235345860268936,2036
2,14,5,0,4,6,31,0.827248789747134,28.504354769520212,2047
5,13,15,0,7,0,40,0.8361591166995956,28.31162203768386,2046
9,2,15,0,5,11,42,0.9194056875553602,27.82221537810024,2057
8,1,16,0,6,1,32,0.9616155537398333,27.901288529573172,2081
3,1,16,0,3,10,33,0.8769839158437289,28.62198765929117,2099
2,3,8,4,4,0,21,0.8166762475874542,28.888329441871004,2123
3,0,5,3,4,3,18,0.8394183296516257,29.286735883941567,2142
0,10,6,0,6,0,22,0.7999570914815018,29.68112056147735,2165
7,5,5,2,8,3,30,0.787234070910854,29.490321884562373,2168
7,6,5,3,11,0,32,0.8014518200474683,29.801899034557206,2172
6,7,7,4,6,5,35,0.7634342940617803,29.84559066770531,2179
8,0,7,2,21,1,39,0.8538123713642631,29.773022497665668,2195
3,0,5,4,8,5,25,0.762746981008786,30.575143044526598,2212
11,0,5,2,1,1,20,0.7765930037358129,30.9471444489278,2228
9,0,6,17,2,2,36,0.8015157549584909,30.463723279615053,2238
6,8,9,21,8,0,52,0.8876249253307659,29.427780825373212,2227
3,6,7,4,7,1,28,0.8740116510206929,29.761552575677456,2222
6,2,7,0,6,0,21,0.8170653943261567,29.761392994588718,2235
4,0,6,2,6,5,23,0.879030052587821,29.986926501772285,2257
4,0,5,0,4,0,13,0.8735321149751775,30.14616188061031,2268
4,0,6,0,0,8,18,0.8890306845707051,30.63088741601369,2282
0,0,0,0,0,0,0,0.7930826971109599,31.322484810202678,2314
9,0,2,0,0,0,11,0.7016010616660908,31.756337777672503,2323
0,6,1,0,2,0,9,0.680645261310618,32.18602253036339,2341
0,6,3,0,1,0,10,0.587158003138885,33.26808158486246,2354
0,2,0,0,0,0,2,0.4604795042539307,34.063149219271054,2365
0,0,5,0,0,2,7,0.4321137936357915,34.58631411360007,2378
0,0,5,11,10,0,26,0.45213328913467804,34.51614284231967,2377
0,0,5,6,3,3,17,0.3900154071632454,34.850411605392914,2383
0,0,0,1,0,0,1,0.3713770761879217,35.692193598950894,2394
0,0,1,1,0,0,2,0.3054834705158481,36.09250250834758,2405
0,0,7,3,0,0,10,0.32285721604205986,36.02550744751725,2417
0,0,9,0,0,0,9,0.32846932292543646,36.244631116006424,2433
0,0,5,0,0,0,5,0.3361923852012325,36.52675069022475,2456
0,0,7,0,0,0,7,0.32444243840917875,36.888309935928284,2479
0,0,7,0,0,0,7,0.3095386712127168,36.95192069010372,2493
0,0,7,0,0,0,7,0.32197336542042115,36.980507979646426,2510
0,0,3,0,0,0,3,0.27907170355104394,37.30340785269194,2518
0,0,0,0,0,0,0,0.26718799222181955,37.48634468548589,2528
0,0,12,0,0,0,12,0.29076936594276365,37.504199874419385,2542
0,0,6,0,0,0,6,0.2903152773089898,37.79424589831443,2571
0,0,5,0,0,0,5,0.2975750182885343,38.30504867794275,2594
0,0,3,0,0,0,3,0.27040269561244207,38.92987101050449,2618
0,0,5,8,0,0,13,0.23815756996523632,39.45320509172696,2626
0,0,5,0,7,0,12,0.22527652105719553,39.56079306501872,2634
0,0,2,2,0,0,4,0.20508527630728124,39.94915462248617,2648
0,0,0,1,0,0,1,0.16749841192189877,40.296465980317606,2654
0,0,5,4,0,0,9,0.17949658599239005,40.47114397778686,2664
0,0,1,2,0,0,3,0.20405357341292837,40.71784016747146,2680
0,0,0,3,0,0,3,0.19852818740101066,41.05984250261236,2701
0,0,0,2,0,0,2,0.19567004557040166,41.26048648869565,2712
0,0,1,3,0,0,4,0.1865856931543616,41.422411662008976,2720
0,0,5,2,0,0,7,0.211099766313418,41.226238721810965,2726
0,0,5,3,0,0,8,0.19878029115519874,41.194080137083375,2726
0,0,5,0,0,0,5,0.17644364588494618,41.312583409222945,2728
0,0,5,1,0,0,6,0.1798636324228887,41.4188208793938,2739
0,0,0,0,0,0,0,0.1716206340060105,41.682437721336285,2752
0,0,0,0,0,0,0,0.16557258441518713,41.72950393090651,2760
0,0,0,0,0,0,0,0.14425898237552257,41.89910569986662,2768
0,0,0,0,0,0,0,0.16325517388393243,41.79425035589228,2778
0,0,0,0,0,0,0,0.1463280239136279,41.977890838926264,2781
0,0,1,0,0,0,1,0.1706663295010506,42.09136770637207,2794
0,0,0,0,0,0,0,0.13467894805135605,42.31629884999951,2798
0,0,0,0,0,0,0,0.15284584648419733,42.62266597268887,2819
0,0,5,0,1,0,6,0.16521959416501267,42.6277142008046,2825
0,0,1,7,0,0,8,0.1427770651782025,43.01773046000272,2827
0,0,0,2,0,0,2,0.1179559218622133,43.02117769386041,2828
0,0,1,0,0,0,1,0.12264615868774638,43.11946515197409,2834
0,0,5,0,0,0,5,0.10199031927751218,43.08323729484723,2825
0,0,4,1,0,0,5,0.08817923408437524,43.204068282196104,2827
0,0,2,0,0,0,2,0.0908528354420841,43.300677388412524,2831
0,0,1,1,0,0,2,0.07957352889262927,43.35233980306133,2832
0,0,0,0,0,0,0,0.09059370674020034,43.405810941319324,2838
0,0,5,0,0,0,5,0.08116777075585502,43.317377192695965,2835
0,0,6,0,0,0,6,0.09253500860596293,43.15068557156981,2833
0,0,6,0,0,0,6,0.14530876378973723,43.14010838396726,2846
0,0,5,0,0,0,5,0.15031775987297036,43.07665335861614,2844
0,0,1,0,0,0,1,0.1354766006375951,43.15562197650991,2850
0,0,0,0,0,0,0,0.15147018211897947,43.18061118275483,2857
0,0,0,0,0,0,0,0.13663940303051625,43.29363992687883,2860
0,0,0,0,0,0,0,0.12388265417439899,43.286084632826274,2861
0,0,0,7,0,0,7,0.12731389871726181,43.26780125454946,2860
0,0,1,3,0,0,4,0.1112545984665698,43.31046447418365,2860
0,0,0,1,0,0,1,0.11363993964464394,43.41368741823701,2864
0,0,0,0,0,0,0,0.07791909295129536,43.843336282207126,2875
0,0,0,0,0,0,0,0.0707792314222021,44.339754668642115,2880
0,0,0,0,2,0,2,0.04847545160340706,44.40434799236971,2880
0,0,0,1,0,0,1,0.047488994883305595,44.48950342797999,2885
0,0,0,0,0,0,0,0.06595195680738261,44.53801133314719,2893
0,0,5,0,0,0,5,0.05358978468005729,44.498288995824495,2893
0,0,4,0,0,0,4,0.04740124752302482,44.66945666242967,2899
0,0,0,0,0,0,0,0.06862009996356555,44.74003234676966,2907
0,0,0,0,0,0,0,0.06294086347292284,44.81667019339904,2913
0,0,0,0,0,0,0,0.06552227339044933,44.9261990624909,2925
0,0,5,0,0,0,5,0.07090585699067614,44.92688751942662,2925
0,0,5,0,0,0,5,0.053481762349045704,44.957065359475465,2925
0,0,6,0,0,0,6,0.07151667386378875,44.90115741560428,2931
1,0,5,7,0,0,13,0.09613466681812022,44.73980812925174,2929
0,0,0,1,0,0,1,0.0837934142038754,44.84015590812309,2930
0,0,1,1,0,0,2,0.06706941021321929,44.93628261702092,2933
0,0,0,1,0,0,1,0.037044050714619095,45.18313740868617,2935
1,0,0,2,0,0,3,0.04030981139809922,45.27166608064658,2938
0,0,1,3,0,0,4,0.0654406649963384,45.69299564674929,2949
0,0,0,1,2,0,3,0.04751271235697878,45.71960629065294,2949
0,0,0,0,0,0,0,0.044445989686307814,45.788668329230376,2949
0,0,0,0,0,0,0,0.06796442437849787,45.81986144051379,2958
0,0,1,0,0,0,1,0.04376272103408895,45.980627739200806,2963
0,0,1,0,0,0,1,0.043014448029369656,46.05629760941517,2968
0,0,0,0,0,0,0,0.025465542949655477,46.177293181031175,2971
0,0,0,0,0,0,0,0.03971161738930446,46.17724030735165,2975
0,0,5,0,0,0,5,0.05393814221897266,46.16693065978931,2978
0,0,0,0,0,0,0,0.057626815912308574,46.26437745837258,2984
0,0,0,0,0,0,0,0.03645879078026654,46.30472356206468,2983
0,0,1,0,0,0,1,0.04080092769324519,46.336198897656274,2988
0,0,2,8,0,0,10,0.06279925344272119,46.20582595295585,2990
0,0,5,3,0,0,8,0.05737870609631895,46.239406468318684,2986
0,0,5,0,0,0,5,0.07431792792422688,46.14796194770137,2989
0,0,5,0,0,0,5,0.09599739695686114,45.7790074589394,2996
0,0,6,1,0,0,7,0.08333769772018482,45.97690163424446,3000
0,0,0,0,0,0,0,0.06068334745852987,46.13188131196871,3004
0,0,1,0,0,0,1,0.0418721940138559,46.38109386080692,3009
0,0,0,0,0,0,0,0.05452534130274805,46.41221772546497,3015
0,0,0,0,0,0,0,0.05759989705080302,46.506182539477884,3023
0,0,0,0,0,0,0,0.062288987409946275,46.60025672631448,3029
0,0,0,0,0,0,0,0.0655406990761459,46.6315267159856,3037
0,0,0,0,0,0,0,0.06373821511428973,46.75727350034358,3041
0,0,0,0,0,0,0,0.05428102771277309,46.82012331822281,3043
0,0,0,0,0,0,0,0.05280969854190517,46.868643913563794,3046
0,0,0,0,1,0,1,0.03793252339881928,46.92972641794047,3045
0,0,0,0,0,0,0,0.043417395851277955,47.01516261795892,3053
0,0,1,7,0,0,8,0.045293931349572,46.96973159493137,3048
0,0,5,0,0,0,5,0.04130343190345058,46.912451977901476,3044
0,0,3,0,0,0,3,0.03682363846718039,46.95408607309557,3046
0,0,1,0,0,0,1,0.0397758425245551,47.0166614397845,3052
0,0,1,1,0,0,2,0.04330454717939214,47.079945553450955,3055
0,0,1,0,0,0,1,0.043516305081895676,47.111101130633465,3057
0,0,5,0,0,0,5,0.047895981926440345,47.02109112027422,3058
0,0,5,0,0,0,5,0.04405254815752546,47.01394042043791,3055
0,0,4,0,0,0,4,0.04374094006194001,47.05217596803078,3057
0,0,2,0,0,0,2,0.03912651714874916,47.13542178170663,3060
0,0,0,0,0,0,0,0.04594416190183479,47.183990284486,3067
0,0,0,0,0,0,0,0.053508158093203924,47.20907065404278,3070
0,0,1,0,0,0,1,0.05380940066091054,47.263030153960415,3075
0,0,0,0,0,0,0,0.06791015070343671,47.278632226082614,3082
0,0,0,0,0,0,0,0.050896790086350056,47.40378622507947,3084
0,0,0,0,0,0,0,0.05175238203489126,47.488961353605916,3089
0,0,0,6,0,0,6,0.045282297220257756,47.548959948740375,3090
0,0,0,0,0,0,0,0.03375673810143935,47.611444057363315,3091
0,0,0,0,0,0,0,0.027150076680688782,47.673472368069405,3092
0,0,0,0,0,0,0,0.0186965533274303,47.73375184074129,3095
0,0,0,6,0,0,6,0.028645749764610273,47.70247299902852,3093
0,0,0,0,0,0,0,0.027925718757082548,47.72352408387124,3097
0,0,4,1,0,0,5,0.019948790598217633,47.728852498777734,3093
0,0,1,0,0,0,1,0.008709324536066935,47.80639280219422,3096
0,0,0,0,0,0,0,0.028950759266113756,47.83766608425983,3102
0,0,0,0,0,0,0,0.020541184804008336,47.88510837527624,3104
0,0,0,0,0,0,0,0.02778636172009009,47.90023261227774,3108
0,0,1,0,0,0,1,0.027137022235460134,47.96292699300049,3109
0,0,0,0,0,0,0,0.018026548443289783,48.03036816334102,3113
0,0,1,0,0,0,1,0.03599026417109291,48.061664708829916,3119
0,0,0,0,0,0,0,0.029447886039491444,48.13466444563753,3122
0,0,0,0,0,0,0,0.03361913013324479,48.18859604191022,3129
0,0,0,1,0,0,1,0.025202413898847243,48.26711394584011,3131
0,0,0,0,0,0,0,0.038038238301500854,48.29844383966409,3136
0,0,0,1,0,0,1,0.026836301832547586,48.35428938762306,3137
0,0,0,0,0,0,0,0.030698660882575824,48.40123034407292,3140
0,0,0,1,0,0,1,0.03706375056078178,48.39422226285211,3143
0,0,0,0,0,0,0,0.028416095696069392,48.480958665241545,3146
0,0,0,0,0,0,0,0.03560099049200385,48.513223244808266,3149
0,0,1,0,0,0,1,0.0377716077211628,48.5601762724608,3154
0,0,0,0,0,0,0,0.044504086242126144,48.60706303030543,3159
0,0,0,0,0,0,0,0.03297286455198275,48.697810237854874,3160
0,0,0,0,0,0,0,0.022386357780412845,48.76198627968585,3163
0,0,5,0,0,0,5,0.030312754167006496,48.70504822804401,3162
0,0,3,0,0,0,3,0.020044004818235376,48.751985784534,3160
0,0,0,0,0,0,0,0.030258516846079348,48.75198328541871,3164
0,0,2,0,0,0,2,0.028844153736847677,48.81282693616272,3168
0,0,0,0,0,0,0,0.04185974077213588,48.875558202840885,3175
0,0,0,1,0,0,1,0.04666192652358259,48.89976525857969,3177
0,0,0,1,0,0,1,0.03962817231411278,48.978139403125006,3181
0,0,0,0,0,0,0,0.040390842059513196,49.01975575841627,3185
0,0,0,1,0,0,1,0.0196655747841382,49.10533576355434,3184
0,0,0,3,0,0,3,0.0208908009302862,49.122847995633194,3185
0,0,0,0,0,0,0,0.01770635035862634,49.16991306044528,3187
0,0,0,0,0,0,0,0.026718910526353196,49.20133479649856,3191
0,0,0,0,0,0,0,0.020588540828723488,49.232496159260116,3193
0,0,0,0,0,0,0,0.0265697980814749,49.27938100479838,3196
0,0,1,0,0,0,1,0.03162554207441826,49.31082956791422,3200
0,0,0,0,0,0,0,0.029252316666299214,49.38915929983278,3204
0,0,0,0,0,0,0,0.03283697539374923,49.435953321451684,3207
0,0,0,0,0,0,0,0.029448510236232774,49.46726040892846,3210
0,0,0,0,0,0,0,0.02009126579613015,49.575166904505686,3217
0,0,0,0,0,0,0,0.01510899005207691,49.63771043542181,3216
0,0,0,0,0,0,0,0.01717209192966064,49.66026206314305,3222
0,0,0,1,0,0,1,0.0240747926545,49.7003094602156,3226
0,0,0,0,0,0,0,0.011756422163447864,49.79596101732102,3227
0,0,0,0,0,0,0,0.013782327188361683,49.82712954712575,3230
0,0,0,0,0,0,0,0.014553378247552564,49.87428597797427,3233
0,0,0,4,0,0,4,0.011427554057121815,49.900301153642296,3232
0,0,0,0,0,0,0,0.02023851236983294,49.91603483016163,3235
0,0,0,0,0,0,0,0.013725766045271998,49.96302312379015,3238
0,0,0,1,0,0,1,0.011340197429935613,49.994307902061166,3239
0,0,1,0,0,0,1,0.02746391503725441,50.00464215531426,3246
0,0,5,0,0,0,5,0.032740332817247655,49.97876272654622,3247
0,0,3,0,0,0,3,0.02661261988064114,50.01002216310272,3245
0,0,1,0,0,0,1,0.02683706215551206,50.057026839326376,3248
0,0,0,0,0,0,0,0.02261766670915043,50.07274927439443,3252
0,0,0,0,0,0,0,0.03272839150552301,50.11967120751712,3255
0,0,0,0,0,0,0,0.024115774573739174,50.171622043257734,3258
0,0,0,0,0,0,0,0.024899596077256433,50.19994126423707,3261
0,0,0,3,0,0,3,0.008565278839048876,50.312594985368406,3261
0,0,0,0,0,0,0,0.009232881343833602,50.33451858448492,3263
0,0,0,0,0,0,0,0.018392226480254424,50.33451858448492,3266
0,0,0,0,0,0,0,0.02268341866534976,50.37280537427999,3271
0,0,0,1,0,0,1,0.03051007689827516,50.404081806067126,3275
0,0,2,0,0,0,2,0.020461765357439755,50.466667022962255,3276
0,0,0,0,0,0,0,0.032351554036791484,50.49799358175474,3285
0,0,0,0,0,0,0,0.050023525179789544,50.54518006654414,3290
0,0,0,0,0,0,0,0.0302278333518515,50.655154385443375,3293
0,0,0,0,0,0,0,0.01352610449480929,50.753326130360755,3294
0,0,0,0,0,0,0,0.016671854673712863,50.769007793183484,3295
0,0,0,0,0,0,0,0.013201996604270055,50.80030758579857,3298
1,0,0,0,0,0,1,0.01761950446893142,50.81466334511449,3299
1,0,0,0,0,0,1,0.012380263117904232,50.845495939488345,3300
0,0,0,0,0,0,0,0.011009118159660908,50.87674308323043,3302
0,0,0,0,0,0,0,0.009046670780350074,50.89238146246129,3303
0,0,0,2,0,0,2,0.01638982684555961,50.92560867545989,3307
0,0,0,0,0,0,0,0.02339969135813318,50.92560867545989,3309
0,0,1,0,0,0,1,0.025445509570810192,50.98824994447622,3312
0,0,0,0,0,0,0,0.020790524572602935,51.01969727835311,3313
0,0,0,2,0,0,2,0.020477026162690846,51.055067967928764,3314
0,0,0,0,0,0,0,0.02976320888770023,51.07069465228629,3318
0,0,0,0,0,0,0,0.00876471881567042,51.14918957102313,3318
0,0,5,0,0,0,5,0.008676663637363911,51.07926131650639,3315
0,0,5,0,0,0,5,0.008177055417991082,51.07926131650639,3312
0,0,2,0,0,0,2,0.006987639950614849,51.11058172626769,3312
0,0,1,0,0,0,1,0.0080727024092511,51.1262237475145,3314
0,0,0,0,0,0,0,0.017162041612646697,51.1262237475145,3317
0,0,0,0,0,0,0,0.022396937746544738,51.15750939708496,3320
0,0,0,0,0,0,0,0.026605648518481396,51.17314763627957,3324
0,0,0,0,0,0,0,0.027699775180358665,51.22710623138609,3327
0,0,1,0,0,0,1,0.023960913125017885,51.28099036225865,3330
0,0,0,2,0,0,2,0.02544917875333758,51.289838924239575,3330
0,0,0,0,0,0,0,0.027233726387727333,51.332171436940264,3333
0,0,0,0,0,0,0,0.027605777181503435,51.34759663875422,3339
0,0,1,0,0,0,1,0.033818556498191946,51.394607726205194,3344
0,0,0,1,0,0,1,0.029001927868565466,51.475059220604216,3345
0,0,0,4,0,0,4,0.033780352486311,51.4848404015755,3345
0,0,1,0,0,0,1,0.02695803527271155,51.52664139306374,3346
0,0,0,1,0,0,1,0.03258967192902288,51.56452279979507,3348
0,0,0,0,0,0,0,0.024258619551808514,51.59572553454124,3347
0,0,0,0,0,0,0,0.023899212216485485,51.606678511322315,3348
0,0,0,0,0,0,0,0.019932220696151196,51.644850068268624,3354
1,0,0,0,0,0,1,0.011827120757432398,51.78857869920476,3357
0,0,1,0,0,0,1,0.010550059008845857,51.8199428987182,3358
0,0,1,0,0,0,1,0.020934783865376578,51.80471407002389,3362
0,0,0,0,0,0,0,0.021763154665475133,51.825611775664946,3363
0,0,0,0,0,0,0,0.02433441509697899,51.8835159635496,3365
0,0,0,0,0,0,0,0.024687199290043607,51.88326739864137,3367
0,0,0,2,0,0,2,0.02275978279736809,51.90080684136455,3367
0,0,1,1,0,0,2,0.02778787800025962,51.92336945734934,3369
0,0,0,0,0,0,0,0.020918584276967536,51.98064156005727,3370
0,0,0,1,0,0,1,0.017523313925849333,51.954668737728284,3369
0,0,5,0,0,0,5,0.024445161470076145,51.876830163441525,3367
0,0,6,0,0,0,6,0.02065249914219169,51.845512038457024,3363
1,0,1,0,0,0,2,0.026677610420042058,51.85773347897003,3366
0,0,2,0,0,0,2,0.03469729554421739,51.884046298050976,3369
0,0,1,0,0,0,1,0.02291339382167098,51.933087053214685,3367
0,0,0,0,0,0,0,0.02280050320194055,51.946572061801,3370
0,0,0,0,0,0,0,0.031034216405800643,51.9678275020816,3374
0,0,0,0,0,0,0,0.02930513634582596,52.0251787900636,3376
0,0,1,0,0,0,1,0.024105315143037348,52.068487020902445,3379
0,0,0,0,0,0,0,0.027614272429390553,52.11383287145078,3382
1,0,0,0,0,0,1,0.022382162791120947,52.16563922372913,3385
0,0,0,0,0,0,0,0.020619073285761895,52.163244347054466,3385
0,0,0,4,0,0,4,0.017330101366065404,52.17245266062415,3382
0,0,0,0,0,0,0,0.014546522910187997,52.17855641444329,3385
0,0,0,0,0,0,0,0.0200618861348305,52.222434733725606,3388
0,0,0,1,0,0,1,0.022713387301613503,52.25813630631364,3391
0,0,0,2,0,0,2,0.014702046929105976,52.33545624474084,3391
0,0,0,0,0,0,0,0.033903356946814,52.31313805186998,3397
0,0,1,0,0,0,1,0.027036656250475914,52.372247531462165,3397
0,0,0,0,0,0,0,0.03141334081100122,52.35546477286034,3401
0,0,0,0,0,0,0,0.027647075140959435,52.449297943954086,3403
0,0,0,0,0,0,0,0.03161518594657586,52.45759168502367,3406
0,0,0,0,0,0,0,0.016629251908959294,52.55968775460961,3409
0,0,0,0,0,0,0,0.02197958812730522,52.59214034413219,3411
0,0,0,0,0,0,0,0.017117162652657853,52.5912371054586,3413
0,0,0,0,0,0,0,0.02366490620404334,52.66182336901892,3415
0,0,0,0,0,0,0,0.022984346992138662,52.67884720504154,3420
0,0,0,0,0,0,0,0.016745627379159495,52.77754477220699,3424
0,0,0,1,0,0,1,0.02647722278712681,52.729000785434124,3427
0,0,0,0,0,0,0,0.008447583172989496,52.911668081428935,3427
0,0,5,0,0,0,5,0.041300471029296786,52.72482001748506,3430
0,0,5,0,0,0,5,0.018692652955130867,52.798972920672774,3423
0,0,0,4,0,0,4,0.022391347789019,52.75911321732014,3421
0,0,0,0,0,0,0,0.009529190795443235,52.84790226493295,3422
0,0,0,0,0,0,0,0.01687957252071829,52.83300457464917,3425
0,0,0,0,0,0,0,0.02288477220410138,52.86588986320831,3430
0,0,0,0,0,0,0,0.02105014917799914,52.90754007461273,3431
1,0,0,0,0,0,1,0.023409311963318833,52.923329659900375,3432
0,0,0,0,0,0,0,0.02600091555742806,52.970762996183645,3438
0,0,0,0,0,0,0,0.030450769280074834,52.94436276547863,3439
1,0,0,0,0,0,1,0.013571670833906401,53.08082382900352,3441
1,0,0,0,0,0,1,0.020655175059165896,53.115172146592,3445
0,0,0,0,0,0,0,0.019090086809972075,53.122652842550956,3449
0,0,0,0,0,0,0,0.014050518721563612,53.22808463281501,3449
0,0,0,0,0,0,0,0.012300145916414916,53.21126398133326,3449
0,0,0,0,0,0,0,0.006753231461302383,53.24251346663712,3449
1,0,0,0,0,0,1,0.007989426615079747,53.25851406691796,3453
0,0,0,0,0,0,0,0.009924363414620668,53.352937786754985,3459
0,0,0,1,0,0,1,0.006259530439821292,53.39923929096656,3459
0,0,0,0,0,0,0,0.011426090076729211,53.400089023297795,3461
1,0,0,0,0,0,1,0.024576354087687494,53.41488545032435,3467
0,0,1,1,0,0,2,0.02476900882507802,53.446323291841345,3470
0,0,0,0,0,0,0,0.025924057682445763,53.52447732792795,3475
0,0,0,0,0,0,0,0.025130273183396896,53.57132656570783,3477
0,0,0,0,0,0,0,0.02666658365171784,53.588943771217636,3479
0,0,0,0,0,0,0,0.024904636191932235,53.64950340917998,3482
1,0,0,0,0,0,1,0.01916337056998099,53.718989125620084,3485
0,0,0,0,0,0,0,0.017713936281902497,53.765904006028045,3487
0,0,0,0,0,0,0,0.01530842028060142,53.80526328272533,3489
0,0,0,0,0,0,0,0.02402364189156593,53.828584206351806,3493
0,0,5,1,0,0,6,0.029270493002402302,53.75714423031997,3492
0,0,5,0,0,0,5,0.022473310654396297,53.7724193264798,3489
0,0,1,0,0,0,1,0.02802575212587589,53.788057552760776,3491
0,0,1,0,0,0,1,0.02068394304716132,53.788057552760776,3489
0,0,1,0,0,0,1,0.026251982860907755,53.83438548963845,3494
0,0,0,0,0,0,0,0.01492495691934311,53.89535784503323,3496
0,0,0,0,0,0,0,0.016719603397836073,53.92664773738865,3497
0,0,1,0,0,0,1,0.017206653253454156,53.926647509025294,3497
0,0,0,0,0,0,0,0.017105490185446916,53.95792719312475,3499
0,0,0,0,0,0,0,0.016325136192683797,53.96481644629073,3500
0,0,0,0,0,0,0,0.01230586894685088,53.964816111552786,3500
0,0,0,0,0,0,0,0.01004570501964274,53.99635764894175,3501
0,0,0,0,0,0,0,0.015139039815450032,54.01173085004724,3503
0,0,0,0,0,0,0,0.02286606133016736,54.01173085004724,3506
1,0,0,0,0,0,1,0.018744105533202486,54.0587619555065,3509
0,0,0,0,0,0,0,0.017904309630189942,54.14382547335819,3515
0,0,0,2,0,0,2,0.01623143733558007,54.15966181072991,3513
0,0,1,0,0,0,1,0.02205558625835904,54.17535602920373,3516
0,0,1,0,0,0,1,0.015280525586313938,54.1981416068387,3516
0,0,0,0,0,0,0,0.025014593050284684,54.213638459487015,3520
0,0,0,4,0,0,4,0.028760876832277547,54.192694171365034,3518
0,0,2,0,0,0,2,0.02013140136451043,54.2239970054781,3517
0,0,0,0,0,0,0,0.013810245591050523,54.27812559560145,3519
0,0,0,0,0,0,0,0.026837277718826238,54.26216905484502,3523
0,0,0,0,0,0,0,0.021273672772948643,54.30927616714416,3525
0,0,0,0,0,0,0,0.016439127949197954,54.33183285389705,3525
0,0,0,0,0,0,0,0.021173985459078008,54.363090698389094,3529
0,0,1,0,0,0,1,0.024801517646373703,54.3787392848416,3532
0,0,1,0,0,0,1,0.013923105354425392,54.45665756926599,3532
0,0,0,0,0,0,0,0.018690153570272604,54.46360226512249,3535
0,0,5,0,0,0,5,0.026996278827980925,54.32816162709908,3533
0,0,5,0,0,0,5,0.021276488380749237,54.35947580282519,3529
0,0,0,5,0,0,5,0.027321081469746978,54.298777117082835,3525
0,0,0,0,0,0,0,0.029132061380554186,54.33006451442747,3530
0,0,0,1,0,0,1,0.027013941456024055,54.37705003849943,3531
0,0,0,0,0,0,0,0.02845571956859163,54.40302165052496,3533
0,0,1,2,0,0,3,0.02221323867071041,54.420335287604324,3531
0,0,0,0,0,0,0,0.02268008981419013,54.420335287604324,3531
0,0,0,0,0,0,0,0.024298647987711485,54.43597741478168,3533
0,0,0,0,0,0,0,0.006682605361342171,54.52981537958112,3533
0,0,0,0,0,0,0,0.01151076052868151,54.51417675786143,3534
0,0,0,0,0,0,0,0.011991774753486959,54.52981519591574,3535
0,0,0,0,0,0,0,0.010384912305325681,54.536707338102964,3536
0,0,0,0,0,0,0,0.016592579993990806,54.559325449257194,3540
0,0,0,0,0,0,0,0.013329084150941028,54.590644674489916,3541
0,0,0,0,0,0,0,0.006112203933947907,54.63757555053906,3541
0,0,0,0,0,0,0,0.0031664327722336623,54.65154709661304,3542
0,0,0,0,0,0,0,0.003237604615233843,54.65153852230248,3542
0,0,0,1,0,0,1,0.0,54.644646609620935,3540
0,0,0,0,0,0,0,0.0,54.644646609620935,3540
0,0,0,0,0,0,0,0.0,54.644646609620935,3540
0,0,0,0,0,0,0,0.0,54.644646609620935,3540
0,0,0,3,0,0,3,0.0033777259775485046,54.630683637857516,3539
0,0,0,0,0,0,0,0.0034856489528625636,54.64641389996874,3540
0,0,0,0,0,0,0,0.006956323451527984,54.64641389996874,3541
0,0,0,0,0,0,0,0.006759923898788744,54.66206995958528,3542
0,0,0,0,0,0,0,0.007712483408326636,54.66206995958528,3543
0,0,0,0,0,0,0,0.010446499937420186,54.69335369476922,3545
0,0,0,0,0,0,0,0.020299948217076046,54.69335369476922,3549
0,0,0,0,0,0,0,0.024794594634562114,54.73575782629593,3554
0,0,5,0,0,0,5,0.025846617031297075,54.647300795739575,3549
0,0,2,0,0,0,2,0.00923468843360561,54.70126145019346,3548
0,0,0,0,0,0,0,0.02428743839117645,54.732565411471,3554
0,0,0,0,0,0,0,0.018351359236818913,54.779544788354755,3555
0,0,0,0,0,0,0,0.01501230386288419,54.80214473853295,3556
0,0,0,0,0,0,0,0.01976079727800358,54.81778598666963,3558
0,0,0,0,0,0,0,0.015862738667460657,54.84914958962002,3560
0,0,1,0,0,0,1,0.009367841845862599,54.88034016689078,3559
0,0,0,5,0,0,5,0.012409329962962203,54.87505470371885,3559
0,0,0,0,0,0,0,0.016007859338101393,54.89072010024023,3560
0,0,0,0,0,0,0,0.016227271640411746,54.90635913123586,3561
0,0,0,1,0,0,1,0.013124978249409799,54.90635913123586,3561
0,0,1,0,0,0,1,0.012371859654553143,54.92919307347379,3563
0,0,0,0,0,0,0,0.013071634903855607,54.95151495866076,3564
0,0,1,0,0,0,1,0.010186447075867397,54.95150930091894,3564
0,0,0,0,0,0,0,0.004649548572515836,54.998425982519,3565
0,0,0,0,0,0,0,0.019957340897852078,54.99842434184512,3569
0,0,0,0,0,0,0,0.023237050999825357,55.01455409334013,3571
0,0,0,0,0,0,0,0.016029294839695504,55.00540572688229,3571
0,0,0,0,0,0,0,0.011752885479137545,55.07489970015819,3573
0,0,0,3,0,0,3,0.015845364227428563,55.061115694238495,3573
0,0,2,0,0,0,2,0.016987091420906236,55.076754223598684,3573
0,0,1,0,0,0,1,0.023520858760499818,55.07675391148775,3575
0,0,1,0,0,0,1,0.022278896351135526,55.08960742830553,3576
0,0,0,2,0,0,2,0.02159244910578905,55.11301534045027,3578
0,0,0,0,0,0,0,0.020732728535668453,55.132480306719984,3581
0,0,0,0,0,0,0,0.018963441773225252,55.18631803863991,3583
1,0,0,2,0,0,3,0.01784770648568168,55.19346702815359,3583
0,0,1,0,0,0,1,0.023036599944002742,55.22474359640775,3586
0,0,0,0,0,0,0,0.017233413919231572,55.22476652284919,3587
0,0,0,0,0,0,0,0.012568743925165524,55.27326962259703,3588
0,0,0,0,0,0,0,0.013262817862568149,55.311565962633516,3590
0,0,0,0,0,0,0,0.016520312441108843,55.311554775658564,3592
0,0,1,0,0,0,1,0.014890290345735897,55.35145289266083,3594
0,0,0,0,0,0,0,0.012009511782198303,55.35149622417266,3594
0,0,0,0,0,0,0,0.009476853726634704,55.36713454933534,3594
1,0,0,5,0,0,6,0.018466642052423925,55.36885846376011,3595
0,0,0,0,0,0,0,0.02334522192142353,55.385593259147896,3596
0,0,1,1,0,0,2,0.016970420470633865,55.400159731925186,3595
1,0,0,0,0,0,1,0.023823258791319295,55.438890238109444,3601
0,0,1,1,0,0,2,0.010072826065956029,55.47940578431556,3599
0,0,0,0,0,0,0,0.012457594721946833,55.494567231509095,3602
0,0,0,0,0,0,0,0.018835286939274463,55.51020548268379,3603
0,0,0,0,0,0,0,0.0076271234247398964,55.57015989946052,3604
0,0,0,0,0,0,0,0.0066335661776070216,55.5544023396257,3604
0,0,0,0,0,0,0,0.0066662731389134046,55.587267093876086,3605
0,0,0,0,0,0,0,0.0033161501461156217,55.602905333678635,3605
0,0,0,0,0,0,0,0.0033212406133037806,55.609888376481145,3606
0,0,0,0,0,0,0,0.01364811762708094,55.625537688240016,3610
0,0,0,0,0,0,0,0.010046093215545442,55.641203672059234,3611
0,0,0,0,0,0,0,0.0033978818865018725,55.69518035470063,3612
0,0,0,0,0,0,0,0.0036390675918731986,55.710827673740695,3614
0,0,0,2,0,0,2,0.0065341879471949305,55.68828844589115,3612
0,0,0,0,0,0,0,0.0036027510813763284,55.68828844589115,3612
0,0,0,0,0,0,0,0.005026217729782229,55.70393099304933,3613
0,0,0,0,0,0,0,0.006627109290812917,55.70393099304933,3614
0,0,0,2,0,0,2,0.008907577491878732,55.70560660657714,3614
0,0,0,1,0,0,1,0.009756581529751007,55.68996816430508,3613
0,0,0,1,0,0,1,0.008893221561070258,55.72124583192243,3614
0,0,0,0,0,0,0,0.006233626353433275,55.75256080009033,3615
0,0,0,0,0,0,0,0.008589123650854898,55.752521356077565,3617
0,0,0,0,0,0,0,0.004736290120305757,55.79448261851582,3618
0,0,1,0,0,0,1,0.0067887695705324555,55.79420693965583,3618
0,0,0,0,0,0,0,0.005416305988747763,55.79420693965583,3619
0,0,0,0,0,0,0,0.013486386745330028,55.80985841482602,3622
0,0,0,0,0,0,0,0.022522550293285096,55.82549668692321,3625
0,0,1,0,0,0,1,0.024235341246821886,55.80985841482602,3625
0,0,0,0,0,0,0,0.027777951903073084,55.8324971718832,3629
0,0,0,0,0,0,0,0.01912058407745277,55.86388042931222,3629
0,0,0,1,0,0,1,0.01164402513638362,55.934071566897835,3630
0,0,0,1,0,0,1,0.007411894474427782,55.949441668612344,3630
0,0,0,0,0,0,0,0.0075660669829600465,55.94896890769972,3631
0,0,0,3,0,0,3,0.006807256859460114,55.98207984904285,3630
0,0,1,1,0,0,2,0.0059730765600348405,55.98192056609641,3632
0,0,0,0,0,0,0,0.021576900899034787,55.99755879417076,3636
0,0,1,1,0,0,2,0.020400172308411745,56.02890174568805,3638
0,0,0,0,0,0,0,0.01809062756613096,56.060278460851464,3639
0,0,0,0,0,0,0,0.038406994672142133,56.060187776111235,3645
0,0,2,0,0,0,2,0.023224088336559326,56.09845235749075,3645
0,0,0,0,0,0,0,0.012639826532624378,56.18364739674945,3646
0,0,0,0,0,0,0,0.009905722524482411,56.18180468372723,3646
0,0,0,0,0,0,0,0.009700818537565813,56.16615611172359,3648
0,0,0,0,0,0,0,0.0109801722629026,56.1974568283667,3648
1,0,0,0,0,0,1,0.010008674365902519,56.22024859127642,3650
0,0,0,4,0,0,4,0.00971922207352508,56.19932442960034,3647
0,0,0,0,0,0,0,0.0033519643846852774,56.25333293526021,3648
0,0,0,0,0,0,0,0.00393492299228142,56.25324411474203,3649
0,0,0,0,0,0,0,0.006687099116580076,56.2688845908941,3650
0,0,0,4,0,0,4,0.005303520797225933,56.247941205678636,3648
0,0,0,0,0,0,0,0.013095176751620599,56.26364196827556,3651
1,0,0,0,0,0,1,0.00868996756018131,56.31061510449727,3652
0,0,0,0,0,0,0,0.00621432177982358,56.341849718659326,3655
0,0,0,0,0,0,0,0.012839217271703868,56.364671669471704,3657
0,0,1,0,0,0,1,0.008988066285122375,56.3871093278078,3658
0,0,0,0,0,0,0,0.00899800121360051,56.3871093278078,3658
0,0,0,0,0,0,0,0.009482617960046912,56.37147105794545,3659
0,0,0,0,0,0,0,0.0006308075313970939,56.42106225639774,3659
0,0,0,0,0,0,0,0.009519685266096306,56.42112327632725,3661
0,0,0,0,0,0,0,0.007328080715826812,56.452484076928066,3663
0,0,0,0,0,0,0,0.006985597764642721,56.45239983537086,3666
0,0,0,1,0,0,1,0.013285740942730322,56.483702253536315,3666
0,0,1,0,0,0,1,0.0061556605166924,56.52062476910057,3667
0,0,0,0,0,0,0,0.003959492392174543,56.52062476910057,3667
0,0,0,0,0,0,0,0.0052152085783953635,56.53626310856333,3668
1,0,0,5,0,0,6,0.008833752235173287,56.51531889910381,3667
0,0,1,0,0,0,1,0.0064210032354562845,56.56077485703869,3668
0,0,0,0,0,0,0,0.006540943047501737,56.56077339958498,3668
0,0,0,0,0,0,0,0.0030887440919359146,56.56766546799946,3668
0,0,0,0,0,0,0,0.006627897722529829,56.56766546799946,3669
0,0,0,0,0,0,0,0.004714805910392713,56.59123539397527,3671
0,0,0,0,0,0,0,0.007466838590742692,56.59812730706633,3673
0,0,0,0,0,0,0,0.008412045375239322,56.63213619487163,3677
0,0,0,0,0,0,0,0.017966554716952503,56.660703162644,3681
0,0,0,0,0,0,0,0.016513398221687736,56.691979793104174,3683
0,0,0,0,0,0,0,0.007678446313408502,56.7528740768906,3684
0,0,0,0,0,0,0,0.006432938073693188,56.768513584735494,3685
0,0,1,2,0,0,3,0.006173589851218788,56.786049150293465,3685
0,0,0,0,0,0,0,0.010845445994035178,56.80169567009099,3687
0,0,0,0,0,0,0,0.014765549118656395,56.80169567009099,3688
1,0,0,0,0,0,1,0.020349665408292555,56.793039659657495,3691
0,0,0,6,0,0,6,0.009728732082945363,56.8209041046537,3687
0,0,0,0,0,0,0,0.0066032221893141925,56.859112323688095,3689
0,0,0,0,0,0,0,0.0,56.890401593700915,3689
0,0,0,0,0,0,0,0.003155585732487684,56.890401593700915,3690
0,0,0,0,0,0,0,0.007956339655900228,56.890401593700915,3692
0,0,0,0,0,0,0,0.013176017475546892,56.890401593700915,3694
0,0,1,0,0,0,1,0.011317871822718827,56.890401593700915,3694
0,0,0,0,0,0,0,0.014948229928604412,56.94430205230794,3699
0,0,0,0,0,0,0,0.005283026323370027,56.966921699367205,3698
0,0,0,0,0,0,0,0.006248077591314811,57.0051797919926,3700
0,0,0,0,0,0,0,0.012587517558908308,56.9895413908761,3701
0,0,0,0,0,0,0,0.014729408549621847,56.9895413908761,3702
0,0,0,1,0,0,1,0.006122274794354526,57.013949529601604,3701
0,0,0,1,0,0,1,0.003739608434543902,57.02958764969672,3701
0,0,0,0,0,0,0,0.0,57.06089698047488,3701
0,0,0,0,0,0,0,0.007080158794851039,57.04531321376851,3704
0,0,0,5,0,0,5,0.003445919005263355,57.071289213002444,3702
0,0,0,0,0,0,0,0.0033166795706996307,57.0869276799198,3702
0,0,0,0,0,0,0,0.010886547457010098,57.08692756046975,3706
0,0,0,1,0,0,1,0.00245048208394365,57.13390349582187,3705
0,0,0,0,0,0,0,0.0,57.1495367948644,3705
0,0,0,0,0,0,0,0.002930623050834375,57.165189236046224,3707
0,0,0,0,0,0,0,0.006945595486815064,57.165189236046224,3710
0,0,0,0,0,0,0,0.009625158178465435,57.179212197967644,3711
0,0,0,0,0,0,0,0.0065603847738957295,57.179152239179444,3711
0,0,0,0,0,0,0,0.005529750384623782,57.19479024863753,3711
0,0,0,0,0,0,0,8.554368215313963e-05,57.21042865972903,3711
0,0,0,0,0,0,0,0.005444894212295837,57.22606689662302,3713
0,0,0,0,0,0,0,0.003069985270731242,57.25775952135283,3714
0,0,0,0,0,0,0,0.0033618343450315807,57.27301213943698,3715
0,0,0,0,0,0,0,0.001697106581368103,57.31994521663695,3719
0,0,0,0,0,0,0,0.003370902255919845,57.31994521663695,3719
0,0,0,4,0,0,4,0.000880318686208148,57.3059824399714,3716
0,0,0,0,0,0,0,0.004328274600135645,57.3059904646745,3717
0,0,0,0,0,0,0,0.0031414132068162126,57.33726702103683,3718
1,0,0,0,0,0,1,0.005319776925313416,57.35291111062515,3720
0,0,0,0,0,0,0,0.005489529864363859,57.38493749887299,3724
0,0,0,0,0,0,0,0.003354058310946705,57.43818724872618,3725
0,0,0,0,0,0,0,0.00427745901621466,57.43809261969177,3726
0,0,0,0,0,0,0,0.003969762282267061,57.44507414235653,3727
0,0,0,0,0,0,0,0.0014456570589105554,57.4453018214765,3727
0,0,0,0,0,0,0,0.008350702503912304,57.47635068502781,3730
0,0,0,0,0,0,0,0.012684462133670716,57.47635068502781,3731
0,0,0,0,0,0,0,0.00940531381401896,57.483332111146595,3731
0,0,0,0,0,0,0,0.004383810379946548,57.483332111146595,3731
0,0,0,0,0,0,0,0.00038180601136292254,57.53025451125982,3732
0,0,0,0,0,0,0,0.005555091088819819,57.53024683844515,3733
0,0,0,0,0,0,0,0.0006001997881440871,57.514612649369276,3732
0,0,0,5,0,0,5,0.0048828257131376404,57.52494085488985,3732
1,0,0,0,0,0,1,0.009694858082695027,57.52494756656363,3735
0,0,0,0,0,0,0,0.015195109454191204,57.57185548586824,3737
0,0,1,0,0,0,1,0.019247889439350595,57.57185548586824,3738
0,0,1,0,0,0,1,0.014233343675660237,57.587504280742486,3738
0,0,0,0,0,0,0,0.006367973874678809,57.64140022180093,3739
0,0,0,0,0,0,0,0.008877309430524727,57.64141627586367,3741
0,0,0,0,0,0,0,0.01267536045970202,57.633665500508044,3742
0,0,0,0,0,0,0,0.003577887299143257,57.67964830140458,3742
0,0,0,0,0,0,0,0.005558473569084268,57.67964830140458,3743
0,0,0,0,0,0,0,0.007144622866962041,57.68654039431709,3744
0,0,0,0,0,0,0,0.006099296570836363,57.717817006475215,3745
0,0,0,2,0,0,2,1.1188639021037249e-05,57.69528666494386,3742
0,0,0,0,0,0,0,0.0030846586563026534,57.71092487952477,3743
0,0,0,0,0,0,0,0.0030413762870439504,57.71092487952477,3743
0,0,0,0,0,0,0,0.002977789133240255,57.71092487952477,3743
0,0,0,3,0,0,3,5.3074391184225184e-08,57.712600555898355,3741
0,0,0,0,0,0,0,0.0029977959162470515,57.71260010176727,3742
0,0,0,0,0,0,0,0.002184544899332955,57.728238425689895,3743
0,0,0,1,0,0,1,0.004090609135229548,57.71260020210173,3743
0,0,0,0,0,0,0,0.0059744606155294755,57.74387683622708,3745
0,0,0,0,0,0,0,0.003190829397456369,57.77515381346999,3746
0,0,0,0,0,0,0,0.004068670609656721,57.77515340622182,3747
0,0,0,0,0,0,0,2.442609978430534e-06,57.79778465746359,3747
0,0,0,0,0,0,0,0.007948389461299934,57.79777303801301,3751
0,0,0,0,0,0,0,0.012239699043972619,57.79777303801301,3751
0,0,2,0,0,0,2,0.013003130070968288,57.80475448812794,3753
0,0,1,0,0,0,1,0.012449501933084004,57.81173589003222,3753
0,0,1,0,0,0,1,0.009312993188925794,57.81173589003222,3752
0,0,0,0,0,0,0,0.016427930354380553,57.81173589003222,3755
0,0,0,1,0,0,1,0.01312944333938079,57.81173589003222,3754
0,0,1,1,0,0,2,0.012666818685966126,57.81173589003222,3753
0,0,0,5,0,0,5,0.014076201958483928,57.806429930018915,3752
0,0,0,1,0,0,1,0.009692029840630828,57.82896047874837,3752
0,0,1,0,0,0,1,0.011096248051005644,57.82022078689844,3753
0,0,0,0,0,0,0,0.006886753568588072,57.835852640426566,3753
0,0,0,0,0,0,0,0.00961679582189834,57.85149062236801,3754
0,0,0,0,0,0,0,0.003879259702483642,57.858473984476255,3754
0,0,0,0,0,0,0,0.004965897820858322,57.85850993215436,3754
0,0,0,0,0,0,0,0.0,57.88126380118962,3754
0,0,0,0,0,0,0,0.0018368871094801792,57.8969295936257,3756
0,0,0,0,0,0,0,0.0030468822497313128,57.8969295936257,3756
0,0,0,0,0,0,0,0.004879867640944984,57.8969295936257,3757
0,0,0,0,0,0,0,0.004754298556800581,57.8969295936257,3757
0,0,0,4,0,0,4,0.0014025304952804912,57.883086798778855,3754
0,0,0,0,0,0,0,0.009403388840011262,57.8829735399832,3757
0,0,0,0,0,0,0,0.008654552877511108,57.8829735399832,3756
0,0,0,0,0,0,0,0.007625283606692147,57.88995579803082,3757
0,0,0,5,0,0,5,0.0032483581097555417,57.90031063562403,3754
0,0,1,0,0,0,1,0.006188022746046021,57.90031063562403,3755
1,0,0,0,0,0,1,0.007084867541446966,57.91595194659992,3757
0,0,0,0,0,0,0,0.003172531898258905,57.94722730940315,3757
0,0,0,0,0,0,0,0.005920420315889642,57.931587140839135,3757
0,0,0,0,0,0,0,0.0030236734135960382,57.938568586580416,3757
0,0,0,0,0,0,0,0.00045054160147430867,57.938568586580416,3757
0,0,0,0,0,0,0,0.004176396906061573,57.938568586580416,3758
0,0,0,0,0,0,0,4.2878619741483335e-08,57.96109884422515,3758
0,0,0,0,0,0,0,0.0,57.96109884422515,3759
0,0,0,0,0,0,0,6.121755776722248e-05,57.96823274355528,3759
0,0,0,0,0,0,0,0.00705124398003776,57.96808048883478,3762
0,0,0,1,0,0,1,0.0033379856500786696,57.97682647684256,3761
0,0,0,0,0,0,0,0.004291280042668799,57.9838078640289,3762
0,0,0,0,0,0,0,0.004981795904931653,57.9838078640289,3762
0,0,0,0,0,0,0,0.0032193620485021415,57.99414236405718,3762
0,0,0,6,0,0,6,0.0059885805450309495,57.96286363657734,3759
0,0,0,2,0,0,2,0.005939981976737564,57.96286363657734,3759
0,0,1,0,0,0,1,0.0062409053687932856,57.96286363657734,3759
0,0,1,0,0,0,1,0.0061195849384131406,57.96286363657734,3759
0,0,0,0,0,0,0,0.009673107178544903,57.96286363657734,3760
0,0,0,0,0,0,0,0.006284527978036483,57.96286363657734,3760
0,0,0,0,0,0,0,0.003553539419805216,57.96984511504766,3761
0,0,0,0,0,0,0,0.0030035514328257155,57.99316734025589,3761
0,0,0,0,0,0,0,0.00929912016136912,57.99237546923722,3764
0,0,1,0,0,0,1,0.01064434614475813,57.99237546923722,3764
0,0,1,0,0,0,1,0.018554487554963417,58.00801367130195,3769
0,0,0,0,0,0,0,0.01799443088316569,58.023741392501236,3769
0,0,0,2,0,0,2,0.014820411667840757,58.02378443021062,3769
0,0,0,0,0,0,0,0.014547682372881943,58.03075597044226,3769
0,0,1,0,0,0,1,0.011872787137201905,58.06199942691403,3769
1,0,0,0,0,0,1,0.01086957272330909,58.109328338605195,3773
0,0,0,1,0,0,1,0.011431620720132808,58.12455299553533,3773
0,0,0,1,0,0,1,0.006291377885056776,58.134887610842746,3772
0,0,0,6,0,0,6,0.005368653990901616,58.08796990365859,3768
0,0,0,0,0,0,0,0.00168312840705694,58.11924667672497,3768
0,0,0,0,0,0,0,0.0018248362048607569,58.11924667672497,3768
0,0,0,0,0,0,0,0.0,58.12613876361219,3768
0,0,0,0,0,0,0,0.0,58.12613876361219,3768
0,0,0,0,0,0,0,0.003944669873700711,58.12613876361219,3770
0,0,0,0,0,0,0,0.005823760423065429,58.133445854208176,3771
0,0,0,0,0,0,0,0.006234923986869164,58.14875845935495,3772
0,0,0,0,0,0,0,0.00013859270829004664,58.16439998215672,3772
0,0,0,0,0,0,0,0.0,58.17137822059237,3772
0,0,0,0,0,0,0,0.00045356350474991643,58.17137822059237,3773
1,0,0,0,0,0,1,0.0067477226048031054,58.15574000648456,3774
0,0,1,1,0,0,2,0.0030875788168503297,58.18012436070115,3773
0,0,0,0,0,0,0,0.002959542201914381,58.18012436070115,3773
0,0,0,0,0,0,0,0.008952873334288599,58.18012436070115,3775
0,0,1,0,0,0,1,0.006173969002795432,58.18012436070115,3774
0,0,0,2,0,0,2,0.011083707608592338,58.166161370137374,3775
0,0,0,2,0,0,2,0.0066699040148028195,58.188691870301405,3776
0,0,0,0,0,0,0,0.01218524569646017,58.18869151271663,3777
0,0,1,2,0,0,3,0.006274064796884229,58.204329996508136,3775
0,0,0,0,0,0,0,0.006513588781622762,58.20432973681581,3775
0,0,0,0,0,0,0,0.0027680847739526573,58.21996802504443,3776
0,0,0,0,0,0,0,0.006141763438494833,58.211221670272614,3776
0,0,0,0,0,0,0,0.008436875243424577,58.211221670272614,3777
0,0,0,0,0,0,0,0.010659492398359307,58.22686435238697,3779
0,0,1,0,0,0,1,0.007822792543536097,58.23384148204879,3779
0,0,0,0,0,0,0,0.011028710502510199,58.249479697808994,3782
0,0,1,0,0,0,1,0.011343136367946533,58.31211155163476,3785
0,0,1,3,0,0,4,0.00942987418659629,58.282657569470025,3781
0,0,0,0,0,0,0,0.006916453129118913,58.2982489881791,3782
0,0,0,0,0,0,0,0.006344354549679387,58.31388736752468,3783
0,0,0,0,0,0,0,0.009291179710408284,58.313887260469734,3783
0,0,0,1,0,0,1,0.012193990075920416,58.2981612403935,3783
0,0,1,1,0,0,2,0.007599806691022077,58.29815955597478,3783
0,0,0,0,0,0,0,0.0035918272905048755,58.32943636286009,3783
0,0,1,0,0,0,1,0.003067381743390475,58.35223519593732,3784
0,0,0,0,0,0,0,0.008879157791467165,58.33658955893745,3786
0,0,0,0,0,0,0,0.01238335645489556,58.35222782975994,3787
0,0,0,0,0,0,0,0.009510851781222995,58.34385330270468,3787
0,0,0,0,0,0,0,0.0035516710879130164,58.366199682912956,3787
0,0,0,0,0,0,0,0.003022687803316446,58.37481196438861,3787
0,0,0,0,0,0,0,0.003672429483844968,58.37481196438861,3788
0,0,0,0,0,0,0,0.003150725729041358,58.39045029535813,3789
0,0,0,0,0,0,0,0.00466491480744329,58.39045029535813,3789
0,0,0,5,0,0,5,0.0026674602560156557,58.3750905960601,3786
0,0,0,0,0,0,0,0.0,58.37476481626912,3786
0,0,0,0,0,0,0,0.0032093197048031195,58.37476481626912,3786
0,0,0,0,0,0,0,0.0031668675509469594,58.37476481626912,3787
0,0,0,5,0,0,5,0.008065904153356522,58.35382058815946,3785
0,0,1,0,0,0,1,0.003086747420680006,58.36945881418234,3784
0,0,0,1,0,0,1,0.003238296253635227,58.36945881418234,3784
0,0,0,0,0,0,0,0.003229397234520438,58.36945881418234,3785
0,0,0,0,0,0,0,0.008213930025226327,58.36945881418234,3787
0,0,1,0,0,0,1,0.012878323914427186,58.38511583448261,3789
0,0,1,0,0,0,1,0.009752039149886283,58.39200785689496,3789
0,0,1,0,0,0,1,0.011828999173319416,58.398989244511846,3791
0,0,0,0,0,0,0,0.008782328322611716,58.405976721885466,3791
0,0,0,0,0,0,0,0.013400885106760907,58.421608941987394,3792
0,0,0,0,0,0,0,0.008228106540295975,58.43727918143266,3792
0,0,0,0,0,0,0,0.008214094670957931,58.45291740680385,3794
0,0,1,2,0,0,3,0.006591566714215684,58.43736988380085,3792
0,0,0,1,0,0,1,0.011127652959335809,58.437368551665465,3793
0,0,1,1,0,0,2,0.003108225999594148,58.437368551665465,3790
0,0,0,0,0,0,0,0.008987167571231188,58.437368551665465,3792
0,0,0,6,0,0,6,0.006076898250456923,58.41642438473627,3788
0,0,0,0,0,0,0,0.002977020945922093,58.42331715410884,3788
0,0,0,0,0,0,0,0.006992869655386373,58.43899818411259,3791
0,0,0,1,0,0,1,0.0031826294432476467,58.470238960124625,3791
0,0,0,0,0,0,0,0.0,58.48586952973656,3791
0,0,0,0,0,0,0,0.0,58.48586952973656,3791
0,0,0,0,0,0,0,0.002387943786676022,58.48586952973656,3792
0,0,0,0,0,0,0,0.0022780904743914714,58.49285120623678,3793
0,0,0,0,0,0,0,0.005377691730499983,58.492850957763416,3794
0,0,1,0,0,0,1,0.006014140417146401,58.492850957763416,3794
0,0,1,0,0,0,1,0.006241015804542201,58.492850957763416,3794
0,0,0,0,0,0,0,0.006142730386088208,58.492850957763416,3794
0,0,0,2,0,0,2,0.012672957715737444,58.470320761874035,3794
0,0,0,0,0,0,0,0.012311227223140046,58.486149664388165,3795
0,0,0,2,0,0,2,0.008077555762026527,58.486149664388165,3794
0,0,0,0,0,0,0,0.0,58.533064612472764,3794
0,0,0,1,0,0,1,0.0006371933474788628,58.54361339138773,3796
0,0,0,0,0,0,0,0.0008325498602393507,58.57488982239156,3797
0,0,0,0,0,0,0,0.0029185584229254042,58.57488982239156,3797
0,0,0,0,0,0,0,0.0037238183310559472,58.57488982239156,3798
0,0,0,1,0,0,1,0.006202252892084632,58.57488982239156,3798
0,0,1,0,0,0,1,0.006965604622102378,58.57488982239156,3799
0,0,1,0,0,0,1,0.009503693314936019,58.597869292175965,3803
0,0,0,0,0,0,0,0.0094210815003384,58.63627574244535,3804
0,0,0,0,0,0,0,0.00910465839718395,58.62063744204288,3803
0,0,0,0,0,0,0,0.006495974663513425,58.643257705785345,3804
0,0,0,0,0,0,0,0.008376010189530339,58.66594304492801,3808
0,0,0,0,0,0,0,0.014655191627684815,58.68142618569038,3811
0,0,1,0,0,0,1,0.016448361681063596,58.68831824246248,3812
0,0,0,2,0,0,2,0.005995721987784273,58.716269705816565,3809
0,0,0,0,0,0,0,0.0031998883734290196,58.73178359492894,3809
0,0,0,0,0,0,0,0.006401765325175124,58.73178344758121,3810
0,0,0,0,0,0,0,0.01008709485418008,58.73178344758121,3812
0,0,0,7,0,0,7,0.006073098125020377,58.71614281811027,3807
0,0,0,0,0,0,0,2.6671892934647555e-08,58.747419346800186,3807
1,0,0,0,0,0,1,0.0022864637847965206,58.73867322827539,3808
1,0,0,0,0,0,1,0.005044391915794691,58.75431153098289,3810
0,0,0,0,0,0,0,0.0057976063515151255,58.76994974531569,3811
0,0,0,0,0,0,0,0.0072912450267224455,58.801251216961276,3814
0,0,0,0,0,0,0,0.004367570763086114,58.82384621160187,3815
0,0,0,0,0,0,0,0.007056617913660309,58.82384621160187,3816
0,0,0,0,0,0,0,0.0031285749609829736,58.845538631162235,3816
0,0,0,0,0,0,0,0.0031548088487843933,58.845257185446094,3816
0,0,0,0,0,0,0,6.329007960589995e-06,58.84813458356379,3816
0,0,0,0,0,0,0,2.720938581850197e-06,58.863731125552334,3817
0,0,0,1,0,0,1,0.0,58.85682502272414,3817
0,0,0,0,0,0,0,0.00292477275101711,58.872464394185684,3818
0,0,0,0,0,0,0,0.006121739716668771,58.872463321116214,3819
0,0,0,0,0,0,0,0.008499275330288342,58.872463321116214,3820
0,0,0,2,0,0,2,0.0031279505156377035,58.8898155122643,3818
0,0,0,0,0,0,0,0.0031733095158289607,58.8897769102699,3818
0,0,0,0,0,0,0,0.0,58.90541518832268,3818
0,0,0,0,0,0,0,0.0021455482383699797,58.90541518832268,3819
0,0,0,0,0,0,0,0.0031096773245256042,58.90541518832268,3819
1,0,0,0,0,0,1,0.002317744535029657,58.92105698749758,3820
1,0,0,0,0,0,1,0.00424921051181472,58.93669190515552,3822
0,0,0,0,0,0,0,1.298409377113966e-05,58.95934491182766,3822
0,0,0,0,0,0,0,0.0029931945694971506,58.95931169874867,3823
0,0,0,0,0,0,0,0.0025897231807724495,58.95931169874867,3823
0,0,0,0,0,0,0,0.002952214200186025,58.96629313257963,3824
0,0,1,0,0,0,1,0.011558763104848983,58.96629313257963,3828
0,0,0,0,0,0,0,0.011843880641375364,58.981931955860965,3828
0,0,0,0,0,0,0,0.006136680904354135,58.99765743170515,3827
0,0,0,0,0,0,0,0.006502405014008288,59.01320804828907,3828
0,0,0,0,0,0,0,0.009655947022281109,59.01320804828907,3831
1,0,0,4,0,0,5,0.006018290499276324,59.05305183652509,3830
0,0,0,2,0,0,2,0.0,59.05305183652509,3828
0,0,0,0,0,0,0,0.0,59.053051602593975,3828
0,0,0,0,0,0,0,0.0,59.053051602593975,3828
0,0,0,0,0,0,0,0.0,59.053051602593975,3828
0,0,0,0,0,0,0,0.003248784821930368,59.06338610262228,3830
0,0,1,0,0,0,1,0.0029670004491565392,59.06338610262228,3830
0,0,0,0,0,0,0,0.0057166067745654265,59.0792975629105,3832
0,0,0,0,0,0,0,0.0031327591159511516,59.0792975629105,3831
0,0,0,0,0,0,0,2.299386365927938e-07,59.08628144745633,3831
0,0,0,0,0,0,0,0.0,59.08627898299122,3831
0,0,0,0,0,0,0,0.0,59.08627898299122,3831
0,0,0,1,0,0,1,0.0052196620335381505,59.07938707940091,3832
0,0,1,0,0,0,1,0.0029871772207986807,59.07938707940091,3831
0,0,0,0,0,0,0,0.005932156805404498,59.07938707940091,3832
0,0,0,0,0,0,0,5.1078939079416845e-06,59.121006431999305,3833
0,0,0,1,0,0,1,0.0034505248264629002,59.1036823114299,3833
0,0,0,0,0,0,0,0.005938684248722392,59.1036823114299,3833
0,0,0,1,0,0,1,0.002961938740590311,59.1036823114299,3832
0,0,0,0,0,0,0,0.0030204024107554797,59.11932660924581,3833
0,0,0,0,0,0,0,0.0014179002780025402,59.134965019367705,3835
0,0,0,0,0,0,0,0.0029024232510177473,59.141857347743375,3835
0,0,1,0,0,0,1,0.005109772135995414,59.14185710319167,3836
0,0,0,0,0,0,0,0.00468494683076532,59.14185710319167,3836
0,0,1,0,0,0,1,0.004296864440107845,59.15219160321997,3837
0,0,0,0,0,0,0,0.005480277019539901,59.14185710319167,3837
0,0,1,0,0,0,1,0.01230876281554004,59.15749545713281,3839
0,0,0,0,0,0,0,0.012339829579032085,59.164476962804365,3840
0,0,1,2,0,0,3,0.007296969100723508,59.1575848789804,3838
0,0,0,0,0,0,0,0.010993603980034045,59.1575848789804,3839
0,0,0,1,0,0,1,0.004883517540776988,59.1679193790087,3838
1,0,0,1,0,0,2,0.004488797724904288,59.18355772591763,3839
0,0,0,1,0,0,1,0.006169197035986404,59.1818799998492,3838
0,0,0,1,0,0,1,0.0029906034201518544,59.1818799998492,3837
0,0,0,0,0,0,0,0.002981236156980088,59.1818799998492,3837
0,0,0,0,0,0,0,0.001688053089967109,59.19751859817651,3838
0,0,0,0,0,0,0,0.0032313406412424655,59.188773958434204,3838
0,0,1,0,0,0,1,0.00913216617196061,59.188771904302996,3840
