throughput_KLONGTEI,throughput_KASEMRAT,throughput_NARANONG,throughput_SUNLAKAKHON,throughput_RAMA4, throughput_ATTHAKAVI_RAMA4,throughput,mean_speed,jamlength_percent,Backlog
0,0,0,0,0,0,0,9.904311108768514,0.0,12
0,1,0,0,0,0,1,9.839863360162939,0.0,29
0,1,0,0,0,0,1,10.569699334734166,0.0,45
0,0,0,0,0,0,0,10.304831657863364,0.0,72
1,2,0,1,0,0,4,10.720197186647916,0.027650399548779687,104
1,2,2,0,1,1,7,9.968870445469534,0.09853519948630768,136
0,4,0,0,1,1,6,9.737582112252989,0.1672852624911552,146
2,4,1,2,1,1,11,9.34424865904939,0.23987077907177293,184
0,5,0,9,0,2,16,9.723940476667071,0.27777936961376426,220
4,6,1,1,3,3,18,9.408733769687307,0.356909410690981,241
6,4,0,2,2,6,20,8.922513149489257,0.5972046305572777,273
6,18,0,3,1,5,33,8.875648746783073,0.6322456966902513,306
9,11,0,5,3,4,32,8.493576524523098,0.8209520376493726,324
5,13,0,2,3,5,28,7.965014710095942,1.0720510528996037,345
6,8,1,2,4,7,28,7.072548197682111,1.4937528023893887,371
4,7,8,0,2,0,21,6.774932229749364,1.781653625573733,400
5,8,4,0,0,4,21,6.10650043672792,2.2908055290653655,428
5,10,0,18,3,6,42,6.012078735473574,2.516677427391798,440
2,9,1,11,1,5,29,5.6244498540539825,2.9197355013239727,462
10,9,11,6,22,7,65,6.0751122242473174,2.429400151946438,452
8,10,10,1,22,5,56,6.274608317609576,2.400506803459934,476
9,5,12,15,3,8,52,6.524174192178425,2.3764832938822837,501
11,7,10,9,5,3,45,6.245405310567642,2.6303356522033754,524
9,13,8,2,5,10,47,6.117608028844471,2.7151722230023747,539
8,7,7,0,4,13,39,5.518524417679706,3.317552371730061,566
9,14,8,2,5,15,53,5.429182983013202,3.457668614147613,562
9,13,7,18,5,12,64,5.350333976822669,3.684310115788639,566
7,10,8,7,5,8,45,5.049943614072541,4.1763476102007155,596
9,9,10,3,19,4,54,4.902143591647839,4.221000907329557,606
28,13,10,0,24,7,82,5.381307584201328,3.980602447464352,616
24,6,6,2,17,7,62,4.960633238759026,4.290391431477806,625
13,7,13,9,7,9,58,4.849074326678843,4.376222280514148,630
7,12,10,6,4,8,47,4.525683929649547,4.722324457400019,638
5,8,15,2,6,9,45,4.2823472800898745,4.929036262223666,634
4,11,7,1,11,9,43,3.8690122110056486,5.381500399619598,647
6,22,3,1,11,6,49,3.9907286114288074,5.286958776766261,661
7,9,7,17,6,7,53,4.1737423871667225,5.332578501450116,691
8,13,7,22,3,7,60,4.227437325868554,5.54137630404384,691
5,8,11,16,6,4,50,4.308334754605237,5.691594946316874,715
17,6,9,4,9,7,52,4.243115222498113,5.814355042046043,725
5,6,1,8,11,5,36,3.6438620940862934,6.419009353911684,724
6,9,1,5,3,7,31,3.0254626583780686,7.230546253510265,743
3,8,10,4,1,5,31,2.8937068948404185,7.6555566308161875,759
5,13,10,5,0,6,39,3.0496952262853942,7.7065647508743504,789
4,7,11,2,17,6,47,3.241972207758269,7.584736214793656,814
6,6,11,3,23,7,56,3.492517627752127,7.561035415155925,829
9,6,11,6,22,5,59,3.4195637807941526,7.779044509513426,831
13,6,10,6,19,5,59,3.501163079932552,8.148293779603259,861
12,8,10,3,8,11,52,3.407574456755952,8.047886065339616,873
7,17,11,11,23,18,87,3.5769795373497146,8.283122056366807,879
32,15,10,17,14,12,100,3.5426486599627314,7.730905425924814,871
17,12,8,15,5,10,67,3.47576155896444,7.891914652454407,877
6,7,5,13,7,12,50,3.215298937916232,8.359425543743843,877
5,9,3,15,5,15,52,3.151291839518327,8.383775506451803,902
3,9,6,6,5,16,45,2.8878316035724567,9.30574600359776,914
7,8,5,2,16,10,48,2.5767182988955994,9.425962818991565,917
3,15,4,1,9,1,33,2.6816479772271506,9.537189375981301,933
3,16,11,7,10,4,51,2.90555257777313,9.144603736479393,947
3,27,7,6,8,7,58,3.2685735672742617,8.703988724341485,962
4,17,9,3,10,7,50,3.1475004237990443,9.205785669710215,979
13,21,6,1,10,6,57,3.1079309534211967,9.19041075568479,979
7,11,6,4,7,7,42,2.9176014733620668,9.670746456687981,991
5,6,8,14,4,9,46,2.95954591281393,9.865125353134822,1033
3,10,8,21,5,7,54,2.931386222719722,10.189397026459702,1045
5,8,8,18,5,6,50,2.86899417707239,10.59310479220502,1057
4,12,6,8,6,3,39,2.900047663576238,10.96891654628411,1085
5,15,6,7,11,7,51,2.954196291681009,10.95140980174458,1103
3,21,10,3,14,5,56,2.9268226277319913,11.249799168950746,1111
2,21,12,5,3,8,51,2.637918592566504,11.906838145279066,1123
1,18,14,2,2,8,45,2.607977969635592,12.07571664011304,1146
2,12,7,15,21,7,64,2.5816707043739235,11.732775959900804,1145
8,11,0,14,19,6,58,2.6358157759434278,11.703095739376598,1150
9,5,0,15,17,5,51,2.508753885552551,12.095424041996845,1172
8,6,5,7,8,4,38,2.369691885662639,12.493244802562838,1186
15,15,3,4,21,13,71,2.480205412801091,12.354412307898055,1191
7,13,9,4,28,11,72,2.444581586740697,12.256007175658572,1200
32,24,10,17,21,12,116,2.766469533046521,11.23731378983625,1175
34,25,7,20,14,13,113,2.9941671862288253,11.186444475916389,1158
30,25,5,21,19,13,113,2.8158313669044372,11.19066036979261,1130
6,11,10,24,12,13,76,2.4937379468382903,11.89244711936226,1118
30,10,11,16,7,9,83,2.2390822790927745,12.3799920228656,1097
6,6,6,5,11,3,37,2.09100230765191,12.541565490345427,1108
9,16,6,9,6,3,49,2.0811908770022245,12.647283084602364,1122
10,8,9,3,8,5,43,2.003423902328578,12.754404569310568,1130
10,12,5,4,7,6,44,1.9195062796119167,12.795454280385348,1131
9,9,5,4,7,6,40,1.9337176848403543,13.003844945329396,1151
6,8,6,2,6,5,33,2.0611489873638966,12.933398144332342,1160
3,7,5,7,14,7,43,1.880852312614566,13.411953556309932,1163
1,11,11,6,8,6,43,2.0324421215147055,13.652085668092013,1187
3,6,5,10,7,6,37,1.7810816593725036,14.251847316618374,1184
0,13,5,11,1,5,35,1.9755912344413613,13.974275402954383,1208
5,9,9,11,22,7,63,2.387232434411257,13.105390810808672,1216
7,11,10,13,28,7,76,2.7745331586662605,12.495539883116779,1213
8,10,10,16,18,10,72,2.6695533097292246,12.861439723776309,1231
8,14,7,13,3,6,51,2.7150767646218754,12.730287210095089,1242
12,8,9,6,1,11,47,2.5177773298116435,12.71628703894292,1254
14,12,9,8,11,12,66,2.451294031710553,12.970473900389564,1271
14,26,8,5,12,17,82,2.48391426664411,13.265872624639522,1288
7,24,5,7,15,14,72,2.3470784492625896,13.927127485261847,1304
9,22,5,5,6,12,59,2.3111915933612774,14.186984767413913,1304
3,17,5,4,20,7,56,2.2806035164360083,14.369907343261483,1324
13,9,5,5,24,11,67,2.321217819762038,14.213249077456787,1343
15,7,6,12,10,8,58,2.1468131770458445,14.525274038846362,1360
15,8,13,13,8,9,66,2.332361659636262,14.168191713688438,1368
6,12,13,13,11,7,62,2.3548684610952604,14.690528866611613,1387
8,8,13,9,2,7,47,2.2222759743023763,15.073070450763558,1389
24,24,9,6,18,8,89,2.3475043042143193,14.190767955592154,1373
29,25,8,8,30,13,113,2.4551964862126967,14.181963509279283,1353
28,26,11,4,5,12,86,2.3136348014524897,14.19598070573734,1341
0,8,12,7,11,3,41,2.1764144435263737,14.643619837851409,1351
23,5,15,5,19,6,73,2.2778370612631185,14.811954646057558,1369
12,6,10,5,16,5,54,2.0239843429120024,15.45539832193557,1382
16,11,12,6,7,5,57,1.939493283646833,15.79289536240612,1406
7,14,4,3,8,8,44,1.859590056817265,16.349544110822357,1431
9,11,5,14,1,12,52,1.9069018361757364,16.070729896977735,1440
7,23,5,13,18,16,82,1.8674495553852462,16.38467555980133,1439
17,23,5,10,11,11,77,1.7104313642501172,16.91345688183844,1433
17,23,5,6,6,12,69,1.6479857128962796,17.26572251192213,1424
5,12,5,2,10,3,37,1.5840476754854955,17.22660932861366,1443
0,6,5,1,22,7,41,1.5464551916668774,17.965139585923378,1465
16,6,6,17,2,4,51,1.5240117345870203,18.003791873839166,1466
7,10,5,19,8,7,56,1.5410266895901883,17.789449012003658,1460
7,14,15,20,3,3,62,1.630454982914668,17.492049463677493,1447
7,5,14,22,21,2,71,1.881032974723362,16.620484810822614,1445
26,24,12,21,9,6,98,1.9793718387899986,15.792227364868886,1423
6,17,15,23,4,8,73,1.8333517888833397,16.156846984752402,1408
6,15,15,6,0,6,48,1.885192430842327,16.636564478544145,1421
3,10,15,8,13,10,59,1.8810307472981322,16.508522243093854,1421
8,10,14,5,5,9,51,1.9041807036229517,16.64449984211311,1419
1,11,6,6,4,9,37,1.7100227089631534,17.56864186470928,1462
5,6,9,10,5,9,44,1.476582504374688,18.0916159251261,1467
4,0,12,5,6,9,36,1.7423407401476396,16.993905933438075,1486
8,0,6,7,17,9,47,1.740068802798348,17.00966512251191,1488
6,14,2,12,13,9,56,1.8859529016294307,16.719831896994886,1493
9,21,5,11,2,6,54,1.8808549932759298,16.748643633754757,1486
14,17,5,13,4,4,57,1.9722100901210442,16.039528643098446,1488
13,18,5,15,7,4,62,2.0740582237571488,15.503956219178693,1487
12,17,5,10,10,5,59,2.3649791028599965,15.185895343064047,1502
12,8,5,7,10,4,46,2.2563416307458803,15.833958936065473,1512
6,11,5,8,7,0,37,2.0658916125133744,16.90708057754237,1524
16,12,5,8,9,3,53,2.017841815878917,16.92945942140373,1531
19,15,5,10,9,0,58,1.8681237306339338,17.51113838207897,1537
10,13,5,8,7,5,48,1.8512577335670832,18.111837144047332,1554
13,18,9,6,8,6,60,1.8624518768988847,18.07101880523511,1563
10,15,5,4,8,2,44,1.6131537400460052,19.45266061985364,1593
7,7,6,4,7,4,35,1.5830956850759748,19.903155245806527,1621
6,5,10,9,6,2,38,1.6238518072697066,20.46490724439168,1658
8,6,6,14,17,4,55,1.6022450746979604,20.6761893092901,1666
2,13,10,13,10,2,50,1.53708654555864,20.504347473746016,1663
1,5,6,9,4,4,29,1.6875154124958593,21.106381950900506,1701
4,9,7,5,1,0,26,1.4638363307370992,21.569572460729248,1710
1,17,8,5,0,3,34,1.565259745869295,21.440828233564933,1713
7,14,8,2,20,2,53,1.5668829465745135,21.220242470597263,1738
4,7,5,15,21,2,54,1.7421944691928268,20.5175665665997,1745
10,3,7,13,19,5,57,1.7021324859220541,20.0834529301174,1766
7,5,10,11,19,4,56,1.5386438251194283,20.977260312853584,1788
12,5,11,9,21,7,65,1.4702360299447186,21.41463021765148,1804
17,10,10,8,28,4,77,1.456302069568539,21.490651511282728,1795
10,7,10,6,16,1,50,1.3168072611740436,22.2551997767617,1813
10,10,9,3,7,4,43,1.3059706683475765,22.438846836739366,1818
32,22,6,16,7,5,88,1.5648876651751236,21.632809408751108,1812
10,12,15,20,8,7,72,1.5810925600883643,20.92433778267167,1804
19,18,14,22,20,2,95,1.7591253351937919,20.178951770616,1777
24,5,14,19,27,2,91,1.8478210695415762,20.28346422017647,1762
28,4,12,13,23,3,83,1.6772090605382355,20.584462382296376,1743
24,5,11,13,8,4,65,1.3741029896581616,20.791908788717212,1724
8,8,9,17,20,4,66,1.3813284759304738,20.74615042742203,1702
10,10,10,12,15,5,62,1.3628024228168978,20.805753304156102,1714
8,8,6,15,9,19,65,1.4395769062356254,20.580929988312846,1732
2,21,4,14,10,15,66,1.5109799187548734,20.672676511632396,1743
8,14,0,10,16,16,64,1.689285669333059,20.094660626647283,1747
20,26,0,10,12,16,84,1.8609270625678054,19.722623185637705,1742
11,19,15,9,7,20,81,1.882582879020661,19.30068011093138,1733
4,15,15,10,7,20,71,2.0567837257032466,19.09354301522532,1743
4,12,15,11,11,19,72,2.013787078786486,19.368431628770825,1737
6,10,15,11,7,17,66,1.7110881026759894,20.374117830211564,1725
5,6,3,7,6,14,41,1.563734411106676,21.52736644763659,1743
6,13,10,4,4,17,54,1.3445065422853832,21.81130292925399,1746
5,28,10,4,2,17,66,1.4835274839583277,21.457223058103526,1759
2,34,4,5,7,15,67,1.4369138306672942,22.20651129965441,1755
4,25,1,6,1,12,49,1.402818531283955,22.13919513639681,1747
3,14,10,7,1,17,52,1.3339346011844107,22.638901836849676,1757
14,13,5,2,1,14,49,1.3499202343661447,22.605466934286802,1764
0,8,5,0,0,14,27,1.211733765912262,23.06199117227808,1771
0,9,5,0,6,12,32,0.9991838479228144,23.457348485195386,1777
0,12,5,4,4,12,37,0.9434307730404885,23.957142284316514,1779
0,12,5,0,9,2,28,0.9202010285057353,23.876336296709127,1782
0,19,8,9,7,2,45,1.0248133135077344,23.64781118204731,1792
0,12,10,14,6,6,48,1.0427722359878862,23.591854006080546,1794
5,19,12,10,22,6,74,1.2852329160364437,22.623151289530103,1778
6,14,9,5,27,4,65,1.395828909148377,22.527830095840105,1788
5,7,6,4,13,6,41,1.29673748864736,22.771676263885258,1804
6,7,6,17,2,7,45,1.2523242845866123,22.848638643027286,1811
6,8,5,21,24,11,75,1.3899161873166652,22.23769280902395,1798
12,8,6,22,21,16,85,1.4234881514418525,21.97605065618994,1794
11,8,5,22,6,17,69,1.4107048595873453,22.236196991600508,1798
9,24,4,22,7,15,81,1.377898730304985,22.173510342909026,1789
11,24,10,7,8,10,70,1.26359002422127,22.89087291123858,1795
7,27,6,3,7,2,52,1.4676901215160063,22.042144173157702,1812
5,13,6,2,9,6,41,1.350177330144569,22.063354836661826,1819
23,5,7,2,22,8,67,1.3907100428886465,21.835586381380256,1812
1,7,12,14,8,6,48,1.3730378566898696,21.87797957812169,1819
34,6,12,13,8,5,78,1.4957553747403445,20.82678459153544,1807
26,9,10,14,11,6,76,1.4322881027901966,21.184480292877762,1808
15,9,8,11,11,6,60,1.4017985703950933,21.74281659955395,1824
14,25,6,8,6,5,64,1.4999737982445673,21.38863001297639,1829
3,21,5,7,3,5,44,1.435212588682983,22.025636914583842,1832
2,15,6,8,6,6,43,1.4619839614808643,22.216435356417037,1850
8,8,10,4,8,5,43,1.3201078495002232,22.789917123522795,1855
7,7,6,3,8,5,36,1.2425640200027641,23.03238482405364,1857
10,7,5,7,21,5,55,1.3297709358471388,22.409015635402895,1860
0,10,5,3,26,5,49,1.362447069704303,22.718723489577428,1873
16,10,5,4,24,5,64,1.365354976719275,23.30027142476962,1890
15,9,5,5,14,6,54,1.3678284969793701,23.447755306305492,1896
15,22,6,0,9,10,62,1.5196035165911337,22.92590821649991,1906
14,24,6,1,9,12,66,1.3516298396061668,23.754714442774173,1917
9,19,17,0,9,9,63,1.3607007453709534,23.6992667365962,1919
7,8,13,0,9,12,49,1.2481337261852905,24.111773785844186,1927
11,11,9,7,3,14,55,1.1119395742481022,24.65604386483941,1923
16,7,8,6,21,12,70,1.1687515741836312,24.85132797462958,1948
9,9,11,9,22,8,68,1.2997603742959418,24.574207787573908,1965
1,10,6,7,12,6,42,1.3453668416498101,24.609740988040606,1985
20,9,5,6,0,7,47,1.406796133001885,24.831164657256135,1994
15,24,5,17,3,12,76,1.4598600794490042,23.937285277868497,1984
13,30,6,20,2,11,82,1.4035795699441718,23.972281840335448,1956
5,22,6,22,5,15,75,1.4480163588616213,23.458841041540097,1946
7,15,5,22,11,12,72,1.259631459020541,23.942064387977855,1929
9,7,6,9,9,10,50,1.1311374266693899,24.18970958861731,1923
6,7,7,12,8,6,46,1.10143326386796,24.396841048711934,1932
9,10,5,11,23,3,61,1.1410721412281033,23.39587055414019,1936
10,8,5,15,26,4,68,1.4633019085463423,23.12465185031469,1956
2,11,8,13,16,6,56,1.4900646543009848,23.22590928376375,1972
10,22,6,10,0,6,54,1.610276454103501,23.004157008032482,1975
3,16,5,9,8,11,52,1.3863415504543304,23.478202447079486,1969
5,20,9,6,7,15,62,1.3856177927311562,24.015714872023302,1980
7,13,8,8,6,15,57,1.1966735234114836,24.544454404635093,1992
6,14,2,3,7,15,47,1.0912918380982277,25.312018289896784,2003
6,12,5,2,4,7,36,0.9895143146373242,25.915244807914082,2029
6,11,6,0,14,5,42,0.948008582600388,26.20380808245246,2036
5,7,5,0,3,8,28,1.0607186237785604,26.03819060251567,2059
5,7,6,2,4,7,31,1.0195536475314346,26.27731208563055,2066
0,24,5,0,0,7,36,1.036913933755177,25.706591832932638,2076
7,22,5,0,8,12,54,1.138708039235708,25.682139215499237,2082
7,19,7,0,12,12,57,1.136410926261381,25.88647542603054,2078
9,15,6,0,13,0,43,1.1076714659505764,26.198337178450117,2085
10,3,10,12,13,6,54,1.1798363528258837,26.093967615712817,2085
13,6,6,7,9,7,48,1.4144753268136443,24.901260265175726,2117
14,11,6,3,19,7,60,1.4309819485227224,24.70711757614637,2120
11,12,0,3,7,5,38,1.5027247651304583,24.571506464606273,2150
13,15,0,17,5,5,55,1.6398809368104785,24.58562762042957,2162
12,21,1,21,9,8,72,1.6589249945268842,24.168779507029203,2144
0,19,0,20,10,5,54,1.6870195448957013,24.150119715500015,2144
14,24,5,22,10,8,83,1.6764149710716352,23.532333317852984,2131
17,11,7,8,5,7,55,1.4906133262356935,24.054789951027,2134
13,8,8,2,2,9,42,1.4021806897431814,25.318566016568948,2156
10,10,5,3,6,8,42,1.203583367298766,26.09083682705709,2171
2,5,5,7,5,10,34,1.0543303961612769,27.25589930217161,2177
3,7,6,9,12,7,44,0.9625738564154991,27.833052580998228,2191
1,8,6,7,20,9,51,0.8681787291975125,28.649904476945885,2198
0,18,5,3,11,8,45,0.8220817926157495,28.84404536684683,2171
4,18,6,2,15,9,54,0.8802472984444052,29.382542678042118,2191
0,18,6,3,15,8,50,0.8790396154720815,29.082474097270417,2188
3,18,9,13,22,5,70,0.9811076059017666,28.628480269410687,2187
5,17,8,16,20,6,72,1.1799772814337666,28.170167400233048,2187
5,13,6,17,4,5,50,1.0700926567954094,28.46516236155166,2195
5,12,5,12,0,6,40,1.0761843315598196,27.74209549332526,2193
6,19,6,13,19,5,68,1.168253598694113,28.41632654794003,2201
4,12,6,10,14,5,51,1.135024076293692,28.4196198856674,2206
29,6,10,6,13,5,69,1.164763813848145,28.472976763018664,2206
19,5,7,7,17,5,60,1.0774168419458614,28.909578877036267,2210
15,8,7,6,8,6,50,0.9877699569629995,29.373621871826085,2203
1,10,7,4,11,6,39,1.0278391592871823,29.015089262365624,2213
11,6,2,3,9,5,36,1.1085441873024597,29.202436110154245,2231
4,7,5,3,5,5,29,1.0075447903612322,29.614481578878465,2236
7,16,5,1,4,5,38,0.8956460723521563,29.662025341056445,2237
7,5,5,0,4,5,26,0.8889600480239337,30.058721040970877,2246
5,16,5,0,15,5,46,0.9785550275372924,30.05971290306902,2255
6,9,7,0,10,5,37,0.9561745195712968,30.194755810655828,2264
1,7,8,0,18,5,39,1.0026499993543996,29.937338299601333,2279
1,7,5,9,24,5,51,1.0368920065878071,30.49070640908777,2283
0,5,5,8,8,8,34,0.9547510874321701,30.655791534496647,2282
0,17,12,6,0,5,40,0.8049977083239547,31.237864899753156,2285
2,11,7,6,7,5,38,0.791965082647972,31.860623206962178,2297
2,21,6,9,7,5,50,0.7875381529497703,32.12709753237218,2293
2,22,8,8,7,7,54,0.7847577524185134,31.79119570298783,2295
2,17,16,4,7,5,51,0.7765320713875848,31.362695627211302,2304
7,10,15,17,6,5,60,0.8399454146687569,31.18385838052592,2292
2,8,15,21,0,6,52,0.8288746987855106,31.28450075302009,2287
0,5,15,23,1,4,48,0.8080204850697429,31.558027166108232,2272
2,5,15,21,0,3,46,0.8829813854165934,30.686951414726252,2253
4,12,5,21,0,2,44,0.806531557585218,30.7109302838763,2241
1,9,5,19,11,3,48,0.8057506184946626,30.82497594626164,2235
20,19,7,14,10,1,71,0.8831528658672129,30.215903062939393,2217
7,15,11,4,7,4,48,0.8774839772675328,30.09940526340682,2226
4,11,7,12,5,2,41,0.793041281249175,30.32668175426758,2230
2,4,6,14,4,2,32,0.8382139074570711,30.153234483559483,2237
2,1,5,13,16,5,42,1.2447986355059166,27.36816174168705,2238
2,8,7,16,21,2,56,1.4037524548774274,27.05334581189289,2244
7,9,4,15,16,2,53,1.5603785494407898,26.1571848321988,2249
7,8,9,15,13,4,56,1.4492539347631732,26.606221941206012,2249
8,9,8,7,19,7,58,1.4874758596118773,26.32389438299366,2268
3,19,5,4,8,4,43,1.4285191386459115,26.697547218258386,2280
9,18,5,4,3,5,44,1.2152375790161647,27.781060105346825,2289
12,14,1,3,8,7,45,1.0276364572075074,29.09149616744361,2315
11,6,7,2,4,4,34,0.9489915964375674,29.411794999808013,2316
6,8,5,3,20,7,49,1.0152117123739008,29.63736663469862,2338
10,8,5,4,14,5,46,0.9573018902406019,30.113083338709977,2340
11,9,6,5,8,19,58,1.0196670286791665,29.95434620706496,2339
8,8,5,9,6,14,50,1.061318403945187,29.746873868366816,2341
7,8,5,2,3,21,46,1.0506290413462236,30.765524994658755,2357
12,15,9,6,2,17,61,1.178844191238656,30.599357844326885,2367
3,12,6,8,8,21,58,1.2908514537106102,29.86630536300644,2379
31,20,6,8,18,18,101,1.3228051578134292,29.669269070407058,2367
24,19,9,6,22,17,97,1.4358327517395675,29.148590129821066,2371
27,14,7,7,20,14,89,1.380208620273482,29.53453883184052,2346
21,12,5,7,22,15,82,1.3458744438877182,29.974430607950218,2349
11,12,15,11,24,13,86,1.3635930930371234,29.898219280226883,2360
12,9,10,12,19,18,80,1.4254264438907034,29.484453738242575,2341
10,13,10,9,8,18,68,1.326915321679773,29.715554781663684,2353
8,22,8,8,7,17,70,1.2550718705642294,29.86832435401142,2356
17,21,10,12,24,14,98,1.3919639537298512,28.812889817044315,2344
4,21,10,11,24,11,81,1.345499244341113,29.276031871475652,2327
7,17,10,7,17,12,70,1.21912156997501,30.287612712177783,2331
35,16,12,7,10,15,95,1.106147539651117,30.70853402304369,2292
13,20,10,10,13,18,84,1.0374470183942197,30.805090075695215,2276
11,15,8,9,12,15,70,1.0725440570914566,30.9790016600459,2299
6,9,5,8,5,13,46,0.998372805160488,31.966276317326244,2304
5,7,5,13,1,7,38,0.9425982517834406,32.00302824839678,2299
8,26,12,14,16,10,86,0.9549165878411772,31.346350843144915,2272
6,28,11,16,6,16,83,1.0334453346418286,30.63302385478101,2262
9,19,12,22,10,13,85,1.1458375702073456,29.763307696739975,2238
9,24,12,22,9,9,85,1.1783995910655696,29.831232346579352,2224
7,22,12,20,11,7,79,1.222403332649944,29.633055218692093,2198
31,12,5,23,33,9,113,1.2222098533340089,29.2356953489375,2174
10,16,5,22,26,4,83,1.1499784203211572,29.486235774529153,2160
3,17,5,18,8,11,62,1.191410395535376,29.690036795929572,2176
3,16,13,15,4,8,59,1.0203188022685061,30.083643525030098,2160
8,8,14,6,0,13,49,0.9498660990800927,30.871463929173135,2164
1,8,15,3,2,12,41,0.8914214618344443,31.28292897914575,2162
24,8,13,5,22,10,82,0.9538467989521159,30.680680436266943,2141
33,17,12,5,19,7,93,1.0105455829852246,29.010184750148074,2099
22,17,9,4,14,5,71,0.9815749980366972,29.198711882378213,2077
1,9,10,16,12,5,53,1.0360389861950403,28.972445927043683,2088
21,6,10,12,6,8,63,1.0672338445223815,28.927487290905443,2089
4,9,7,15,6,5,46,1.1275768392314278,28.684830873180598,2083
7,7,5,14,0,5,38,1.0791659414492911,28.930529250339074,2085
3,14,5,11,4,4,41,1.159161900447458,28.896523856225077,2087
1,18,5,12,11,10,57,1.1097217455441104,29.273553714460917,2093
9,14,5,9,7,10,54,0.9570563799490526,29.727056292700958,2098
2,13,5,8,10,5,43,0.7971055614922472,30.21578923254227,2098
3,8,7,7,8,5,38,0.687461919543523,30.633469274348673,2090
1,6,5,4,16,6,38,0.726498717475506,30.62551337984014,2098
2,12,5,4,7,8,38,0.6847056144278877,30.518776975331118,2100
1,13,6,6,10,4,40,0.8123529168018889,30.73952283273698,2133
6,9,5,3,7,7,37,0.7896225549052911,30.836925420758842,2144
0,21,5,11,16,10,63,0.9637856412032462,30.386876288286068,2137
10,19,5,15,9,6,64,0.9865140928019043,30.012543535585507,2124
2,19,5,10,9,8,53,1.0111208618689942,29.548617484984774,2113
3,18,6,3,7,8,45,1.091565797680453,29.244107132564814,2119
5,9,5,7,5,6,37,1.026231379406254,29.285762171148306,2125
5,6,5,8,0,5,29,0.8166942142012963,30.264579977029058,2144
5,12,5,2,1,5,30,0.7562118373784964,30.81083447021622,2164
1,7,7,3,0,5,23,0.7915607887898667,30.705062057603875,2192
0,9,7,4,18,8,46,0.8810748328480563,30.443423653608644,2174
15,23,7,4,17,5,71,1.0447469808431096,30.148786328843908,2184
23,19,6,6,7,6,67,0.9932849783183197,30.18024846365168,2177
8,21,5,6,8,5,53,0.9804181082258617,30.243167610649415,2185
9,10,5,3,19,6,52,1.1570761774854732,29.37150086640688,2193
9,7,6,6,3,8,39,1.1959254016574623,29.15798568714698,2198
7,10,5,6,5,5,38,1.0991612439086977,29.37535559034809,2209
10,11,8,5,6,6,46,1.0865298776092054,29.297639532409722,2204
5,9,11,6,15,11,57,1.1091008880328228,29.343854603096908,2200
1,11,10,7,16,12,57,1.0042840182526716,29.535463981447542,2196
25,23,8,7,9,8,80,1.2122647919911023,28.850325594977015,2175
11,22,11,10,8,8,70,1.3430059260890184,28.41638365559586,2161
10,19,10,13,18,8,78,1.2725671576100244,28.414703925707194,2155
9,11,8,12,3,6,49,1.1441510764983112,28.661010586161947,2163
12,6,10,14,3,1,46,1.0330238648123757,29.485909897496516,2178
11,6,6,20,5,2,50,0.9733866486528989,29.22438839766962,2178
4,16,5,21,12,10,68,1.026253562281634,29.21979746921453,2168
9,11,6,22,9,7,64,1.0092820135244098,29.511918485986893,2167
8,8,6,20,6,3,51,0.9842900636733503,29.627513741105375,2145
0,4,0,21,9,9,43,0.9564565171313837,29.58558577021619,2132
8,6,0,17,15,4,50,0.9903750682262522,29.45368740856814,2121
6,3,15,15,13,5,57,0.9820565369282372,28.85640274316767,2088
6,15,14,13,14,4,66,0.9422215154530024,28.601394965624845,2070
4,10,15,4,12,6,51,0.965604335432495,28.89664739598655,2075
3,11,14,3,7,5,43,0.9114604853797833,29.400791937563167,2081
0,6,8,12,7,5,38,1.0006675791938473,29.575450204707153,2102
3,7,11,14,1,6,42,1.016987026528922,29.37246780696312,2102
4,8,11,13,0,11,47,0.9915635778112938,29.52155832010342,2115
0,8,5,11,0,8,32,0.9224852201098266,30.09614365251679,2129
1,8,5,9,0,5,28,0.774128526926211,30.597419013521538,2124
5,12,5,11,21,6,60,1.0015105920345853,29.498378785062727,2121
5,17,6,11,16,5,60,1.086113721648234,29.907932146007443,2143
5,23,5,8,7,5,53,1.1975222741557576,29.972058407350186,2158
5,22,6,5,3,4,45,1.1642258351881822,29.815573538208483,2158
10,21,6,11,11,10,69,1.1818900992120862,29.506127110461854,2167
4,13,6,6,13,13,55,1.1283991126649753,29.90588824982779,2179
6,11,12,6,9,13,57,1.1340465241190592,29.8464868005268,2199
12,13,10,9,3,11,58,0.9902155474888908,30.084175290376766,2187
11,6,6,7,7,3,40,1.02518247459959,29.60154063878966,2213
7,13,5,1,16,6,48,0.9294489129849739,28.96033780206749,2211
15,9,5,1,6,6,42,0.8732713946958065,30.045313954833386,2222
5,24,5,5,6,7,52,1.0892850440325377,29.06543408424634,2225
10,20,5,4,1,7,47,1.18828708650775,28.811239225671148,2226
11,18,5,9,7,10,60,1.2681210861163261,28.549077896488278,2221
11,15,5,5,14,14,64,1.2742072616475306,28.049433060959828,2220
11,8,8,6,13,9,55,1.2084131648719458,28.106834961681802,2225
10,11,10,10,9,12,62,1.1545578261814213,28.59902286614429,2225
8,10,10,10,8,8,54,1.1256888128017026,28.40701317175609,2233
8,10,7,8,13,6,52,1.1700196700043204,28.387003728570217,2228
2,10,5,9,14,8,48,1.142536070823237,28.462000603968693,2230
23,28,0,8,6,3,68,1.2122770837011734,28.064245625413502,2225
5,20,5,11,1,9,51,1.2314969691719517,28.06588405657887,2232
3,13,6,14,22,5,63,1.3336044290319904,27.654904762876523,2237
3,11,10,20,27,9,80,1.4658775143880314,26.716011353359857,2231
8,9,10,19,16,11,73,1.5527728524770903,26.070570167844274,2253
6,10,10,15,7,8,56,1.5179977093507762,26.45063871856955,2255
7,20,10,14,3,3,57,1.4754963114279664,26.76630086491703,2280
8,7,8,11,16,6,56,1.5070872623195548,25.911941399718703,2285
5,3,6,13,17,5,49,1.4283506138065603,26.833231368023732,2294
7,18,7,19,7,8,66,1.259816659945115,27.583619850424633,2299
24,19,6,8,6,9,72,1.1624848188616546,28.51628360545785,2302
8,19,11,2,4,10,54,1.0915568554587372,29.50157916807636,2303
10,17,10,2,4,10,53,0.9492852510419073,30.925759359378514,2327
4,13,10,11,14,9,61,0.9853083010594557,31.156492731976254,2345
7,12,10,15,17,9,70,1.0937370737744045,30.916144600073434,2338
13,8,11,14,14,9,69,1.213977054941933,31.583561779145064,2322
12,8,8,14,20,8,70,1.2758396201138056,31.081884095267014,2301
19,9,5,10,17,6,66,1.2193926773720964,31.065987191788025,2296
4,2,7,9,9,5,36,1.1209696254347166,30.115307876998795,2288
9,16,12,8,7,3,55,1.1649963224558033,31.05749852391376,2285
4,26,11,4,7,5,57,1.1812278861033358,30.83080074500551,2279
11,17,10,6,7,4,55,1.2797903612955108,30.40701726941355,2277
4,12,8,8,12,5,49,1.2519424239769519,30.237875604889037,2293
7,6,9,6,5,3,36,1.2288441815676765,30.415328208535268,2289
3,6,11,4,4,6,34,1.2302617295573486,30.51945426545296,2320
9,9,8,4,9,5,44,1.2156590106098966,30.887304127225388,2350
8,10,7,10,4,3,42,1.167335819071665,30.103574286225903,2369
12,7,10,9,13,5,56,1.1924606233360648,30.021113899201666,2385
6,25,9,3,25,5,73,1.2664778408594175,30.23876400657425,2402
6,20,10,4,24,8,72,1.224247185209237,31.07842755137498,2426
3,15,8,1,3,5,35,1.0093629588401278,32.16233183102364,2453
8,7,5,2,7,4,33,0.9886288772281441,32.54057179678205,2474
3,5,5,2,5,2,22,0.8463912105148034,33.93453038127677,2504
7,5,5,0,7,5,29,0.8061304141788025,34.79541519177786,2520
2,12,5,5,4,3,31,0.8208180496175993,35.37119087942596,2547
5,13,5,8,7,3,41,0.834206453564866,36.16882033224167,2567
7,14,6,3,15,2,47,0.8396658919268092,36.88168287067067,2583
0,18,6,8,7,5,44,0.7800891379766504,37.21500230582482,2589
0,19,11,2,0,4,36,0.686093191946131,37.14573637711746,2610
2,11,6,12,0,2,33,0.5953101240100448,37.25567652203258,2622
2,2,7,9,11,6,37,0.6135302523392492,37.146767642499206,2625
5,7,8,8,4,5,37,0.5699223387443676,37.731493922410806,2633
2,7,12,7,9,3,40,0.7001275302635682,36.938513007717646,2642
3,13,14,11,5,5,51,0.6281193402001914,36.82019162913864,2619
3,13,12,8,7,3,46,0.6057258721705465,36.693606932818255,2621
2,11,10,6,3,2,34,0.637817693574128,36.62674862118771,2625
0,20,8,8,1,2,39,0.6287439090909829,36.91742323264896,2624
0,6,13,6,0,3,28,0.4997369648992096,37.38966953610377,2629
0,13,9,17,0,4,43,0.528271641782644,37.17446943691288,2630
0,5,12,20,4,2,43,0.520025443522092,37.10796791959026,2636
0,5,4,17,7,2,35,0.5102691454165135,36.296337834742054,2617
3,4,7,18,1,4,37,0.4884379693555617,36.41766974385188,2613
1,14,5,17,0,3,40,0.5178525179699697,36.30057744734435,2597
0,3,5,17,2,2,29,0.5159677626721276,36.40675554330854,2592
0,9,6,21,0,1,37,0.46515726576656136,36.28793556989328,2573
0,2,6,15,0,4,27,0.5117564794462539,36.23649308701871,2576
0,4,5,14,0,2,25,0.45949397952576776,36.44836982063461,2577
0,4,7,6,0,2,19,0.4727585725136367,36.69904540139881,2591
1,1,13,3,10,5,33,0.5186082052249317,36.47377974727647,2598
1,3,15,1,11,6,37,0.5979223290028148,36.28228505132287,2597
0,11,9,4,10,4,38,0.5822446550265701,36.519375469676774,2600
6,4,5,15,11,3,44,0.6143338898742504,36.12629087233665,2615
1,3,3,16,13,1,37,0.7091223824120609,36.14254494027567,2621
0,2,0,12,0,4,18,0.7128631097818153,36.30749261788821,2632
0,0,2,9,0,6,17,0.8050695590596492,35.692120813035224,2651
0,7,0,11,0,5,23,0.921316037342824,34.81884965868131,2657
0,14,0,12,0,5,31,0.9078367710439055,34.92288054985579,2685
0,5,0,13,13,4,35,0.9877188037442504,34.99374720017256,2694
0,8,3,6,12,3,32,0.9845003417158283,35.41036972738839,2711
0,7,9,8,7,5,36,0.9556078486789351,36.291536159777515,2736
0,6,5,9,4,2,26,0.905356952182965,36.584227198215984,2749
17,9,5,9,6,5,51,0.9270581558359993,36.42134813941298,2753
5,7,6,9,17,5,49,0.8806971089263853,36.6571292370959,2755
0,12,6,7,13,6,44,0.8158545028538707,37.35799903752101,2753
0,6,5,6,16,5,38,0.7062431805397168,37.37586822605281,2749
1,14,5,1,17,5,43,0.6595263074512997,37.29909540640291,2758
3,5,6,3,10,4,31,0.6069994367712271,38.327838077962085,2760
1,6,9,3,0,5,24,0.4971251120223561,39.077203823813456,2775
2,4,10,5,0,5,26,0.48766741181881496,39.821959638226026,2790
1,7,8,3,2,4,25,0.4629423029228953,40.00006356447476,2794
0,9,6,1,1,5,22,0.44625867620076143,40.14647417958254,2810
5,7,10,0,20,3,45,0.5153168963450179,39.91773361854306,2816
1,12,8,1,18,7,47,0.5015846261327154,39.864902424663995,2829
0,4,6,2,2,5,19,0.5047729587151926,39.987844794603625,2837
0,16,7,6,3,4,36,0.5574291009389372,39.72463748129287,2833
0,8,10,2,3,4,27,0.488395342988035,41.37940882193516,2855
1,5,8,8,0,5,27,0.4567047047425552,42.4786929838464,2875
23,7,10,10,18,1,69,0.46211416318847626,41.45602173859312,2857
21,7,10,12,14,3,67,0.3905769145510029,41.45628761208786,2835
9,8,11,5,5,6,44,0.35534276936292253,41.95199730639403,2828
0,7,11,7,6,3,34,0.3548462588998549,41.54029254280519,2825
0,7,14,7,0,4,32,0.49596906137816,40.3780043657673,2840
4,2,12,8,0,3,29,0.5190962332896373,40.69199359368929,2838
4,8,13,13,2,3,43,0.5871533605456957,40.43372955809566,2840
4,7,14,6,2,2,35,0.5843324523490381,40.62789388214515,2845
0,3,13,10,17,2,45,0.5570828514017674,41.071106901092726,2832
15,4,13,16,16,4,68,0.5536112704681416,41.16839048287072,2828
13,5,7,21,10,5,61,0.5872226431566936,40.75697760133367,2810
2,4,5,21,9,5,46,0.5601249984994775,40.37728017285338,2784
5,6,10,19,11,4,55,0.6616911368476284,39.456998140779866,2774
1,5,10,20,2,4,42,0.6448276335668292,39.42234960168031,2768
11,5,8,21,4,19,68,0.6721149079236267,38.50781671696156,2745
11,13,5,7,11,17,64,0.7035088825212648,38.05400205751794,2732
4,9,5,2,19,18,57,0.7635227669498832,37.19904774090917,2732
15,9,5,16,8,18,71,0.821562604304573,36.56345875802416,2703
2,9,5,14,8,20,58,0.9022170851670083,35.969227173417565,2694
3,27,5,11,11,17,74,0.951307285411892,34.954528976950265,2661
5,35,6,9,10,16,81,1.1675922783176134,33.39312457445603,2634
5,26,6,10,0,11,58,1.1484034979635982,33.772854839633276,2632
13,22,5,4,0,11,55,1.107005419473935,34.568555556991065,2639
6,10,6,15,8,10,55,1.057787006805287,35.368422113444225,2653
21,9,5,11,24,12,82,1.135177016219553,34.38795865835222,2649
26,7,9,5,24,14,85,1.0467207980302964,35.122766628425296,2633
23,11,3,6,15,19,77,0.9884033578523723,35.64257076966502,2624
9,14,6,7,12,14,62,1.0355836508033545,35.62197338804136,2637
8,26,9,5,19,16,83,1.152268512111022,35.19575674523973,2648
10,26,6,8,19,20,89,1.1777242414656122,35.72814370652221,2665
10,24,5,6,9,18,72,1.0919871629258062,35.473322329498245,2658
7,27,5,2,9,12,62,1.0650250373216494,35.573316118610826,2659
12,21,8,0,20,8,69,1.185188293604039,35.066410590762665,2658
3,19,1,0,15,12,50,1.0499486231997557,35.52589827823977,2678
35,19,0,14,10,12,90,1.0204136766679583,34.96027991851036,2652
15,13,0,10,17,12,67,0.9112956155470744,35.67990199425157,2650
14,11,0,11,17,9,62,0.8498485424134525,35.764233715309366,2645
3,27,3,11,18,8,70,0.9370093969447044,34.39564894784532,2627
6,28,6,7,16,9,72,1.0327818157917819,34.02837761520486,2609
4,16,6,8,16,12,62,1.0701538293478872,33.44461470585305,2606
4,21,11,5,12,7,60,1.005803080320702,34.02237073468924,2604
5,10,9,0,9,7,40,0.8892931867953254,34.844815237622385,2625
8,10,8,3,6,10,45,0.8271019734205068,35.512006712994044,2647
1,11,5,18,4,8,47,0.7065596332986683,35.88056740285057,2659
13,8,10,18,0,11,60,0.7679261933277918,36.74550174535875,2652
0,10,10,23,3,6,52,0.7326894397712245,37.69993692135195,2649
7,21,10,23,17,7,85,0.8382829258351557,35.17469412642884,2605
3,22,10,18,20,6,79,0.9657026869854722,34.793453711121565,2586
5,18,10,18,16,7,74,0.9347112752695454,34.81038276223011,2569
5,19,10,15,11,6,66,1.054679316306395,33.932139808366976,2569
5,13,10,16,5,12,61,1.079914741399455,34.16197173127,2573
9,9,10,14,6,13,61,1.1776781038619248,33.61533614849348,2576
10,22,14,11,7,16,80,1.173469319743382,32.731916326539874,2574
12,21,7,13,13,16,82,1.210773927263567,33.61637002459161,2602
7,21,9,10,5,12,64,1.015878647284649,35.2663851820161,2611
6,11,7,7,7,6,44,0.9268092821419923,36.72077364504835,2636
21,8,5,4,18,3,59,0.9036683190208781,35.197257317196694,2644
4,2,9,4,10,7,36,0.7949552040607898,36.905956181081876,2657
8,11,6,5,8,5,43,0.7091276541422173,37.06154956390226,2662
3,10,5,5,7,6,36,0.7397714840924914,37.27478774454833,2669
6,12,5,6,7,10,46,0.8399435516640462,36.25404344571246,2678
7,22,5,3,22,7,66,0.9598439297435876,35.823507063330375,2673
6,23,5,6,25,6,71,1.0413124512335727,34.910880255869685,2678
9,23,5,8,9,10,64,1.10461171798055,35.613669582118945,2691
9,11,5,4,4,8,41,1.0358716888704926,35.76136650020864,2688
1,7,10,1,4,10,33,0.9219192247591235,35.95632379860661,2700
7,10,11,2,18,12,60,0.8748963117598642,36.14086992170282,2723
9,7,9,4,16,14,59,0.8228732380174418,35.93749471512082,2732
12,10,8,2,8,12,52,0.7930399718972642,36.66467583523155,2754
4,8,9,3,5,5,34,0.8046791547514461,37.77686465762134,2764
5,24,12,3,2,7,53,0.8679180083926376,36.44677532138063,2760
0,33,13,7,3,11,67,0.7823686268993609,37.510567994654146,2754
23,22,8,6,24,8,91,0.8817041880599561,36.23842669905786,2747
25,8,10,3,27,7,80,0.8245287212649033,36.50105197790081,2722
22,4,6,1,17,5,55,0.7177053015808195,37.444835353894014,2725
1,8,13,16,15,9,62,0.627282693237282,38.287456084424015,2719
22,12,9,18,4,3,68,0.6251486543905947,38.125708279895775,2687
2,15,11,22,4,8,62,0.6697317842832113,37.34132554152754,2673
1,8,15,21,2,7,54,0.7678527046946488,36.50897953624682,2646
3,24,15,22,0,8,72,0.762816481224895,36.385424379343114,2626
0,20,13,22,17,5,77,0.7497514414114677,36.217252930132865,2596
14,15,9,6,18,7,69,0.7703106277280015,36.43152340610544,2587
12,13,9,3,9,4,50,0.7081169884614607,36.676133545794755,2589
2,5,5,9,10,5,36,0.5639814911336496,37.089660208967835,2571
5,7,5,5,0,6,28,0.6230495863180558,37.07100811815238,2576
0,20,5,6,0,8,39,0.5663331427595577,37.37618509268269,2568
2,17,5,7,0,6,37,0.5201416657357099,38.10367483816508,2572
5,12,7,5,0,7,36,0.46305227373713687,38.33494268159643,2574
1,8,6,6,19,8,48,0.437616349055599,38.62266991105425,2574
14,9,5,5,7,5,45,0.4094589394747763,38.50036691317244,2559
1,7,6,6,8,5,33,0.4801315505722953,38.26277320002246,2556
2,18,5,6,9,7,47,0.5758315171075667,37.57660532246876,2538
11,16,8,6,0,5,46,0.7073555585274748,36.725982682443,2541
15,12,11,18,6,5,67,0.7727465369767202,36.368718997911834,2524
12,7,7,21,7,6,60,0.8878759155355013,34.819243647561976,2516
6,8,5,22,9,6,56,0.9590514437898332,34.00840024047246,2494
11,9,5,23,15,6,69,0.9135687854632553,34.01015666173469,2480
16,16,5,17,5,8,67,0.8266589596756433,33.739078006629214,2451
2,19,5,4,9,11,50,0.781866917641928,34.00456836033684,2444
2,17,5,4,9,9,46,0.7005171979482597,34.27219473377744,2427
6,6,2,1,19,10,44,0.7595746987954582,33.80420568163028,2434
6,13,6,3,3,6,37,0.8723192832651352,33.26281856335771,2432
8,8,10,8,1,7,42,0.8552068969422445,33.098055295393046,2426
5,13,9,2,2,6,37,0.9171950320577096,32.78146928174916,2433
8,9,6,6,3,10,42,0.864671306942981,33.06113870905348,2437
2,16,9,4,2,8,41,0.7892308044133903,33.573431946348,2427
12,8,4,14,17,6,61,1.0266787044319532,32.495069962173844,2429
20,9,6,14,8,9,66,1.174939453253532,31.514084325040173,2413
9,9,6,12,9,8,53,1.2260703101436663,30.898797792833243,2405
9,9,5,11,10,4,48,1.2202307969833828,30.595322015421342,2408
7,11,6,11,21,7,63,1.2009256165884326,30.135765374614188,2406
7,13,9,8,11,5,53,1.2238262905997093,30.76406643050304,2412
11,20,6,8,4,5,54,1.3170846229258897,30.971568218178703,2429
7,5,5,7,6,8,38,1.1293938363249063,32.11511503308027,2443
7,22,5,8,16,10,68,1.092638563818214,32.50684268209307,2443
5,19,5,7,5,11,52,1.08073935541942,32.608947578283534,2469
12,8,5,5,8,8,46,1.087715886301121,32.958262135598595,2492
6,7,5,2,16,5,41,0.9027816036823264,34.00298104949567,2478
9,11,5,2,16,3,46,0.888994811974624,33.65017594502247,2468
14,9,5,0,27,6,61,0.8634673142731408,33.8910054029795,2476
7,9,14,0,28,8,66,0.805481349580034,34.63217685697453,2466
8,25,9,0,9,6,57,0.8433975800893587,34.497036555833084,2470
5,15,8,0,12,6,46,0.8454333898902178,34.74967609506936,2484
7,19,7,9,8,10,60,0.770513978833936,34.70631939072574,2481
6,6,8,5,4,13,42,0.7087012892824907,35.262817675629364,2507
4,10,7,6,14,13,54,0.6696446696514962,35.468909368247495,2502
24,7,7,5,9,6,58,0.6364094460914113,35.89318231020576,2493
15,8,7,6,10,7,53,0.61564736470348,35.570393981837405,2480
5,8,4,6,12,7,42,0.6440590628509206,35.33447969909273,2474
9,10,6,5,6,7,43,0.6817905089158268,35.106986911526235,2477
11,23,5,4,4,8,55,0.7719163107211013,35.06111005147504,2491
14,10,5,1,5,6,41,0.8088762693178517,34.77813236324146,2502
11,15,8,16,11,6,67,0.9362934378897679,34.48388685347908,2507
11,16,10,21,12,6,76,0.9810936060571511,34.10308990133557,2486
15,7,11,24,5,9,71,1.006859014327024,32.34634526396183,2445
0,8,16,21,10,11,66,1.058559414830419,32.332652694343366,2421
12,11,10,21,10,8,72,1.064974896408043,32.85431686676658,2398
9,9,14,22,13,10,77,0.9164884601942572,32.64186379227132,2372
8,11,12,11,8,10,60,0.8603573646677733,32.614130978947124,2358
3,9,7,5,8,7,39,0.7967722927898591,32.82510009454719,2367
7,9,8,5,4,8,41,0.7293185805992181,33.44778692888759,2368
4,17,7,5,7,7,47,0.7582057264737859,33.00790015219138,2367
2,21,5,9,6,8,51,0.8369514832624152,32.14161078031077,2361
6,13,5,13,19,10,66,0.958877306628091,31.319523513518366,2348
4,16,5,16,5,8,54,0.9757681927571333,31.45820265183454,2348
0,10,6,12,6,6,40,1.035185057872315,31.418793307194843,2347
5,8,5,10,3,5,36,0.909617926422939,31.503905963250944,2319
2,11,5,8,9,6,41,0.8589702650955396,31.77561056018415,2312
2,13,5,7,8,5,40,0.8173254891457368,32.240779738796775,2316
3,13,10,8,13,4,51,0.8321569356752663,32.69238303949795,2322
2,22,9,6,5,5,49,0.8361898011105289,32.01036056793087,2328
2,8,9,7,6,5,37,0.8758495944791832,32.15220483892907,2335
5,16,5,8,5,3,42,0.8694369657510238,32.398163440275425,2334
5,7,5,6,0,2,25,0.819954284836433,32.46131241054644,2337
6,2,5,5,0,1,19,0.7610066173539533,32.27374207139095,2341
6,2,5,0,1,5,19,0.7658930754299685,32.3584403721869,2346
3,10,5,0,14,7,39,0.7667139941010026,32.66917152959163,2358
5,6,7,1,11,5,35,0.6507443716310523,33.19366349402644,2366
2,11,13,0,7,6,39,0.6574234824134556,33.11186002204296,2367
2,25,9,0,6,4,46,0.7662848631272593,32.93465906896636,2385
2,12,8,7,10,5,44,0.7891542253783833,32.16536301270473,2374
3,15,5,9,11,4,47,0.8332688707277103,32.21538343216268,2383
3,8,7,8,17,3,46,0.8530253509947897,32.012832797972614,2402
5,5,11,6,19,5,51,0.8882405010376252,31.764971290040805,2404
3,4,11,5,17,4,44,0.8128589991138532,32.53427207748907,2418
1,11,10,6,11,3,42,0.8107802860788365,31.747245111630892,2401
4,14,11,6,17,6,58,0.9231799197567245,31.15973450142148,2410
1,7,7,9,6,5,35,0.8185886277808836,31.805209866014838,2413
7,22,13,12,1,5,60,0.9963423729026223,30.701622504668798,2409
4,5,9,15,1,5,39,0.9361969684876422,31.04838198427904,2401
5,17,6,21,13,5,67,1.0650598274648442,30.904775667055876,2408
5,8,6,21,11,5,56,1.0814162688918216,31.27737545506166,2417
6,7,5,23,0,6,47,0.9050917155018533,32.13538150648152,2401
4,11,7,18,0,6,46,0.7955252047891159,32.71444939932015,2399
5,11,5,22,0,5,48,0.700557552210343,32.89776600716668,2386
9,11,6,8,0,6,40,0.7746298744427511,32.85283533863581,2391
4,9,7,6,5,5,36,0.6445961714552627,33.57266594343261,2400
38,23,5,4,1,5,76,0.7737182600144996,33.35940352999276,2370
7,8,7,17,17,3,59,0.8607993510875249,33.04621236473892,2357
20,12,10,14,19,3,78,1.0417765598424513,31.910392995413478,2342
20,9,10,13,7,3,62,1.0973864398506172,29.734069136769733,2314
10,7,8,16,9,4,54,1.0861288803960298,29.992016928524333,2317
12,4,5,14,7,1,43,1.0407138053415042,30.224830401877796,2324
3,10,5,13,11,3,45,1.0608565630874487,30.43667434398773,2311
7,2,7,10,4,5,35,1.0630600292174568,30.732569944288887,2322
8,8,8,7,6,6,43,0.9425572915823037,31.385954810443547,2326
6,7,5,7,7,5,37,0.9175526332488977,31.685010088172206,2344
3,6,10,2,9,1,31,0.9134818864290609,31.419535265420958,2342
2,3,8,4,18,4,39,0.9421691837561944,30.4355090455532,2331
0,7,7,0,16,6,36,0.9045338234219086,30.689316950870747,2318
0,6,8,2,13,5,34,0.940736285111382,30.57901684986105,2332
1,7,6,1,8,4,27,0.8966470233758589,31.24798599049218,2352
0,22,10,0,9,4,45,0.8828787705442194,32.02228949382114,2357
5,11,10,1,21,5,53,0.9097112949016934,31.853845546455545,2367
5,12,6,5,24,3,55,1.0221273487521525,32.39893371267934,2385
5,5,3,0,12,3,28,0.8205494281305221,32.92623721567457,2402
0,3,10,1,0,5,19,0.76023203850576,33.039894574838854,2411
1,8,11,5,5,4,34,0.7204401432968113,33.25347465048724,2421
6,14,10,5,5,4,44,0.7103179204672692,33.76536467277849,2437
4,15,10,7,2,5,43,0.7503331289254538,34.577909820407015,2480
6,13,5,6,2,6,38,0.7249810244759286,35.044238778217654,2495
6,23,5,5,5,5,49,0.7157894577492755,34.96209881861721,2498
8,9,6,9,3,3,38,0.7209123870047474,35.2030685625873,2507
16,14,5,12,18,4,69,0.8754389956354189,34.2756810226517,2507
16,6,6,9,17,7,61,0.8384360520966868,34.025421310512954,2495
18,9,12,12,10,4,65,0.8029951986360887,34.21401985643206,2509
6,6,12,10,8,4,46,0.6894557879497586,34.904284397751844,2520
15,12,12,7,17,5,68,0.7528734011037574,34.69951798207102,2508
4,10,10,7,10,4,45,0.7033666559995735,35.08751773995023,2524
8,11,12,6,3,5,45,0.7579086375395112,35.14418325284574,2542
13,22,6,7,5,4,57,0.734387085661541,35.49059612951958,2549
7,10,15,5,10,6,53,0.6996639857894212,35.04793980338049,2538
6,16,14,8,11,4,59,0.688639858570695,35.41518576433258,2523
11,6,15,18,8,5,63,0.8117275889414992,34.6107684120665,2507
10,6,15,19,6,6,62,0.7874354686097906,34.15787059020928,2473
3,9,13,19,7,5,56,0.8310735161275457,33.26684835984515,2457
4,6,12,23,19,3,67,0.9124758818760262,32.88251986247587,2439
5,14,8,21,8,4,60,0.9028003411417802,32.907810379169376,2434
9,1,5,22,4,16,57,0.8681365718933229,32.90515120233948,2426
11,17,5,15,2,18,68,0.8260123573069399,32.83720551047945,2413
6,15,10,2,19,18,70,0.8725316657045812,32.476554169726526,2400
17,14,5,15,7,20,78,0.9311819477073194,31.91504432701855,2378
4,18,5,14,9,19,69,1.0338835456524218,31.29319461078519,2363
3,15,5,10,10,18,61,1.1278149925154837,30.701393875423552,2352
6,17,7,8,12,18,68,1.2353235849356132,29.608169989308376,2337
6,20,5,12,7,18,68,1.2436905536007261,29.814887644656903,2323
5,24,6,8,2,15,60,1.1585467969820393,29.998385302516144,2308
2,14,5,12,3,17,53,1.111339914429658,30.53167569349693,2321
0,14,5,5,11,16,51,1.1283190070220486,31.159213812304912,2348
5,16,5,9,6,18,59,0.9415197484318376,31.650385413804006,2325
0,15,5,8,9,17,54,0.896489597633304,31.659366269903988,2315
4,12,5,6,7,16,50,0.747189780977853,32.712707639004485,2312
4,13,5,2,17,16,57,0.7682069453373757,32.66963508692868,2316
3,7,8,4,11,12,45,0.8037662133484036,32.38872624392161,2329
4,9,3,13,7,17,53,0.8260127055133553,32.381004588700065,2326
8,23,7,7,6,16,67,0.9230288728493508,31.151944108000368,2322
0,17,5,8,7,11,48,0.9572038530543219,31.316337890158742,2320
17,23,6,7,12,5,70,1.0857338655683075,30.82478949449978,2336
4,15,6,4,11,10,50,1.085390678920215,31.059979542596867,2341
4,16,12,1,9,10,52,0.98771514693252,30.216721997987563,2368
3,14,13,10,8,5,53,0.859683050488499,31.615595883620653,2379
1,11,13,12,5,7,49,0.9087599232010521,30.988718091386147,2394
6,12,11,3,19,6,57,1.0155417451633377,29.962524218490298,2413
5,11,10,2,9,5,42,1.0827603682305544,29.928976613850224,2423
4,19,6,17,0,5,51,1.063799356659097,30.58649705839653,2422
7,7,5,21,0,5,45,1.0694386925754948,31.03248157488848,2429
2,13,5,20,9,12,61,1.0314252045689487,31.415694022369113,2427
9,16,6,21,9,13,74,0.9070487783844741,31.246029249090412,2419
2,11,8,21,10,12,64,0.8848778898368553,31.404359872186177,2410
3,10,7,21,12,1,54,0.7917936664746065,31.922938650201115,2409
3,10,5,19,10,5,52,0.7625336749751044,32.59847121227552,2399
7,8,8,17,6,6,52,0.7640929235939851,32.343009613876255,2388
4,8,6,14,7,8,47,0.8046878563240842,32.01598331477503,2388
6,21,10,8,6,5,56,0.7978938133972462,31.841759656080082,2392
5,11,11,9,1,8,45,0.824082594344164,31.62439706334177,2391
5,15,11,10,9,7,57,0.9123105988629538,30.95731441241431,2381
0,11,14,8,5,5,43,0.918623128981077,31.233816972310528,2377
12,6,3,11,6,3,41,0.9282563296054824,31.04697620885892,2376
5,3,5,7,3,6,29,0.935569089354601,31.25825987078812,2385
4,12,5,7,6,6,40,1.049389154798273,31.066425039917704,2390
14,8,6,9,6,6,49,1.0621042625285584,30.35807869928883,2379
10,15,5,14,6,8,58,1.1433311706891027,30.05698361748076,2376
10,8,5,12,7,5,47,1.2350289729309119,29.66648770544141,2374
15,10,6,17,10,3,61,1.343184072249329,28.637291818880833,2366
15,3,5,21,9,12,65,1.3279130455511903,28.071037371222655,2334
7,13,6,10,6,11,53,1.1518800846396333,28.881799109404387,2333
1,11,11,4,9,10,46,0.9586434319542054,28.779932728036755,2311
18,13,13,2,6,6,58,1.0478114610571305,28.703171253223637,2309
8,5,13,1,10,9,46,1.017640129103333,29.347956064412823,2304
8,6,7,2,6,6,35,0.9654625197480894,29.672189814616132,2303
10,8,7,7,22,5,59,0.9512951881462598,28.84049905589207,2288
10,11,5,3,11,7,47,0.9903335698222965,29.38123787896267,2309
9,5,2,16,4,4,40,1.14898482876629,28.923344143701964,2319
10,11,5,15,3,7,51,1.2402737585584207,28.37649959954959,2318
13,8,5,16,2,10,54,1.2121839924384583,28.29543000102924,2313
8,9,6,11,4,12,50,1.1654354718958464,28.521543326824105,2317
2,11,5,12,8,13,51,1.1669094000559757,28.578393980494614,2313
19,13,6,11,10,10,69,1.2037094456149948,29.029055752438442,2304
11,10,6,11,9,11,58,1.1245846896255958,29.687076642900287,2328
5,13,6,7,16,5,52,1.0248322281365791,30.318007165147016,2345
1,6,7,8,14,3,39,0.8179595704771855,31.339910521657075,2350
0,3,11,8,1,5,28,0.7859326116265135,31.483721077911692,2369
0,6,11,6,0,5,28,0.8565357834832786,31.589495320418933,2370
5,12,10,5,22,7,61,0.9615185812856797,30.791620097311558,2378
4,9,10,8,23,5,59,0.9921423028054884,31.029206480108115,2393
3,11,10,6,5,7,42,0.999750699637998,31.18273724250255,2402
1,25,7,8,0,7,48,1.000382614913834,31.516119662429983,2408
2,15,5,6,17,11,56,1.0502658721950109,31.080800355714626,2393
5,22,5,8,22,14,76,1.06596346369286,30.652552190006766,2388
23,15,5,8,16,14,81,1.0079898059175467,30.84061920223587,2407
18,8,5,7,23,8,69,0.8722521256866598,31.59116123001793,2392
16,5,5,4,12,4,46,0.8690227076368257,31.6666665543934,2415
3,10,6,8,12,4,43,0.8521117029583509,31.805319980315645,2416
1,10,5,4,6,6,32,0.8724187512810262,31.653669051797042,2420
3,10,5,5,2,6,31,0.8871629951407994,31.592627989921994,2434
8,19,9,2,2,6,46,0.9481862795095521,31.61735763334091,2441
0,11,15,7,5,5,43,0.9637932258725291,31.488948439544338,2439
14,17,9,10,23,6,79,1.153652014556957,31.174631155187324,2444
25,13,12,14,22,5,91,1.046802997639977,31.009207967819158,2434
22,8,11,11,6,8,66,0.9295967207975844,31.65013597474333,2431
6,8,13,9,6,9,51,0.8238995246871741,32.09198594724976,2432
2,14,7,10,23,4,60,0.8114185887554071,32.23832119711659,2429
0,8,12,13,8,3,44,0.7946779388214733,32.40861215958589,2440
0,9,11,15,0,5,40,0.7783352413739961,33.18795352046017,2449
2,21,10,18,0,7,58,0.8095310821765341,33.24865718150507,2435
0,9,11,17,2,13,52,0.7623555625362822,33.424119614636986,2423
1,17,14,16,14,7,69,0.7594846653953904,33.539308144103224,2406
11,11,15,11,7,5,60,0.7091852522356951,32.8661956177173,2378
1,8,15,21,9,8,62,0.7651762533212767,32.590905951566455,2351
3,10,15,22,11,5,66,0.8406938927261088,32.10070783472116,2315
2,12,15,23,2,10,64,0.8859677543721235,31.438833360602672,2293
4,6,16,21,0,8,55,0.857314992254707,31.55591121354711,2272
7,14,11,22,0,10,64,0.8736723452914261,31.220288397789158,2261
11,11,5,18,1,8,54,0.7926450798554847,31.522604601153926,2257
2,10,9,17,14,8,60,0.7498173434064661,31.646900801028988,2252
10,8,12,14,9,9,62,0.7001958357689995,31.246096686932873,2221
1,8,10,13,7,9,48,0.7368948341913334,31.308792596584894,2218
6,13,8,6,6,7,46,0.7301680426330424,30.799330211421807,2198
6,8,5,2,9,6,36,0.7392781990375064,30.800621454206297,2190
4,13,6,7,1,3,34,0.7184178723996668,30.338059108739664,2169
5,7,5,16,1,3,37,0.7451158783504738,29.923057970456373,2149
5,6,5,17,0,5,38,0.84956639805501,29.327677639709282,2145
0,7,6,16,8,5,42,0.8921086095092405,29.07523164975962,2136
3,4,5,14,3,5,34,0.9100287300897228,29.24316515890172,2135
2,8,5,12,3,5,35,0.9273136714318579,29.15374391607729,2133
7,11,5,11,5,6,45,1.0033633327871285,28.707131618086073,2121
5,14,3,8,10,6,46,0.9794047978676846,28.7068555917081,2111
7,11,0,7,9,5,39,0.9357123124760318,28.891465152843324,2137
25,20,1,7,8,4,65,1.2318571771767632,27.429478940504648,2134
6,20,5,5,7,6,49,1.2774774488366563,27.410948121495306,2146
9,14,7,8,7,4,49,1.2281871186169813,27.776139824094937,2141
4,9,9,6,9,4,41,1.1855307507658088,28.168608377392403,2161
4,4,7,10,18,0,43,1.1113730283079137,28.24469384105644,2186
4,1,8,12,16,3,44,1.0891706969327295,27.98842452140516,2174
9,19,11,16,12,4,71,1.1361998685446242,27.56532469389601,2156
6,8,12,13,16,4,59,1.108046422273366,27.879068663169623,2159
0,9,10,13,14,4,50,1.0338230436881584,28.120666152094614,2161
2,17,11,13,24,2,69,1.181015132801329,27.045687318488387,2149
7,3,15,7,28,2,62,1.2017942841718328,27.464328268158567,2155
8,16,5,8,21,3,61,1.1877172827500855,27.295153865646856,2165
12,9,11,8,3,2,45,1.1975046685714625,27.632725451811506,2189
7,2,10,7,18,2,46,1.0941232471981126,27.999303036742404,2199
7,3,10,7,17,3,47,0.9233817273839039,29.47801479473997,2243
6,10,10,7,6,5,44,0.8326775504841072,29.679131656321896,2257
9,10,10,7,8,2,46,0.8737034509403138,29.71666128776102,2276
6,9,11,6,3,2,37,0.7958021530494214,30.53906979034131,2287
9,17,10,14,2,3,55,0.8820421371093171,30.173032782968406,2293
13,8,10,6,6,4,47,0.9091303564365254,30.600903867125844,2310
5,12,12,6,16,5,56,0.8485436883046895,30.87483871599889,2321
39,6,13,5,9,3,75,0.9069902035576419,30.404623786210983,2314
28,3,14,5,7,5,62,0.8382814961648852,30.656704772546924,2314
9,6,11,6,9,2,43,0.7117317845512415,31.349775374795037,2314
11,10,11,0,14,3,49,0.7385442454220724,31.275722906987355,2324
5,6,11,1,16,4,43,0.7029319887629345,31.51366150693011,2314
6,7,12,6,9,4,44,0.7244701114095977,31.001067629865926,2298
6,3,8,16,9,5,47,0.8089821806715471,31.100826512798033,2291
7,7,11,20,8,4,57,0.7664489519393419,31.21202487376958,2263
2,6,12,22,8,3,53,0.7861845670074012,30.522742448110833,2254
3,8,10,18,10,3,52,0.8240764247620183,30.033205827388304,2246
7,2,8,18,9,1,45,0.8771716406678962,30.187113627719334,2247
8,6,5,19,9,2,49,0.8616170609705076,30.256605422960796,2233
7,2,14,14,11,1,49,0.738573243620299,30.25699482050012,2222
6,4,15,3,20,2,50,0.8251509640208521,29.64629703022101,2219
9,3,15,4,16,3,50,0.9074574350891694,29.424250302660283,2213
10,11,11,1,15,4,52,0.9080939128742149,29.60717336846764,2215
13,5,9,4,12,5,48,0.9639097923353591,29.325684162551752,2240
5,9,14,4,8,4,44,0.9726011620632313,28.76228872675074,2245
2,6,17,11,6,4,46,1.0359124265612263,28.736644264260857,2251
0,6,15,11,7,3,42,1.070844246661341,29.079358121478975,2266
22,4,10,12,3,3,54,1.0406262352551148,29.02708427218058,2257
4,11,11,13,4,4,47,0.9619558809766124,29.43438406203462,2252
2,9,10,10,14,18,63,1.0986419297703391,28.054542737131186,2265
3,16,11,8,21,18,77,1.3664927574046968,27.362942089658887,2257
4,20,10,6,13,15,68,1.2833430426045151,27.44950027306851,2257
5,10,10,7,2,17,51,1.3132461799909676,27.535555645114375,2271
8,24,10,10,0,13,65,1.3413081307740897,27.337774546445573,2278
6,25,11,7,8,18,75,1.5226076163184727,26.391194580590795,2275
8,23,8,3,6,16,64,1.5132521939708912,26.573391473973807,2293
12,21,6,3,9,14,65,1.4301155355140027,27.313830720374117,2302
7,13,6,5,9,16,56,1.24757200366257,27.80753513605616,2306
6,14,10,16,3,16,65,1.250253750816948,28.542831015057523,2313
19,8,5,8,17,14,71,1.1586326305391057,28.665664013690193,2315
5,21,8,6,14,14,68,1.2597242402585627,28.625461888846687,2336
5,19,10,0,11,14,59,1.1913353020743938,28.576020826220997,2320
4,25,7,3,8,11,58,1.0848112046802578,29.710141332744247,2319
0,23,5,5,7,14,54,1.1224517048312708,29.66509894728493,2317
6,19,6,9,20,18,78,0.9938226803975181,29.82276181759469,2308
6,20,1,5,25,16,73,1.0910756899281426,29.79438356843428,2323
6,9,5,7,22,14,63,1.0706943079284812,29.490634476571035,2334
6,9,5,5,5,14,44,1.1073033996001094,29.64305522375124,2352
6,13,5,7,18,17,66,1.152830617888565,29.76532923429781,2363
29,22,5,9,25,15,105,1.2773710917467098,29.28277613282277,2339
11,15,7,3,15,14,65,1.1578864723008675,29.346871693401418,2347
8,26,10,15,7,14,80,1.188909462571599,29.27944975902262,2334
13,16,11,12,2,15,69,1.1719007499361478,29.18692895093828,2327
19,18,13,9,9,14,82,1.1708716264021668,28.944282431168478,2321
11,7,12,8,12,11,61,1.0938624901030807,29.77132623423346,2331
30,8,11,8,18,13,88,1.1548996332628743,29.129993094560678,2311
21,7,11,6,23,11,79,1.141784658913161,29.39751363145567,2305
23,6,12,10,7,12,70,1.0585761915091854,29.28740734870468,2302
4,25,9,7,7,10,62,0.9909639815002786,29.1582662534745,2273
15,22,8,15,8,10,78,1.015555195240513,29.065149930707438,2245
11,17,7,16,6,10,67,1.0028265742185425,29.277742876754527,2242
4,10,11,20,3,10,58,0.9661801143432099,29.456882498960134,2231
8,11,5,23,3,7,57,0.9202669555345232,29.10822907988605,2210
3,11,5,21,4,11,55,0.9237916225140108,28.885219159685168,2203
8,12,5,22,18,7,72,0.939406543081166,28.86098132821125,2187
15,9,5,19,21,5,74,0.9774559463571588,28.467694505281514,2157
17,17,5,7,25,8,79,1.2073732491840274,28.036069846806093,2165
13,11,5,17,20,6,72,1.1410611856492647,27.768163850365962,2143
2,12,5,9,9,12,49,1.09176935874232,28.195224412768994,2153
12,8,5,16,7,14,62,1.1231602787643546,28.30209603958328,2133
5,10,5,15,6,9,50,0.8924335308737943,28.4970981122699,2133
4,9,10,13,8,8,52,0.7799372696453244,28.36604112322393,2118
5,13,12,6,9,10,55,0.9411713151384625,28.256714564598035,2117
9,12,11,13,7,16,68,1.010657887058245,28.01987463394234,2123
10,18,12,14,17,13,84,1.0875213798993482,27.52629597753649,2116
7,14,4,13,8,7,53,1.1069589061358969,27.502756818781272,2105
10,8,5,15,3,7,48,1.2148745070005653,27.102521164922056,2099
11,8,5,10,6,5,45,1.3483931116874723,26.75082440038903,2106
1,12,5,14,3,14,49,1.2804703443432301,26.917633275324015,2124
12,6,6,12,6,12,54,1.1968412102045498,26.921864026618753,2141
12,9,5,8,7,10,51,1.1160365569128028,27.57099856259845,2138
6,22,5,6,7,12,58,1.1624463580739297,27.798641380621394,2152
11,24,7,6,7,8,63,1.219051491898735,26.906637391351317,2147
7,22,9,6,12,4,60,1.1786701876228793,27.02530507640889,2138
5,11,9,8,16,8,57,1.0942114602668682,28.014285290873254,2132
3,6,10,7,11,6,43,1.0259701709508733,27.919640773741193,2140
3,10,12,9,1,6,41,1.085881079437732,27.633891117796182,2143
8,12,11,6,23,8,68,1.2917165371093962,26.352326404683357,2146
0,6,10,6,25,9,56,1.1859410693521109,27.278092977627644,2160
10,14,11,9,4,8,56,1.1743788267711563,27.26564923420653,2173
9,6,13,8,9,6,51,1.1886566749294567,27.487051905354054,2190
12,8,13,2,24,9,68,1.2167426980966303,27.451258247585894,2186
13,8,12,6,25,16,80,1.1498110254758498,27.812640875046963,2191
26,11,9,4,15,14,79,1.0724191140121755,28.447661308909158,2175
19,9,10,6,10,15,69,1.0968391477484223,28.301870000451594,2178
11,9,13,6,8,10,57,1.011756705330144,28.654215720027196,2179
5,26,8,4,6,7,56,1.0071270106119596,28.501031973873484,2186
6,28,15,6,4,8,67,1.0759200063869787,28.01619918112023,2162
1,24,15,8,8,6,62,1.1537133071766927,27.74661123107268,2162
17,16,15,14,7,7,76,1.171533691749649,27.601524562578554,2164
5,6,17,9,1,6,44,1.0163162672118191,28.200816497475184,2177
3,8,15,4,2,6,38,0.9380540600874901,29.078934792295215,2187
5,9,6,8,17,5,50,0.9299279059516676,29.18777889281057,2195
11,8,6,7,17,6,55,0.9759698904564524,28.908427899061316,2196
11,9,5,7,8,6,46,0.9474162137070745,29.040713383894804,2208
7,23,6,10,5,5,56,1.0280170974013105,28.915466190982627,2211
9,10,6,6,2,11,44,0.9033007600132464,30.037008716011105,2222
9,15,5,8,7,14,58,0.9558566478197068,29.738507611563172,2225
3,16,5,18,8,16,66,0.8886291588629495,29.675533401907682,2246
16,14,6,22,7,14,79,0.9901991581001126,29.000533088115954,2229
8,14,6,21,5,11,65,0.9560829604420779,28.998553135718648,2196
16,13,8,23,6,1,67,0.9899558186269167,28.695837282145202,2187
11,3,12,21,11,6,64,1.0608638130520256,28.460086584429426,2159
12,9,8,22,18,6,75,1.1602887908681856,27.421096259283427,2140
2,7,6,18,10,5,48,1.0334366060755487,27.435953311615723,2110
1,9,5,15,6,6,42,1.0247992688090093,27.570178393404177,2101
8,8,5,17,22,8,68,1.096727527667672,27.161710552382356,2079
11,17,6,12,23,5,74,1.2050091229909436,26.095898499822855,2056
